id,tipus,font,nom,municipi,sstt,ssttNou,enquesta,grups,pDepartament,pAltres,pTotal,e75paret,e75rodes,e65paret,e65rodes,eTotal,a75paret,a75rodes,a65paret,a65rodes,aTotal,apTotal,srFixes,srRodes,srTotal,asm,mad,public,maleta,max
"08000013",ESC,Centre públic Dep. i CEB,Escola Francesc Platón i Sartí,Abrera,BLL,BLL,1,18,0,0,0,0,0,0,20,20,0,0,0,18,18,18,0,0,0,0,0,1,1,0
"08000049",ESC,Centre públic Dep. i CEB,Escola Fabra,Alella,MVO,MVO,1,19,1,6,7,17,0,0,0,17,17,0,0,0,17,18,17,0,17,2,2,1,1,0
"08000086",ESC-ZER,Centre públic Dep. i CEB,Escola La Forja - ZER Alt Lluçanès,Alpens,CCE,CCE,1,3,0,0,0,1,1,0,0,2,1,1,0,0,2,2,1,1,2,0,0,1,0,0
"08000098",ESC,Centre públic Dep. i CEB,Escola Bertí,L'Ametlla del Vallès,MVO,MVO,1,17,2,1,3,4,0,0,0,4,4,0,0,0,4,6,3,1,4,3,3,1,1,0
"08000153",ESC,Centre públic Dep. i CEB,Escola Joan Maragall,Arenys de Mar,MVO,MVO,1,24,0,0,0,17,1,9,0,27,17,1,6,0,24,24,9,1,10,0,0,1,1,0
"08000165",ESC,Centre públic Dep. i CEB,Escola Sant Martí,Arenys de Munt,MVO,MVO,1,16,1,1,2,15,1,0,0,16,15,0,0,0,15,16,15,0,15,1,1,1,1,0
"08000189",ESC,Centre públic Dep. i CEB,Escola Bernat de Riudemeia,Argentona,MVO,MVO,1,9,1,5,6,8,0,1,1,10,8,0,0,0,8,9,0,0,0,1,1,1,1,0
"08000244",ESC,Centre públic Dep. i CEB,Escola Doctor Ferrer,Artés,CCE,CCE,1,22,0,0,0,16,2,0,0,18,16,2,0,0,18,18,16,2,18,0,0,1,1,0
"08000271",ESC,Centre públic Dep. i CEB,Escola Santa Maria d'Avià,Avià,CCE,CCE,1,11,0,0,0,10,2,0,0,12,10,1,0,0,11,11,10,1,11,0,0,1,1,0
"08000347",ESC,Centre públic Dep. i CEB,Escola d'Avinyonet del Penedès,Avinyó Nou (Avinyonet del Penedès),BCO,PEN,1,9,2,6,8,6,0,0,0,6,6,0,0,0,6,8,6,0,6,3,3,1,1,0
"08000359",ESC,Centre públic Dep. i CEB,Escola La Muntanya,Aiguafreda,MVO,MVO,1,10,1,0,1,5,3,0,3,11,5,3,0,1,9,10,5,4,9,1,1,1,1,0
"08000384",ESC,Centre públic Dep. i CEB,Escola Lola Anglada,Badalona,BCO,BCO,1,19,0,0,0,1,0,9,2,12,1,0,9,2,12,12,0,0,0,0,0,1,1,0
"08000396",ESC,Centre públic Dep. i CEB,Escola Ventós i Mir,Badalona,BCO,BCO,1,16,5,1,6,0,0,12,0,12,0,0,11,0,11,16,11,0,11,5,5,1,1,0
"08000402",ESC,Centre públic Dep. i CEB,Escola Feliu i Vegués,Badalona,BCO,BCO,1,13,3,7,10,7,0,0,0,7,7,0,0,0,7,10,7,0,7,6,4,1,1,0
"08000670",ESC,Concertada 30% NESE,FEP Mare de Déu de la Salut,Badalona,BCO,BCO,0,9,0,0,0,0,0,0,0,0,9,0,0,0,9,9,0,0,0,0,0,0,1,0
"08001145",IE,Concertada 30% NESE,Lestonnac,Badalona,BCO,BCO,0,26,0,0,0,0,0,0,0,0,26,0,0,0,26,26,0,0,0,0,0,0,1,0
"08001170",IE,Concertada 30% NESE,Santíssima Trinitat,Badalona,BCO,BCO,0,14,0,0,0,0,0,0,0,0,14,0,0,0,14,14,0,0,0,0,0,0,1,0
"08001391",ESC,Centre públic Dep. i CEB,Escola Planas i Casals,Badalona,BCO,BCO,1,18,0,0,0,7,11,0,0,18,7,11,0,0,18,18,7,11,18,0,0,1,1,0
"08001421",INS,Centre públic Dep. i CEB,Institut La Pineda,Badalona,BCO,BCO,1,37,0,0,0,0,10,0,2,12,0,10,0,2,12,12,0,0,0,0,0,1,1,0
"08001431",INS,Centre públic Dep. i CEB,Institut Isaac Albéniz,Badalona,BCO,BCO,1,26,0,0,0,22,0,0,0,22,22,0,0,0,22,22,0,0,0,0,0,1,1,0
"08001443",INS,Centre públic Dep. i CEB,Institut Eugeni d'Ors,Badalona,BCO,BCO,1,28,0,0,0,14,0,0,12,26,14,0,0,12,26,26,14,12,26,0,0,1,1,0
"08001480",INS,Centre públic Dep. i CEB,EA Pau Gargallo,Badalona,BCO,BCO,1,8,0,0,0,6,0,0,0,6,6,0,0,0,6,6,6,0,6,0,0,1,1,0
"08001509",ESC,Centre públic Dep. i CEB,Escola Antoni Botey,Badalona,BCO,BCO,1,18,1,1,2,18,0,0,0,18,17,0,0,0,17,18,17,0,17,1,1,1,1,0
"08001522",ESC,Centre públic Dep. i CEB,Escola Galceran de Pinós,Bagà,CCE,CCE,1,9,1,0,1,6,0,0,1,7,6,0,0,1,7,8,3,1,4,1,1,1,1,0
"08001595",ESC,Centre públic Dep. i CEB,Escola Baixeras,Barcelona,CEB,CEB,1,9,1,3,4,9,0,0,0,9,8,0,0,0,8,9,0,0,0,1,1,1,1,0
"08001601",ESC,Centre públic Dep. i CEB,Escola Parc de la Ciutadella,Barcelona,CEB,CEB,1,9,1,8,9,1,0,8,0,9,1,0,7,0,8,9,3,0,3,1,1,1,1,0
"08001649",ESC,Centre públic Dep. i CEB,Escola Mossèn Jacint Verdaguer,Barcelona,CEB,CEB,1,18,3,0,3,18,0,0,0,18,15,0,0,0,15,18,0,0,0,3,3,1,1,0
"08001650",ESC,Centre públic Dep. i CEB,Escola El Polvorí,Barcelona,CEB,CEB,1,9,3,1,4,6,1,0,0,7,6,0,0,0,6,9,0,1,1,3,3,1,1,0
"08001674",ESC,Centre públic Dep. i CEB,Escola Can Clos,Barcelona,CEB,CEB,1,9,1,0,1,4,3,0,0,7,4,3,0,0,7,8,4,3,7,1,1,1,1,0
"08001716",ESC,Centre públic Dep. i CEB,Escola Dolors Monserdà-Santapau,Barcelona,CEB,CEB,1,20,2,0,2,18,0,0,0,18,18,0,0,0,18,20,18,0,18,2,2,1,1,0
"08001731",ESC,Centre públic Dep. i CEB,Escola Poeta Foix,Barcelona,CEB,CEB,1,9,1,0,1,10,4,0,0,14,8,0,0,0,8,9,8,0,8,1,1,1,1,0
"08001777",ESC,Centre públic Dep. i CEB,Escola Ramon Llull,Barcelona,CEB,CEB,1,21,0,0,0,20,0,0,0,20,20,0,0,0,20,20,8,0,8,0,0,1,1,0
"08001789",ESC,Centre públic Dep. i CEB,Escola Cervantes,Barcelona,CEB,CEB,1,9,1,0,1,9,0,0,0,9,8,0,0,0,8,9,8,0,8,1,1,1,1,0
"08001790",ESC,Centre públic Dep. i CEB,Escola Pere Vila,Barcelona,CEB,CEB,1,18,2,0,2,18,0,0,0,18,16,0,0,0,16,18,6,0,6,2,2,1,1,0
"08001807",ESC,Centre públic Dep. i CEB,Escola de la Concepció,Barcelona,CEB,CEB,1,9,0,0,0,0,9,0,0,9,0,9,0,0,9,9,0,0,0,0,0,1,1,0
"08001819",ESC,Centre públic Dep. i CEB,Escola Collaso i Gil,Barcelona,CEB,CEB,1,19,4,0,4,13,0,0,0,13,13,0,0,0,13,17,0,0,0,4,4,1,1,0
"08001820",ESC,Centre públic Dep. i CEB,Escola Milà i Fontanals,Barcelona,CEB,CEB,1,18,0,0,0,18,3,0,0,21,18,0,0,0,18,18,18,0,18,0,0,1,1,0
"08001832",ESC,Centre públic Dep. i CEB,Escola Castella,Barcelona,CEB,CEB,1,9,1,0,1,8,1,0,0,9,8,0,0,0,8,9,8,0,8,1,1,1,1,0
"08001856",ESC,Centre públic Dep. i CEB,Escola Drassanes,Barcelona,CEB,CEB,1,18,4,7,11,0,0,13,1,14,0,0,13,1,14,18,6,1,7,4,4,1,1,0
"08001868",ESC,Centre públic Dep. i CEB,Escola Rubén Darío,Barcelona,CEB,CEB,1,9,1,0,1,0,1,5,2,8,0,1,5,2,8,9,5,2,7,1,1,1,1,0
"08001911",ESC,Centre públic Dep. i CEB,Escola Els Llorers,Barcelona,CEB,CEB,1,21,16,8,24,0,1,7,4,12,0,1,4,0,5,21,3,2,5,16,6,1,1,0
"08001923",ESC,Centre públic Dep. i CEB,Escola Diputació,Barcelona,CEB,CEB,1,18,0,12,12,0,20,0,0,20,0,18,0,0,18,18,17,1,18,0,0,1,1,0
"08001947",ESC,Centre públic Dep. i CEB,Escola Mallorca,Barcelona,CEB,CEB,1,18,0,0,0,18,0,0,0,18,18,0,0,0,18,18,18,0,18,0,0,1,1,0
"08002009",ESC,Centre públic Dep. i CEB,Escola Francesc Macià,Barcelona,CEB,CEB,1,10,2,3,5,2,0,7,0,9,2,0,6,0,8,10,8,0,8,2,2,1,1,0
"08002010",ESC,Centre públic Dep. i CEB,Escola Lluís Vives,Barcelona,CEB,CEB,1,9,1,4,5,9,0,0,0,9,8,0,0,0,8,9,8,0,8,1,1,1,1,0
"08002022",ESC,Centre públic Dep. i CEB,Escola Cal Maiol,Barcelona,CEB,CEB,1,9,1,0,1,11,0,0,0,11,8,0,0,0,8,9,8,0,8,1,1,1,1,0
"08002058",ESC,Centre públic Dep. i CEB,Escola Pràctiques,Barcelona,CEB,CEB,1,20,3,0,3,18,0,0,0,18,17,0,0,0,17,20,17,0,17,3,3,1,1,0
"08002061",ESC,Centre públic Dep. i CEB,Escola Jaume I,Barcelona,CEB,CEB,1,21,1,2,3,14,0,0,4,18,14,0,0,4,18,19,0,3,3,3,3,1,1,0
"08002071",ESC,Centre públic Dep. i CEB,Escola Gayarre,Barcelona,CEB,CEB,1,9,1,0,1,6,3,0,0,9,6,2,0,0,8,9,6,2,8,1,1,1,1,0
"08002113",ESC,Centre públic Dep. i CEB,Escola Rius i Taulet,Barcelona,CEB,CEB,1,19,0,2,2,17,0,0,0,17,17,0,0,0,17,17,17,0,17,2,2,1,1,0
"08002174",ESC,Centre públic Dep. i CEB,Escola Baldiri Reixac,Barcelona,CEB,CEB,1,9,1,0,1,9,0,0,0,9,8,0,0,0,8,9,8,0,8,1,1,1,1,0
"08002186",ESC,Centre públic Dep. i CEB,Escola Mare de Déu de Montserrat,Barcelona,CEB,CEB,1,9,2,0,2,9,0,0,0,9,7,0,0,0,7,9,6,0,6,2,2,1,1,0
"08002198",ESC,Centre públic Dep. i CEB,Escola La Farigola de Vallcarca,Barcelona,CEB,CEB,1,9,1,0,1,8,1,0,0,9,8,0,0,0,8,9,3,0,3,1,1,1,1,0
"08002204",ESC,Centre públic Dep. i CEB,Escola Montseny,Barcelona,CEB,CEB,1,9,0,0,0,6,3,0,0,9,6,3,0,0,9,9,6,3,9,0,0,1,1,0
"08002216",ESC,Centre públic Dep. i CEB,Escola Josep Maria de Sagarra,Barcelona,CEB,CEB,1,9,0,0,0,9,0,0,0,9,9,0,0,0,9,9,9,0,9,0,0,1,1,0
"08002277",ESC,Centre públic Dep. i CEB,Escola Calderón de la Barca,Barcelona,CEB,CEB,1,18,1,0,1,18,0,0,0,18,17,0,0,0,17,18,0,0,0,1,1,1,1,0
"08002290",ESC,Centre públic Dep. i CEB,Escola Emili Juncadella,Barcelona,CEB,CEB,1,9,1,0,1,0,9,0,0,9,0,8,0,0,8,9,0,0,0,1,1,1,1,0
"08002320",ESC,Centre públic Dep. i CEB,Escola Ciutat Comtal,Barcelona,CEB,CEB,1,9,2,11,13,0,9,0,0,9,0,7,0,0,7,9,0,7,7,2,2,1,1,0
"08002344",ESC,Centre públic Dep. i CEB,Escola El Turó,Barcelona,CEB,CEB,1,10,1,0,1,0,0,6,2,8,0,0,6,2,8,9,3,0,3,1,1,1,1,0
"08002368",ESC,Centre públic Dep. i CEB,Escola Timbaler del Bruc,Barcelona,CEB,CEB,1,9,1,0,1,6,1,6,0,13,6,1,1,0,8,9,4,1,5,1,1,1,1,0
"08002393",ESC,Centre públic Dep. i CEB,Escola L'Arc de Sant Martí,Barcelona,CEB,CEB,1,9,4,9,13,2,0,1,0,3,2,0,1,0,3,7,0,0,0,6,3,1,1,0
"08002411",ESC,Centre públic Dep. i CEB,Escola Baró de Viver,Barcelona,CEB,CEB,1,9,1,0,1,9,0,0,0,9,8,0,0,0,8,9,8,0,8,1,1,1,1,0
"08002459",ESC,Centre públic Dep. i CEB,Escola Elisenda de Montcada,Barcelona,CEB,CEB,1,18,4,14,18,7,0,0,0,7,7,0,0,0,7,11,0,0,0,11,5,1,1,0
"08002484",ESC,Centre públic Dep. i CEB,Escola Marta Mata,Barcelona,CEB,CEB,1,9,1,0,1,0,0,0,8,8,0,0,0,8,8,9,0,8,8,1,1,1,1,0
"08002526",ESC,Centre públic Dep. i CEB,Escola Tibidabo,Barcelona,CEB,CEB,1,9,0,0,0,9,0,0,0,9,9,0,0,0,9,9,9,0,9,0,0,1,1,0
"08002538",ESC,Centre públic Dep. i CEB,Escola Víctor Català,Barcelona,CEB,CEB,1,18,0,1,1,18,0,0,0,18,18,0,0,0,18,18,6,0,6,0,0,1,1,0
"08002551",ESC,Centre públic Dep. i CEB,Escola Molí de Finestrelles,Barcelona,CEB,CEB,1,18,1,0,1,19,0,0,0,19,17,0,0,0,17,18,17,0,17,1,1,1,1,0
"08002563",ESC,Centre públic Dep. i CEB,Escola La Mar Bella,Barcelona,CEB,CEB,1,17,2,0,2,0,12,2,2,16,0,12,2,1,15,17,2,13,15,2,2,1,1,0
"08002575",ESC,Centre públic Dep. i CEB,Escola La Pau,Barcelona,CEB,CEB,1,9,0,0,0,10,0,3,2,15,9,0,0,0,9,9,0,2,2,0,0,1,1,0
"08002587",ESC,Centre públic Dep. i CEB,Escola Concepción Arenal,Barcelona,CEB,CEB,1,9,1,0,1,0,9,0,0,9,0,8,0,0,8,9,0,8,8,1,1,1,1,0
"08002599",ESC,Centre públic Dep. i CEB,Escola Eduard Marquina,Barcelona,CEB,CEB,1,9,1,0,1,0,0,0,9,9,0,0,0,8,8,9,0,8,8,1,1,1,1,0
"08002617",ESC,Centre públic Dep. i CEB,Escola Rambleta del Clot,Barcelona,CEB,CEB,1,18,2,3,5,10,0,0,4,14,10,0,0,4,14,16,5,4,9,4,4,1,1,0
"08002629",ESC,Centre públic Dep. i CEB,Escola Les Acàcies,Barcelona,CEB,CEB,1,19,0,2,2,18,1,0,0,19,18,1,0,0,19,19,18,1,19,0,0,1,1,0
"08002630",ESC,Centre públic Dep. i CEB,Escola Els Porxos,Barcelona,CEB,CEB,1,9,1,0,1,7,0,0,2,9,7,0,0,1,8,9,3,2,5,1,1,1,1,0
"08002642",ESC,Centre públic Dep. i CEB,Escola Poblenou,Barcelona,CEB,CEB,1,15,1,4,5,14,0,0,0,14,14,0,0,0,14,15,10,0,10,1,1,1,1,0
"08002654",ESC,Centre públic Dep. i CEB,Escola Prim,Barcelona,CEB,CEB,1,10,2,3,5,0,0,0,10,10,0,0,0,8,8,10,0,8,8,2,2,1,1,0
"08002666",EE,Centre públic Dep. i CEB,CEE Concha Espina,Barcelona,CEB,CEB,1,6,6,3,9,3,0,0,0,3,0,0,0,0,0,6,0,0,0,6,2,1,1,0
"08002681",ESC,Centre públic Dep. i CEB,Escola Duran i Bas,Barcelona,CEB,CEB,1,18,0,0,0,17,1,0,0,18,17,1,0,0,18,18,6,1,7,0,0,1,1,0
"08002721",ESC,Centre públic Dep. i CEB,Escola Font d'en Fargas,Barcelona,CEB,CEB,1,19,4,2,6,19,0,0,0,19,15,0,0,0,15,19,15,0,15,4,4,1,1,0
"08002733",ESC,Centre públic Dep. i CEB,Escola Miralletes,Barcelona,CEB,CEB,1,9,1,0,1,6,0,0,3,9,6,0,0,2,8,9,6,2,8,1,1,1,1,0
"08002745",ESC,Centre públic Dep. i CEB,Escola El Carmel,Barcelona,CEB,CEB,1,18,19,0,19,0,0,7,0,7,0,0,0,0,0,19,0,0,0,18,5,1,1,0
"08002770",ESC,Centre públic Dep. i CEB,Escola Àgora,Barcelona,CEB,CEB,1,9,0,2,2,5,2,2,0,9,5,2,2,0,9,9,2,2,4,0,0,1,1,0
"08002800",ESC,Centre públic Dep. i CEB,Escola Mas Casanovas,Barcelona,CEB,CEB,1,18,0,1,1,8,1,0,0,9,8,1,0,0,9,9,8,1,9,1,1,1,1,0
"08002873",ESC,Centre públic Dep. i CEB,Escola Bac de Roda,Barcelona,CEB,CEB,1,18,0,20,20,18,0,0,0,18,18,0,0,0,18,18,0,0,0,0,0,1,1,0
"08002897",ESC,Centre públic Dep. i CEB,Escola Mestre Morera,Barcelona,CEB,CEB,1,9,3,0,3,5,1,1,0,7,5,1,0,0,6,9,3,0,3,3,3,1,1,0
"08002903",EE,Centre públic Dep. i CEB,CEE Sant Joan de la Creu,Barcelona,CEB,CEB,0,8,4,0,4,0,0,0,0,0,0,0,0,0,0,4,0,0,0,0,0,1,1,4
"08002915",ESC,Centre públic Dep. i CEB,Escola Brasil,Barcelona,CEB,CEB,1,12,0,0,0,9,0,0,4,13,9,0,0,3,12,12,5,4,9,0,0,1,1,0
"08002927",ESC,Centre públic Dep. i CEB,Escola Joaquim Ruyra,Barcelona,CEB,CEB,1,20,0,0,0,18,0,0,0,18,18,0,0,0,18,18,6,0,6,0,0,1,1,0
"08002952",ESC,Centre públic Dep. i CEB,Escola Enric Granados,Barcelona,CEB,CEB,1,9,1,0,1,9,0,0,0,9,8,0,0,0,8,9,4,0,4,1,1,1,1,0
"08002976",ESC,Centre públic Dep. i CEB,Escola Ramon Casas,Barcelona,CEB,CEB,1,18,2,2,4,11,0,4,0,15,11,0,4,0,15,17,15,0,15,3,3,1,1,0
"08002988",ESC,Centre públic Dep. i CEB,Escola Pare Poveda,Barcelona,CEB,CEB,1,14,0,0,0,10,0,4,1,15,10,0,4,0,14,14,14,0,14,0,0,1,1,0
"08002991",ESC,Centre públic Dep. i CEB,Escola Cascavell,Sant Adrià de Besòs,BCO,BCO,1,9,1,0,1,0,1,0,0,1,0,1,0,0,1,2,0,0,0,1,1,1,1,0
"08003041",ESC,Concertada 30% NESE,Sagrada Família,Barcelona,CEB,CEB,0,9,0,0,0,0,0,0,0,0,9,0,0,0,9,9,0,0,0,0,0,0,1,0
"08003361",IE,Concertada 30% NESE,Maristes Anna Ravell,Barcelona,CEB,CEB,0,24,0,0,0,0,0,0,0,0,24,0,0,0,24,24,0,0,0,0,0,0,1,0
"08003491",ESC,Centre públic Dep. i CEB,Escola De Bosc de Montjuïc,Barcelona,CEB,CEB,1,10,1,0,1,0,9,0,0,9,0,9,0,0,9,10,0,0,0,1,1,1,1,0
"08003671",ESC,Concertada 30% NESE,JesuÏtes Poble Sec - Sant Pere Claver,Barcelona,CEB,CEB,0,9,0,0,0,0,0,0,0,0,9,0,0,0,9,9,0,0,0,0,0,0,1,0
"08003695",ESC,Centre públic Dep. i CEB,Escola Bàrkeno,Barcelona,CEB,CEB,1,9,0,11,11,9,0,0,0,9,9,0,0,0,9,9,9,0,9,0,0,1,1,0
"08003774",EE,EE Privats,Lexia,Barcelona,CEB,CEB,0,1,0,0,0,0,0,0,0,0,3,0,0,0,3,3,0,0,0,0,0,0,1,0
"08004389",ESC,Centre públic Dep. i CEB,Escola Reina Violant,Barcelona,CEB,CEB,1,10,0,0,0,13,0,0,0,13,10,0,0,0,10,10,10,0,10,0,0,1,1,0
"08004523",EE,EE Privats,Paideia,Barcelona,CEB,CEB,0,1,0,0,0,0,0,0,0,0,6,0,0,0,6,6,0,0,0,0,0,0,1,0
"08005102",IE,Concertada 30% NESE,La Salle Comtal,Barcelona,CEB,CEB,0,25,0,0,0,0,0,0,0,0,25,0,0,0,25,25,0,0,0,0,0,0,1,0
"08005114",IE,Concertada 30% NESE,Mare del Diví Pastor,Barcelona,CEB,CEB,0,12,0,0,0,0,0,0,0,0,12,0,0,0,12,12,0,0,0,0,0,0,1,0
"08005151",IE,Concertada 30% NESE,Sant Francesc Xavier,Barcelona,CEB,CEB,0,6,0,0,0,0,0,0,0,0,6,0,0,0,6,6,0,0,0,0,0,0,1,0
"08005618",IE,Concertada 30% NESE,Vedruna Àngels Barcelona,Barcelona,CEB,CEB,0,13,0,0,0,0,0,0,0,0,13,0,0,0,13,13,0,0,0,0,0,0,1,0
"08005746",IE,Concertada 30% NESE,Escola Pia Sant Antoni,Barcelona,CEB,CEB,0,47,0,0,0,0,0,0,0,0,47,0,0,0,47,47,0,0,0,0,0,0,1,0
"08005965",ESC,Concertada 30% NESE,Sant Francesc d'Assís,Barcelona,CEB,CEB,0,9,0,0,0,0,0,0,0,0,9,0,0,0,9,9,0,0,0,0,0,0,1,0
"08006477",ESC,Concertada 30% NESE,Lloret,Barcelona,CEB,CEB,0,9,0,0,0,0,0,0,0,0,9,0,0,0,9,9,0,0,0,0,0,0,1,0
"08006945",IE,Concertada 30% NESE,Acis-Artur Martorell,Barcelona,CEB,CEB,0,13,0,0,0,0,0,0,0,0,13,0,0,0,13,13,0,0,0,0,0,0,1,0
"08006970",IE,Concertada 30% NESE,Sant Josep,Barcelona,CEB,CEB,0,17,0,0,0,0,0,0,0,0,17,0,0,0,17,17,0,0,0,0,0,0,1,0
"08007202",ESC,Centre públic Dep. i CEB,Escola Patronat Domènech,Barcelona,CEB,CEB,1,9,0,0,0,9,0,0,0,9,9,0,0,0,9,9,3,0,3,0,0,1,1,0
"08007445",IE,Concertada 30% NESE,Escola Pia Luz Casanova,Barcelona,CEB,CEB,0,13,0,0,0,0,0,0,0,0,13,0,0,0,13,13,0,0,0,0,0,0,1,0
"08007524",ESC,Concertada 30% NESE,Prínceps 23 d'Abril,Barcelona,CEB,CEB,0,9,0,0,0,0,0,0,0,0,9,0,0,0,9,9,0,0,0,0,0,0,1,0
"08008191",IE,Concertada 30% NESE,Santa Maria dels Apòstols,Barcelona,CEB,CEB,0,18,0,0,0,0,0,0,0,0,18,0,0,0,18,18,0,0,0,0,0,0,1,0
"08008267",IE,Concertada 30% NESE,FEP L'Esperança,Barcelona,CEB,CEB,0,12,0,0,0,0,0,0,0,0,12,0,0,0,12,12,0,0,0,0,0,0,1,0
"08008309",IE,Concertada 30% NESE,FEP Mare Alfonsa Cavín,Barcelona,CEB,CEB,0,13,0,0,0,0,0,0,0,0,13,0,0,0,13,13,0,0,0,0,0,0,1,0
"08008361",IE,Concertada 30% NESE,Cor de Maria-Sabastida,Barcelona,CEB,CEB,0,26,0,0,0,0,0,0,0,0,26,0,0,0,26,26,0,0,0,0,0,0,1,0
"08008401",IE,Concertada 30% NESE,FEP Bon Pastor,Barcelona,CEB,CEB,0,24,0,0,0,0,0,0,0,0,24,0,0,0,24,24,0,0,0,0,0,0,1,0
"08008449",ESC,Centre públic Dep. i CEB,Escola Turó Blau,Barcelona,CEB,CEB,1,9,0,0,0,9,0,0,0,9,9,0,0,0,9,9,5,0,5,0,0,1,1,0
"08008531",IE,Concertada 30% NESE,Amor de Dios,Barcelona,CEB,CEB,0,28,0,0,0,0,0,0,0,0,28,0,0,0,28,28,0,0,0,0,0,0,1,0
"08008826",ESC,Concertada 30% NESE,Miró,Barcelona,CEB,CEB,0,9,0,0,0,0,0,0,0,0,9,0,0,0,9,9,0,0,0,0,0,0,1,0
"08008981",IE,Concertada 30% NESE,Sagrat Cor Besòs,Barcelona,CEB,CEB,0,26,0,0,0,0,0,0,0,0,26,0,0,0,26,26,0,0,0,0,0,0,1,0
"08009171",ESC,Centre públic Dep. i CEB,Escola Casas,Barcelona,CEB,CEB,1,9,0,0,0,13,3,2,0,18,9,0,0,0,9,9,6,3,9,0,0,1,1,0
"08009235",IE,Concertada 30% NESE,FEP Santíssima Trinitat,Barcelona,CEB,CEB,0,13,0,0,0,0,0,0,0,0,13,0,0,0,13,13,0,0,0,0,0,0,1,0
"08009776",ESC,Centre públic Dep. i CEB,Escola Arc Iris,Barcelona,CEB,CEB,1,9,1,0,1,0,0,6,3,9,0,0,6,2,8,9,6,2,8,1,1,1,1,0
"08010146",ESC,Centre públic Dep. i CEB,Escola del Mar,Barcelona,CEB,CEB,1,9,0,0,0,0,0,0,9,9,0,0,0,9,9,9,0,9,9,0,0,1,1,0
"08010201",ESC,Centre públic Dep. i CEB,Escola Parc del Guinardó,Barcelona,CEB,CEB,1,9,0,0,0,9,0,3,0,12,9,0,0,0,9,9,3,0,3,0,0,1,1,0
"08010304",IE,Concertada 30% NESE,Santa Teresa de Jesús,Barcelona,CEB,CEB,0,13,0,0,0,0,0,0,0,0,13,0,0,0,13,13,0,0,0,0,0,0,1,0
"08010882",INS,Concertada 30% NESE,Molina,Barcelona,CEB,CEB,0,4,0,0,0,0,0,0,0,0,4,0,0,0,4,4,0,0,0,0,0,0,1,0
"08010912",ESC,Centre públic Dep. i CEB,Escola Ignasi Iglésias,Barcelona,CEB,CEB,1,16,8,0,8,7,1,0,0,8,7,1,0,0,8,16,0,0,0,8,5,1,1,0
"08011096",IE,Concertada 30% NESE,Piaget,Barcelona,CEB,CEB,0,13,0,0,0,0,0,0,0,0,13,0,0,0,13,13,0,0,0,0,0,0,1,0
"08011266",EE,EE Privats,Aspace,Barcelona,CEB,CEB,0,1,0,0,0,0,0,0,0,0,3,0,0,0,3,3,0,0,0,0,0,0,1,0
"08011281",EE,EE Privats,Inst. Pedagogia Terapèut. Jeroni de Moragas,Barcelona,CEB,CEB,0,1,0,0,0,0,0,0,0,0,2,0,0,0,2,2,0,0,0,0,0,0,1,0
"08011291",EE,EE Privats,Pedralbes,Barcelona,CEB,CEB,0,1,0,0,0,0,0,0,0,0,2,0,0,0,2,2,0,0,0,0,0,0,1,0
"08011424",EE,EE Privats,Sants Innocents,Barcelona,CEB,CEB,0,1,0,0,0,0,0,0,0,0,3,0,0,0,3,3,0,0,0,0,0,0,1,0
"08011451",EE,EE Privats,Aspasim,Barcelona,CEB,CEB,0,1,0,0,0,0,0,0,0,0,1,0,0,0,1,1,0,0,0,0,0,0,1,0
"08011643",EE,EE Privats,FEP Aprenents EE,Barcelona,CEB,CEB,0,1,0,0,0,0,0,0,0,0,3,0,0,0,3,3,0,0,0,0,0,0,1,0
"08012714",INS,Centre públic Dep. i CEB,Institut Anna Gironella de Mundet,Barcelona,CEB,CEB,1,28,0,0,0,28,0,0,0,28,28,0,0,0,28,28,28,0,28,0,0,1,1,0
"08013071",EE,EE Privats,FEP Nostra Senyora de Montserrat EE,Barcelona,CEB,CEB,0,1,0,0,0,0,0,0,0,0,3,0,0,0,3,3,0,0,0,0,0,0,1,0
"08013093",INS,Centre públic Dep. i CEB,Institut Montjuïc,Barcelona,CEB,CEB,1,14,1,0,1,10,0,0,0,10,10,0,0,0,10,11,0,0,0,1,1,1,1,0
"08013101",INS,Centre públic Dep. i CEB,Institut Joan d'Àustria,Barcelona,CEB,CEB,1,26,15,24,39,18,1,5,0,24,11,0,0,0,11,26,0,0,0,15,7,1,1,0
"08013111",INS,Centre públic Dep. i CEB,Institut Jaume Balmes,Barcelona,CEB,CEB,1,26,0,0,0,30,2,0,0,32,26,0,0,0,26,26,26,0,26,0,0,1,1,0
"08013135",INS,Centre públic Dep. i CEB,Institut Moisès Broggi,Barcelona,CEB,CEB,1,27,0,0,0,20,5,0,0,25,20,5,0,0,25,25,20,5,25,0,0,1,1,0
"08013147",INS,Centre públic Dep. i CEB,Institut Sants,Barcelona,CEB,CEB,1,29,1,0,1,0,38,0,0,38,0,28,0,0,28,29,0,20,20,1,1,1,1,0
"08013159",INS,Centre públic Dep. i CEB,Institut Infanta Isabel d'Aragó,Barcelona,CEB,CEB,1,32,0,0,0,25,0,0,0,25,25,0,0,0,25,25,0,0,0,0,0,1,1,0
"08013160",INS,Centre públic Dep. i CEB,Institut Poeta Maragall,Barcelona,CEB,CEB,1,27,0,0,0,16,0,1,3,20,16,0,1,3,20,20,0,0,0,0,0,1,1,0
"08013184",INS,Centre públic Dep. i CEB,Institut Bernat Metge,Barcelona,CEB,CEB,1,16,0,0,0,0,1,10,0,11,0,1,10,0,11,11,10,1,11,0,0,1,1,0
"08013196",INS,Centre públic Dep. i CEB,Institut Milà i Fontanals,Barcelona,CEB,CEB,1,24,1,0,1,19,0,0,0,19,19,0,0,0,19,20,0,0,0,1,1,1,1,0
"08013202",INS,Centre públic Dep. i CEB,Institut Montserrat,Barcelona,CEB,CEB,1,28,0,0,0,0,26,0,0,26,0,26,0,0,26,26,0,26,26,0,0,1,1,0
"08013214",INS,Centre públic Dep. i CEB,Institut Narcís Monturiol,Barcelona,CEB,CEB,1,16,0,0,0,11,0,0,1,12,11,0,0,1,12,12,0,1,1,0,0,1,1,0
"08013226",INS,Centre públic Dep. i CEB,Institut Menéndez y Pelayo,Barcelona,CEB,CEB,1,33,0,0,0,0,6,0,16,22,0,6,0,16,22,22,0,22,22,0,0,1,1,0
"08013238",INS,Centre públic Dep. i CEB,Institut Verdaguer,Barcelona,CEB,CEB,1,13,0,0,0,10,0,0,0,10,10,0,0,0,10,10,0,0,0,0,0,1,1,0
"08013275",INS,Centre públic Dep. i CEB,Institut Escola del Treball,Barcelona,CEB,CEB,1,51,0,2,2,11,23,0,0,34,11,23,0,0,34,34,11,20,31,2,2,1,1,0
"08013329",INS,Centre públic Dep. i CEB,EA Llotja,Barcelona,CEB,CEB,1,36,0,0,0,8,2,0,0,10,8,2,0,0,10,10,8,2,10,0,0,1,1,0
"08013354",EE,Centre públic Dep. i CEB,CEE Municipal Vil·la Joana,Barcelona,CEB,CEB,1,4,0,0,0,3,1,1,3,8,3,1,0,0,4,4,4,0,4,0,0,1,1,0
"08013366",INS,Centre públic Dep. i CEB,Institut Nou Barris,Barcelona,CEB,CEB,1,21,0,0,0,17,0,0,0,17,17,0,0,0,17,17,2,0,2,0,0,1,1,0
"08013408",ESC,Centre públic Dep. i CEB,Escola Barcelona,Barcelona,CEB,CEB,1,19,5,0,5,19,0,0,0,19,14,0,0,0,14,19,14,0,14,5,5,1,1,0
"08013411",ESC,Centre públic Dep. i CEB,Escola Poble-sec,Barcelona,CEB,CEB,1,18,4,0,4,14,3,0,0,17,14,0,0,0,14,18,6,0,6,4,4,1,1,0
"08013457",ESC,Centre públic Dep. i CEB,Escola Pegaso,Barcelona,CEB,CEB,1,19,1,0,1,14,0,3,1,18,14,0,3,1,18,19,3,0,3,1,1,1,1,0
"08013469",INS,Centre públic Dep. i CEB,Institut Rambla Prim,Barcelona,CEB,CEB,1,10,0,0,0,0,9,0,0,9,0,9,0,0,9,9,0,9,9,0,0,1,1,0
"08013470",INS,Centre públic Dep. i CEB,Institut Barri Besòs,Barcelona,CEB,CEB,1,23,0,0,0,2,2,10,3,17,2,2,10,3,17,17,12,5,17,0,0,1,1,0
"08013585",EE,EE Privats,FEP La Sagrera EE,Barcelona,CEB,CEB,0,1,0,0,0,0,0,0,0,0,3,0,0,0,3,3,0,0,0,0,0,0,1,0
"08013901",EE,Centre públic Dep. i CEB,CEE La Ginesta,Barcelona,CEB,CEB,1,5,0,1,1,0,0,7,1,8,0,0,5,0,5,5,0,1,1,0,0,1,1,0
"08014012",EE,EE Privats,FEP Mare de Déu de Montserrat EE,Barcelona,CEB,CEB,0,1,0,0,0,0,0,0,0,0,5,0,0,0,5,5,0,0,0,0,0,0,1,0
"08014051",EE,EE Privats,Estimia,Barcelona,CEB,CEB,0,1,0,0,0,0,0,0,0,0,2,0,0,0,2,2,0,0,0,0,0,0,1,0
"08014115",INS,Centre públic Dep. i CEB,Institut Ferran Tallada,Barcelona,CEB,CEB,1,29,0,0,0,12,0,0,0,12,12,0,0,0,12,12,12,0,12,0,0,1,1,0
"08014140",EE,EE Privats,Guru,Barcelona,CEB,CEB,0,1,0,0,0,0,0,0,0,0,2,0,0,0,2,2,0,0,0,0,0,0,1,0
"08014188",INS,Centre públic Dep. i CEB,Institut Josep Serrat i Bonastre,Barcelona,CEB,CEB,1,15,0,0,0,13,1,0,0,14,13,1,0,0,14,14,0,1,1,0,0,1,1,0
"08014206",INS,Centre públic Dep. i CEB,Institut Caterina Albert,Barcelona,CEB,CEB,1,21,1,1,2,0,18,0,0,18,0,18,0,0,18,19,0,18,18,2,2,1,1,0
"08014255",INS,Concertada 30% NESE,Sopeña Barcelona,Barcelona,CEB,CEB,0,4,0,0,0,0,0,0,0,0,4,0,0,0,4,4,0,0,0,0,0,0,1,0
"08014401",FP,Centre públic Dep. i CEB,Institut Mare de Déu de la Mercè,Barcelona,CEB,CEB,1,42,0,0,0,25,3,0,0,28,25,3,0,0,28,28,0,3,3,0,0,1,1,0
"08014449",IE,Concertada 30% NESE,FEP Mare de Déu del Roser,Barcelona,CEB,CEB,0,6,0,0,0,0,0,0,0,0,6,0,0,0,6,6,0,0,0,0,0,0,1,0
"08014589",ESC,Centre públic Dep. i CEB,Escola Sant Cristòfor,Begues,BLL,BLL,1,19,0,0,0,13,6,0,0,19,13,6,0,0,19,19,13,2,15,0,0,1,1,0
"08014620",ESC,Centre públic Dep. i CEB,Escola Sant Joan,Berga,CCE,CCE,1,13,0,0,0,13,1,0,0,14,13,0,0,0,13,13,5,0,5,0,0,1,1,0
"08014668",ESC,Centre públic Dep. i CEB,Escola de la Valldan,Berga,CCE,CCE,1,9,1,0,1,5,0,0,0,5,5,0,0,0,5,6,5,0,5,1,1,1,1,0
"08014681",ESC,Centre públic Dep. i CEB,Escola Santa Eulàlia,Berga,CCE,CCE,1,18,0,0,0,18,0,0,0,18,18,0,0,0,18,18,18,0,18,0,0,1,1,0
"08014693",INS,Centre públic Dep. i CEB,Institut Guillem de Berguedà,Berga,CCE,CCE,1,34,1,5,6,22,0,0,1,23,22,0,0,1,23,24,0,0,0,6,6,1,1,0
"08014747",ESC,Centre públic Dep. i CEB,Escola El Turó,El Rieral de Bigues (Bigues i Riells),MVO,MVO,1,10,0,0,0,9,2,0,0,11,9,1,0,0,10,10,5,2,7,0,0,1,1,0
"08014796",ESC-ZER,Centre públic Dep. i CEB,Escola de Borredà - ZER Berguedà Centre,Borredà,CCE,CCE,1,2,1,0,1,0,1,0,0,1,0,1,0,0,1,2,0,1,1,1,1,1,0,0
"08014814",ESC,Centre públic Dep. i CEB,Escola El Bruc,El Bruc,CCE,PEN,1,9,0,1,1,9,2,0,0,11,9,0,0,0,9,9,5,2,7,0,0,1,1,0
"08014841",ESC-ZER,Centre públic Dep. i CEB,Escola Les Oliveres - ZER Serra d'Ancosa,Cabrera d'Anoia,CCE,PEN,1,4,1,0,1,0,6,0,0,6,0,3,0,0,3,4,3,0,3,1,1,1,0,0
"08014905",ESC,Centre públic Dep. i CEB,Escola L'Olivera,Cabrils,MVO,MVO,1,16,0,4,4,13,1,0,0,14,13,1,0,0,14,14,0,0,0,2,2,1,1,0
"08014929",ESC,Centre públic Dep. i CEB,Escola Alta Segarra,Calaf,CCE,CCE,1,19,0,0,0,18,0,0,1,19,18,0,0,1,19,19,6,1,7,0,0,1,1,0
"08015004",ESC,Centre públic Dep. i CEB,Escola Sagrada Família,Caldes d'Estrac,MVO,MVO,1,16,1,0,1,11,0,0,0,11,11,0,0,0,11,12,11,0,11,1,1,1,1,0
"08015077",ESC,Centre públic Dep. i CEB,Escola El Farell,Caldes de Montbui,MVO,MVO,1,19,1,0,1,16,2,0,0,18,16,2,0,0,18,19,2,0,2,1,1,1,1,0
"08015107",ESC-ZER,Centre públic Dep. i CEB,Escola Anton Busquets i Punset - ZER El Moianès Ponent,Calders,CCE,CCE,1,7,1,1,2,4,0,0,0,4,4,0,0,0,4,5,2,0,2,2,2,1,0,0
"08015119",ESC,Centre públic Dep. i CEB,Escola La Minerva,Calella,MVO,MVO,1,18,1,0,1,20,0,0,0,20,17,0,0,0,17,18,17,0,17,1,1,1,1,0
"08015144",ESC,Centre públic Dep. i CEB,Escola El Far,Calella,MVO,MVO,1,18,1,7,8,18,0,0,0,18,17,0,0,0,17,18,17,0,17,1,1,1,1,0
"08015171",INS,Centre públic Dep. i CEB,Institut Bisbe Sivilla,Calella,MVO,MVO,1,29,1,0,1,22,0,0,0,22,22,0,0,0,22,23,0,0,0,1,1,1,1,0
"08015193",ESC,Centre públic Dep. i CEB,Escola Sant Marc,Calldetenes,CCE,CCE,1,15,2,0,2,0,0,6,6,12,0,0,6,6,12,14,6,0,6,2,2,1,1,0
"08015201",EE,EE Privats,L'Estel,Vic,CCE,CCE,0,1,0,0,0,0,0,0,0,0,3,0,0,0,3,3,0,0,0,0,0,0,1,0
"08015247",ESC,Centre públic Dep. i CEB,Escola Joventut,Callús,CCE,CCE,1,10,1,0,1,0,0,10,0,10,0,0,9,0,9,10,9,0,9,1,1,1,1,0
"08015259",ESC-ZER,Centre públic Dep. i CEB,Escola L'Alzinar - ZER Baix Montseny,Campins,MVO,MVO,1,3,1,0,1,3,0,0,0,3,2,0,0,0,2,3,2,0,2,1,1,1,0,0
"08015302",ESC,Centre públic Dep. i CEB,Escola Misericòrdia,Canet de Mar,MVO,MVO,1,17,1,0,1,17,0,0,0,17,16,0,0,0,16,17,16,0,16,1,1,1,1,0
"08015351",ESC,Centre públic Dep. i CEB,Escola Jacint Verdaguer,Sanaüja (Canovelles),MVO,MVO,1,13,1,0,1,10,0,0,0,10,10,0,0,0,10,11,3,0,3,1,1,1,1,0
"08015375",ESC,Centre públic Dep. i CEB,Escola l'Estelada,Cànoves (Cànoves i Samalús),MVO,MVO,1,10,1,0,1,8,6,0,0,14,8,1,0,0,9,10,8,1,9,1,1,1,1,0
"08015399",ESC,Centre públic Dep. i CEB,Escola Sant Nicolau,Canyelles,BCO,PEN,1,18,1,0,1,18,0,0,0,18,17,0,0,0,17,18,17,0,17,1,1,1,1,0
"08015430",ESC,Centre públic Dep. i CEB,Escola Marquès de la Pobla,Capellades,CCE,PEN,1,24,0,0,0,9,0,0,8,17,9,0,0,8,17,17,9,0,9,0,0,1,1,0
"08015454",ESC,Centre públic Dep. i CEB,Escola Ramon Macip - Dolors Granés,Cardedeu,MVO,MVO,1,18,1,5,6,10,0,0,0,10,10,0,0,0,10,11,0,0,0,6,5,1,1,0
"08015582",ESC,Centre públic Dep. i CEB,Escola Patrocini,Cardona,CCE,CCE,1,9,1,0,1,0,2,9,0,11,0,2,6,0,8,9,8,0,8,1,1,1,1,0
"08015612",ESC-ZER,Centre públic Dep. i CEB,Escola Joan de Palà - ZER El Cardener,La Coromina (Cardona),CCE,CCE,1,2,0,0,0,2,0,0,0,2,2,0,0,0,2,2,2,0,2,0,0,1,0,0
"08015648",ESC,Centre públic Dep. i CEB,Escola Serra de Coll-Bas,Carme,CCE,PEN,1,9,0,0,0,4,1,0,0,5,4,1,0,0,5,5,4,1,5,0,0,1,1,0
"08015651",ESC,Centre públic Dep. i CEB,Escola Princesa Làscaris,Casserres,CCE,CCE,1,9,1,0,1,0,2,6,0,8,0,2,6,0,8,9,6,2,8,1,1,1,1,0
"08015806",ESC,Centre públic Dep. i CEB,Escola Jaume Balmes,El Borràs (Castellbell i el Vilar),CCE,CCE,1,12,0,0,0,9,2,0,0,11,9,2,0,0,11,11,9,2,11,0,0,1,1,0
"08015821",ESC,Centre públic Dep. i CEB,Escola Mare de Déu de Montserrat,Castellbisbal,VOC,VOC,1,16,0,0,0,16,0,1,0,17,16,0,0,0,16,16,0,0,0,0,0,1,1,0
"08015831",ESC,Centre públic Dep. i CEB,Escola La Popa,Castellcir,CCE,CCE,1,9,2,1,3,1,0,0,0,1,1,0,0,0,1,3,0,0,0,3,3,1,1,0
"08015843",ESC,Centre públic Dep. i CEB,Escola Lluís Vives,Castelldefels,BLL,BLL,1,18,0,0,0,18,0,0,0,18,18,0,0,0,18,18,18,0,18,0,0,1,1,0
"08015855",ESC,Centre públic Dep. i CEB,Escola Els Pins,Castelldefels,BLL,BLL,1,19,0,0,0,18,0,0,0,18,18,0,0,0,18,18,18,0,18,0,0,1,1,0
"08015961",ESC,Centre públic Dep. i CEB,Escola Jacint Verdaguer,Castelldefels,BLL,BLL,1,9,0,0,0,7,2,0,0,9,7,2,0,0,9,9,7,2,9,0,0,1,1,0
"08016033",ESC,Centre públic Dep. i CEB,Escola Montanyans,Sant Marçal (Castellet i la Gornal),BCO,PEN,1,9,1,1,2,0,7,0,0,7,0,7,0,0,7,8,3,4,7,2,2,1,1,0
"08016082",ESC-ZER,Centre públic Dep. i CEB,Escola Sant Roc - ZER Vent d'Avall,Castellfollit de Riubregós,CCE,CCE,1,1,1,0,1,0,0,0,0,0,0,0,1,0,1,2,0,0,0,0,0,1,1,0
"08016094",ESC,Centre públic Dep. i CEB,Escola Sant Miquel,Castellgalí,CCE,CCE,1,9,1,2,3,9,0,0,0,9,8,0,0,0,8,9,8,0,8,1,1,1,1,0
"08016136",ESC-ZER,Centre públic Dep. i CEB,Escola Les Passeres - ZER Tres Branques,Castellolí,CCE,PEN,1,4,1,0,1,1,0,4,0,5,1,0,2,0,3,4,3,0,3,1,1,1,0,0
"08016161",ESC,Centre públic Dep. i CEB,Escola El Castellot,La Múnia (Castellví de la Marca),BCO,PEN,1,9,1,0,1,7,0,0,0,7,7,0,0,0,7,8,7,0,7,1,1,1,1,0
"08016173",ESC,Centre públic Dep. i CEB,Escola Mare de Déu de Montserrat,Castellví de Rosanes,BLL,BLL,1,15,1,0,1,0,0,8,0,8,0,0,8,0,8,9,4,0,4,1,1,1,1,0
"08016185",ESC,Centre públic Dep. i CEB,Escola Ildefons Cerdà,Centelles,CCE,CCE,1,17,0,0,0,0,17,0,0,17,0,17,0,0,17,17,0,17,17,0,0,1,1,0
"08016240",ESC,Centre públic Dep. i CEB,Escola Santa Maria de Cervelló,Cervelló,BLL,BLL,1,19,0,0,0,19,0,0,0,19,19,0,0,0,19,19,19,0,19,0,0,1,1,0
"08016264",ESC,Centre públic Dep. i CEB,Escola El Solell,La Palma de Cervelló,BLL,BLL,1,12,0,16,16,16,0,0,0,16,12,0,0,0,12,12,12,0,12,0,0,1,1,0
"08016291",ESC-ZER,Centre públic Dep. i CEB,Escola Quatre Vents - ZER Vent d'Avall,Copons,CCE,PEN,1,4,2,0,2,2,0,0,0,2,2,0,0,0,2,4,0,0,0,2,2,1,0,0
"08016331",ESC,Centre públic Dep. i CEB,Escola Jaume Balmes,Corbera de Llobregat,BLL,BLL,1,17,1,0,1,0,15,0,0,15,0,15,0,0,15,16,0,15,15,1,1,1,1,0
"08016367",ESC,Centre públic Dep. i CEB,Escola Dolors Almeda,Cornellà de Llobregat,BLL,BLL,1,18,0,0,0,12,6,0,0,18,12,6,0,0,18,18,12,6,18,0,0,1,1,0
"08016380",ESC,Centre públic Dep. i CEB,Escola Anselm Clavé,Cornellà de Llobregat,BLL,BLL,1,9,0,0,0,2,7,0,0,9,2,7,0,0,9,9,2,7,9,0,0,1,1,0
"08016392",ESC,Centre públic Dep. i CEB,Escola Mossèn Jacint Verdaguer,Cornellà de Llobregat,BLL,BLL,1,9,3,3,6,5,1,0,0,6,5,1,0,0,6,9,5,1,6,3,3,1,1,0
"08016409",ESC,Centre públic Dep. i CEB,Escola Montserrat,Cornellà de Llobregat,BLL,BLL,1,9,1,0,1,7,1,0,0,8,7,1,0,0,8,9,7,1,8,1,1,1,1,0
"08016410",ESC,Centre públic Dep. i CEB,Escola Sant Ildefons,Cornellà de Llobregat,BLL,BLL,1,12,1,0,1,11,0,0,0,11,11,0,0,0,11,12,7,0,7,1,1,1,1,0
"08016422",ESC,Centre públic Dep. i CEB,Escola Abat Oliba,Cornellà de Llobregat,BLL,BLL,1,12,2,1,3,0,0,5,0,5,0,0,5,0,5,7,4,0,4,3,3,1,1,0
"08016744",ESC,Centre públic Dep. i CEB,Escola Antoni Gaudí,Cornellà de Llobregat,BLL,BLL,1,12,2,0,2,12,0,0,0,12,10,0,0,0,10,12,3,0,3,2,2,1,1,0
"08016771",ESC,Centre públic Dep. i CEB,Escola Els Pins,Cornellà de Llobregat,BLL,BLL,1,18,2,0,2,17,2,0,0,19,16,0,0,0,16,18,9,2,11,2,2,1,1,0
"08016781",INS,Centre públic Dep. i CEB,Institut Esteve Terradas i Illa,Cornellà de Llobregat,BLL,BLL,1,40,1,19,20,9,9,25,1,44,9,9,21,0,39,40,34,5,39,1,1,1,1,0
"08016793",INS,Centre públic Dep. i CEB,Institut Francesc Macià,Cornellà de Llobregat,BLL,BLL,1,33,3,3,6,26,0,0,0,26,26,0,0,0,26,29,26,0,26,6,6,1,1,0
"08016811",ESC,Centre públic Dep. i CEB,Escola Josep Andreu - Charlie Rivel,Cubelles,BCO,PEN,1,22,0,4,4,23,0,0,0,23,22,0,0,0,22,22,6,0,6,0,0,1,1,0
"08016872",ESC,Centre públic Dep. i CEB,Escola Mare de Déu de la Muntanya,Esparreguera,BLL,BLL,1,9,1,0,1,4,4,0,0,8,4,4,0,0,8,9,4,4,8,1,1,1,1,0
"08016938",ESC,Centre públic Dep. i CEB,Escola Taquígraf Garriga,Esparreguera,BLL,BLL,1,15,0,0,0,18,0,0,0,18,15,0,0,0,15,15,10,0,10,0,0,1,1,0
"08016941",ESC,Centre públic Dep. i CEB,Escola Isidre Martí,Esplugues de Llobregat,BLL,BLL,1,16,2,0,2,0,1,13,0,14,0,1,13,0,14,16,13,1,14,2,2,1,1,0
"08017104",ESC,Centre públic Dep. i CEB,Escola Gras i Soler,Esplugues de Llobregat,BLL,BLL,1,9,1,0,1,0,9,0,0,9,0,8,0,0,8,9,0,5,5,1,1,1,1,0
"08017116",ESC,Centre públic Dep. i CEB,Escola Matilde Orduña,Esplugues de Llobregat,BLL,BLL,1,9,2,3,5,0,10,0,0,10,0,7,0,0,7,9,0,7,7,2,2,1,1,0
"08017131",INS,Centre públic Dep. i CEB,Institut Severo Ochoa,Esplugues de Llobregat,BLL,BLL,1,31,0,24,24,23,1,0,0,24,23,1,0,0,24,24,1,1,2,7,7,1,1,0
"08017153",INS,Centre públic Dep. i CEB,Institut Joanot Martorell,Esplugues de Llobregat,BLL,BLL,1,21,0,0,0,19,0,0,0,19,19,0,0,0,19,19,0,0,0,0,0,1,1,0
"08017232",ESC,Centre públic Dep. i CEB,Escola Agrupació Sant Jordi,Fonollosa,CCE,CCE,1,9,1,0,1,0,0,9,0,9,0,0,8,0,8,9,0,0,0,1,1,1,1,0
"08017244",ESC,Centre públic Dep. i CEB,Escola Font-rúbia,Guardiola de Font-Rubí (Font-rubí),BCO,PEN,1,9,0,8,8,4,0,0,1,5,4,0,0,1,5,5,3,0,3,4,3,1,1,0
"08017271",ESC,Centre públic Dep. i CEB,Escola Joan Sanpera i Torras,Corró d'Avall (Les Franqueses del Vallès),MVO,MVO,1,18,0,3,3,15,0,0,0,15,15,0,0,0,15,15,10,0,10,3,3,1,1,0
"08017311",ESC,Centre públic Dep. i CEB,Escola Puiggraciós,La Garriga,MVO,MVO,1,18,1,0,1,13,0,6,0,19,13,0,4,0,17,18,0,0,0,1,1,1,1,0
"08017359",ESC,Centre públic Dep. i CEB,Escola Salvador Lluch,Gavà,BLL,BLL,1,18,1,0,1,17,0,0,0,17,17,0,0,0,17,18,12,0,12,1,1,1,1,0
"08017360",ESC,Centre públic Dep. i CEB,Escola Jacme March,Gavà,BLL,BLL,1,9,8,2,10,7,0,1,0,8,1,0,0,0,1,9,1,0,1,8,3,1,1,0
"08017505",ESC,Centre públic Dep. i CEB,Escola Juan Salamero,Gavà,BLL,BLL,1,9,2,0,2,0,2,0,0,2,0,2,0,0,2,4,0,0,0,2,2,1,1,0
"08017530",INS,Centre públic Dep. i CEB,Institut de Bruguers,Gavà,BLL,BLL,1,23,5,0,5,6,1,0,0,7,6,1,0,0,7,12,0,0,0,5,5,1,1,0
"08017611",ESC,Centre públic Dep. i CEB,Escola Montcau,Gelida,BCO,PEN,1,16,0,0,0,17,0,0,0,17,16,0,0,0,16,16,16,0,16,0,0,1,1,0
"08017633",ESC,Centre públic Dep. i CEB,Escola Sant Marc,Els Bassacs (Gironella),CCE,CCE,1,11,0,4,4,4,3,0,0,7,4,3,0,0,7,7,4,3,7,4,3,1,1,0
"08017645",ESC,Centre públic Dep. i CEB,Escola de Gironella,Gironella,CCE,CCE,1,9,0,12,12,2,2,3,0,7,2,2,3,0,7,7,5,2,7,2,2,1,1,0
"08017682",ESC,Centre públic Dep. i CEB,Escola Jacint Verdaguer,La Granada,BCO,PEN,1,9,4,0,4,9,0,0,0,9,5,0,0,0,5,9,5,0,5,4,3,1,1,0
"08017694",ESC,Centre públic Dep. i CEB,Escola Pereanton,Granollers,MVO,MVO,1,9,1,0,1,12,0,0,0,12,8,0,0,0,8,9,8,0,8,1,1,1,1,0
"08017700",ESC,Centre públic Dep. i CEB,Escola Joan Solans,Granollers,MVO,MVO,1,9,1,1,2,0,7,0,0,7,0,7,0,0,7,8,0,7,7,2,2,1,1,0
"08017712",ESC,Centre públic Dep. i CEB,Escola Ferrer i Guàrdia,Granollers,MVO,MVO,1,9,1,0,1,5,2,2,0,9,5,2,1,0,8,9,5,0,5,1,1,1,1,0
"08017815",IE,Concertada 30% NESE,L'Estel,Granollers,MVO,MVO,0,13,0,0,0,0,0,0,0,0,13,0,0,0,13,13,0,0,0,0,0,0,1,0
"08017840",IE,Concertada 30% NESE,Educem,Granollers,MVO,MVO,0,13,0,0,0,0,0,0,0,0,13,0,0,0,13,13,0,0,0,0,0,0,1,0
"08017852",INS,EPRI & ESO Municipals no CEB,Institut Escola del Treball,Granollers,MVO,MVO,0,38,0,0,0,0,0,0,0,0,38,0,0,0,38,38,0,0,0,0,0,0,1,0
"08017918",ESC,Centre públic Dep. i CEB,Escola Granullarius,Granollers,MVO,MVO,1,19,1,3,4,20,0,0,0,20,18,0,0,0,18,19,6,0,6,1,1,1,1,0
"08017931",INS,Centre públic Dep. i CEB,Institut Antoni Cumella,Granollers,MVO,MVO,1,28,0,0,0,4,5,2,0,11,4,5,2,0,11,11,0,5,5,0,0,1,1,0
"08017979",ESC,Centre públic Dep. i CEB,Escola Aqua Alba,Gualba,MVO,MVO,1,9,0,0,0,2,2,0,0,4,2,2,0,0,4,4,2,0,2,0,0,1,1,0
"08017992",ESC,Centre públic Dep. i CEB,Escola Montserrat,Sant Salvador de Guardiola,CCE,CCE,1,12,1,0,1,12,0,0,0,12,11,0,0,0,11,12,11,0,11,1,1,1,1,0
"08018005",ESC,Centre públic Dep. i CEB,Escola Sant Llorenç,Guardiola de Berguedà,CCE,CCE,1,9,2,0,2,0,1,1,0,2,0,1,1,0,2,4,0,0,0,2,2,1,1,0
"08018017",ESC-ZER,Centre públic Dep. i CEB,Escola L'Albiol - ZER Alt Berguedà,Sant Julià de Cerdanyola,CCE,CCE,1,1,1,1,2,0,0,1,1,2,0,0,0,0,0,1,0,0,0,1,1,1,0,0
"08018029",ESC,Centre públic Dep. i CEB,Escola Les Escoles,Gurb,CCE,CCE,1,18,0,0,0,6,3,12,0,21,6,3,9,0,18,18,18,0,18,0,0,1,1,0
"08018066",ESC,Centre públic Dep. i CEB,Escola Menéndez Pidal,L'Hospitalet de Llobregat,BCO,BCO,1,27,1,24,25,6,0,8,1,15,6,0,8,1,15,16,2,0,2,12,7,1,1,0
"08018078",ESC,Centre públic Dep. i CEB,Escola Bellvitge,L'Hospitalet de Llobregat,BCO,BCO,1,9,1,0,1,8,0,1,0,9,8,0,0,0,8,9,8,0,8,1,1,1,1,0
"08018091",ESC,Centre públic Dep. i CEB,Escola Pep Ventura,L'Hospitalet de Llobregat,BCO,BCO,1,20,2,4,6,11,7,0,0,18,11,7,0,0,18,20,11,7,18,2,2,1,1,0
"08018145",ESC,Centre públic Dep. i CEB,Escola Pau Vila,L'Hospitalet de Llobregat,BCO,BCO,1,12,2,0,2,9,0,0,0,9,9,0,0,0,9,11,4,0,4,2,2,1,1,0
"08018157",ESC,Centre públic Dep. i CEB,Escola Santiago Ramon y Cajal,L'Hospitalet de Llobregat,BCO,BCO,1,19,4,0,4,19,0,0,0,19,15,0,0,0,15,19,15,0,15,4,4,1,1,0
"08018376",IE,Concertada 30% NESE,La Florida,L'Hospitalet de Llobregat,BCO,BCO,0,13,0,0,0,0,0,0,0,0,13,0,0,0,13,13,0,0,0,0,0,0,1,0
"08019149",ESC,Centre públic Dep. i CEB,Escola Bernat Metge,L'Hospitalet de Llobregat,BCO,BCO,1,10,1,0,1,10,0,0,0,10,9,0,0,0,9,10,9,0,9,1,1,1,1,0
"08019198",ESC,Centre públic Dep. i CEB,Escola Pompeu Fabra,L'Hospitalet de Llobregat,BCO,BCO,1,19,3,7,10,16,2,0,0,18,16,0,0,0,16,19,0,0,0,3,3,1,1,0
"08019216",ESC,Centre públic Dep. i CEB,Escola Busquets i Punset,L'Hospitalet de Llobregat,BCO,BCO,1,18,1,1,2,18,1,0,0,19,17,0,0,0,17,18,6,0,6,1,1,1,1,0
"08019231",ESC,Centre públic Dep. i CEB,Escola Milagros Consarnau,L'Hospitalet de Llobregat,BCO,BCO,1,19,3,2,5,17,1,0,0,18,16,0,0,0,16,19,16,0,16,3,3,1,1,0
"08019241",ESC,Centre públic Dep. i CEB,Escola Frederic Mistral,L'Hospitalet de Llobregat,BCO,BCO,1,18,1,1,2,18,0,0,0,18,17,0,0,0,17,18,17,0,17,1,1,1,1,0
"08019265",ESC,Centre públic Dep. i CEB,Escola Joaquim Ruyra,L'Hospitalet de Llobregat,BCO,BCO,1,18,5,4,9,12,4,0,0,16,12,1,0,0,13,18,8,4,12,5,5,1,1,0
"08019277",ESC,Centre públic Dep. i CEB,Escola La Marina,L'Hospitalet de Llobregat,BCO,BCO,1,51,0,12,12,12,1,1,1,15,12,1,1,1,15,15,5,1,6,12,12,1,1,0
"08019290",ESC,Centre públic Dep. i CEB,Escola Provençana,L'Hospitalet de Llobregat,BCO,BCO,1,9,0,0,0,9,0,0,0,9,9,0,0,0,9,9,3,0,3,0,0,1,1,0
"08019307",INS,Centre públic Dep. i CEB,Institut Santa Eulàlia,L'Hospitalet de Llobregat,BCO,BCO,1,27,1,0,1,16,2,0,0,18,16,2,0,0,18,19,0,0,0,1,1,1,1,0
"08019319",INS,Centre públic Dep. i CEB,Institut Pedraforca,L'Hospitalet de Llobregat,BCO,BCO,1,29,0,0,0,0,28,0,0,28,0,28,0,0,28,28,0,28,28,0,0,1,1,0
"08019320",INS,Centre públic Dep. i CEB,Institut Torras i Bages,L'Hospitalet de Llobregat,BCO,BCO,1,23,0,0,0,18,1,0,0,19,18,1,0,0,19,19,0,0,0,0,0,1,1,0
"08019371",FP,Centre públic Dep. i CEB,Institut Llobregat,L'Hospitalet de Llobregat,BCO,BCO,1,5,0,0,0,6,1,0,0,7,5,0,0,0,5,5,5,0,5,0,0,1,1,0
"08019401",FP,Centre públic Dep. i CEB,Institut Provençana,L'Hospitalet de Llobregat,BCO,BCO,1,22,0,0,0,20,0,1,1,22,20,0,1,1,22,22,0,0,0,0,0,1,1,0
"08019411",INS,Centre públic Dep. i CEB,Institut Bellvitge,L'Hospitalet de Llobregat,BCO,BCO,1,19,0,3,3,13,1,0,0,14,13,1,0,0,14,14,0,0,0,3,3,1,1,0
"08019435",ESC,Centre públic Dep. i CEB,Escola García i Fossas,Igualada,CCE,PEN,1,18,0,1,1,11,8,0,0,19,11,7,0,0,18,18,11,7,18,0,0,1,1,0
"08019459",ESC,Centre públic Dep. i CEB,Escola Gabriel Castella i Raich,Igualada,CCE,PEN,1,9,0,0,0,6,3,0,0,9,6,3,0,0,9,9,6,3,9,0,0,1,1,0
"08019460",ESC,Centre públic Dep. i CEB,Escola Emili Vallès,Igualada,CCE,PEN,1,9,0,1,1,0,0,8,2,10,0,0,8,1,9,9,8,1,9,0,0,1,1,0
"08019472",EE,EE Privats,Àuria,Igualada,CCE,PEN,0,1,0,0,0,0,0,0,0,0,4,0,0,0,4,4,0,0,0,0,0,0,1,0
"08019514",ESC,Concertada 30% NESE,Jesús Maria,Igualada,CCE,PEN,0,8,0,0,0,0,0,0,0,0,8,0,0,0,8,8,0,0,0,0,0,0,1,0
"08019630",INS,Centre públic Dep. i CEB,Institut Pere Vives i Vich,Igualada,CCE,PEN,1,33,0,0,0,16,0,0,0,16,16,0,0,0,16,16,0,0,0,0,0,1,1,0
"08019642",ESC,Centre públic Dep. i CEB,Escola Pare Ramon Castelltort i Miralda,Igualada,CCE,PEN,1,18,0,0,0,14,1,2,1,18,14,1,2,1,18,18,8,1,9,0,0,1,1,0
"08019654",INS,Centre públic Dep. i CEB,Institut Milà i Fontanals,Igualada,CCE,PEN,1,33,0,5,5,35,0,0,0,35,33,0,0,0,33,33,0,0,0,0,0,1,1,0
"08019678",ESC,Centre públic Dep. i CEB,Escola Guerau de Jorba,Jorba,CCE,PEN,1,9,1,0,1,0,0,4,0,4,0,0,4,0,4,5,2,0,2,1,1,1,1,0
"08019691",ESC-ZER,Centre públic Dep. i CEB,Escola Vilademàger - ZER Serra d'Ancosa,La Llacuna,CCE,PEN,1,4,2,0,2,1,1,0,0,2,1,1,0,0,2,4,1,0,1,2,2,1,0,0
"08019711",ESC,Centre públic Dep. i CEB,Escola Sagrada Família,La Llagosta,MVO,MVO,1,12,1,14,15,7,2,0,0,9,7,2,0,0,9,10,0,0,0,3,3,1,1,0
"08019745",ESC,Centre públic Dep. i CEB,Escola Joan Maragall,La Llagosta,MVO,MVO,1,16,1,0,1,0,18,0,0,18,0,15,0,0,15,16,0,9,9,1,1,1,1,0
"08019782",ESC,Centre públic Dep. i CEB,Escola Salvador Sanromà,Llinars del Vallès,MVO,MVO,1,17,0,0,0,18,0,0,0,18,17,0,0,0,17,17,0,0,0,0,0,1,1,0
"08019824",ESC,Centre públic Dep. i CEB,Escola Les Llisses,Lliçà de Vall,MVO,MVO,1,14,1,0,1,15,0,0,0,15,13,0,0,0,13,14,0,0,0,1,1,1,1,0
"08019861",ESC-ZER,Centre públic Dep. i CEB,Escola Gafarró - ZER Alt Lluçanès,Santa Eulàlia de Puig-oriol (Lluçà),CCE,CCE,1,3,1,0,1,2,0,0,0,2,2,0,0,0,2,3,2,0,2,1,1,1,0,0
"08019873",ESC,Centre públic Dep. i CEB,Escola Mare de Déu de Montserrat,Malgrat de Mar,MVO,MVO,1,9,1,0,1,0,8,0,0,8,0,8,0,0,8,9,0,8,8,1,1,1,1,0
"08019927",ESC,Centre públic Dep. i CEB,Escola Marià Cubí i Soler,Malgrat de Mar,MVO,MVO,1,18,1,1,2,25,1,5,0,31,17,0,0,0,17,18,15,1,16,1,1,1,1,0
"08019940",ESC,Centre públic Dep. i CEB,Escola Puig-Agut,Manlleu,CCE,CCE,1,13,0,0,0,16,0,0,0,16,13,0,0,0,13,13,0,0,0,0,0,1,1,0
"08019952",INS,Concertada 30% NESE,La Salle Manlleu,Manlleu,CCE,CCE,0,12,0,0,0,0,0,0,0,0,12,0,0,0,12,12,0,0,0,0,0,0,1,0
"08019976",ESC,Concertada 30% NESE,Vedruna Manlleu,Manlleu,CCE,CCE,0,25,0,0,0,0,0,0,0,0,25,0,0,0,25,25,0,0,0,0,0,0,1,0
"08020012",ESC,Centre públic Dep. i CEB,Escola Muntanya del Drac,Manresa,CCE,CCE,1,9,2,2,4,6,0,1,0,7,6,0,1,0,7,9,7,0,7,2,2,1,1,0
"08020061",ESC,Centre públic Dep. i CEB,Escola La Renaixença,Manresa,CCE,CCE,1,9,0,0,0,9,0,6,0,15,9,0,0,0,9,9,4,0,4,0,0,1,1,0
"08020073",ESC,Centre públic Dep. i CEB,Escola Sant Ignasi,Manresa,CCE,CCE,1,19,0,0,0,18,1,0,0,19,18,1,0,0,19,19,14,0,14,0,0,1,1,0
"08020097",ESC,Centre públic Dep. i CEB,Escola Pare Algué,Manresa,CCE,CCE,1,9,0,5,5,4,0,0,0,4,4,0,0,0,4,4,4,0,4,5,3,1,1,0
"08020127",ESC,Centre públic Dep. i CEB,Escola Bages,Manresa,CCE,CCE,1,18,1,0,1,2,16,0,0,18,2,15,0,0,17,18,2,15,17,1,1,1,1,0
"08020140",IE,Concertada 30% NESE,FEDAC-Manresa,Manresa,CCE,CCE,0,26,0,0,0,0,0,0,0,0,26,0,0,0,26,26,0,0,0,0,0,0,1,0
"08020309",IE,Concertada 30% NESE,Mare de Déu del Pilar,Manresa,CCE,CCE,0,13,0,0,0,0,0,0,0,0,13,0,0,0,13,13,0,0,0,0,0,0,1,0
"08020462",INS,Centre públic Dep. i CEB,Institut Lacetània,Manresa,CCE,CCE,1,49,1,0,1,45,0,0,0,45,45,0,0,0,45,46,0,0,0,1,1,1,1,0
"08020474",INS,Centre públic Dep. i CEB,Institut Lluís de Peguera,Manresa,CCE,CCE,1,44,2,0,2,0,0,35,0,35,0,0,35,0,35,37,35,0,35,2,2,1,1,0
"08020498",ESC,Centre públic Dep. i CEB,Escola Els Convents,Martorell,BLL,BLL,1,9,3,0,3,0,0,0,9,9,0,0,0,6,6,9,0,0,0,3,3,1,1,0
"08020516",EE,Centre públic Dep. i CEB,CEE El Pontarró,Martorell,BLL,BLL,1,10,10,1,11,0,10,0,0,10,0,0,0,0,0,10,0,0,0,10,3,1,1,0
"08020607",ESC,Centre públic Dep. i CEB,Escola Juan Ramón Jiménez,Martorell,BLL,BLL,1,18,1,0,1,17,0,0,0,17,17,0,0,0,17,18,17,0,17,1,1,1,1,0
"08020619",ESC,Centre públic Dep. i CEB,Escola José Echegaray,Martorell,BLL,BLL,1,18,4,0,4,16,0,0,0,16,14,0,0,0,14,18,14,0,14,4,4,1,1,0
"08020620",INS,Centre públic Dep. i CEB,Institut Pompeu Fabra,Martorell,BLL,BLL,1,37,1,0,1,29,2,0,0,31,29,2,0,0,31,32,29,2,31,1,1,1,1,0
"08020656",ESC,Centre públic Dep. i CEB,Escola Simeó Rabasa,Martorelles,MVO,MVO,1,9,0,0,0,13,2,0,0,15,9,0,0,0,9,9,5,1,6,0,0,1,1,0
"08020701",ESC,Centre públic Dep. i CEB,Escola Comtes de Lacambra,Vinyoles d'Orís (Les Masies de Voltregà),CCE,CCE,1,9,2,0,2,0,7,0,0,7,0,7,0,0,7,9,0,7,7,2,2,1,1,0
"08020723",ESC,Centre públic Dep. i CEB,Escola Ocata,El Masnou,MVO,MVO,1,9,0,0,0,5,4,0,0,9,5,4,0,0,9,9,5,4,9,0,0,1,1,0
"08020826",INS,Centre públic Dep. i CEB,Institut Maremar,El Masnou,MVO,MVO,1,16,0,0,0,4,1,0,1,6,4,1,0,1,6,6,4,2,6,0,0,1,1,0
"08020838",INS,Centre públic Dep. i CEB,Institut Mediterrània,El Masnou,MVO,MVO,1,20,0,0,0,19,0,0,0,19,19,0,0,0,19,19,19,0,19,0,0,1,1,0
"08020841",ESC,Centre públic Dep. i CEB,Escola El Turó,Masquefa,CCE,PEN,1,19,2,0,2,0,17,0,0,17,0,17,0,0,17,19,0,10,10,2,2,1,1,0
"08020863",ESC,Centre públic Dep. i CEB,Escola Ginesta,Matadepera,VOC,VOC,1,19,4,2,6,19,0,0,0,19,15,0,0,0,15,19,0,0,0,4,4,1,1,0
"08020905",ESC,Centre públic Dep. i CEB,Escola Angeleta Ferrer,Mataró,MVO,MVO,1,18,6,3,9,0,5,0,4,9,0,5,0,4,9,15,0,9,9,9,5,1,1,0
"08020917",ESC,Centre públic Dep. i CEB,Escola Josep Manuel Peramàs,Mataró,MVO,MVO,1,19,1,0,1,18,0,0,0,18,18,0,0,0,18,19,18,0,18,1,1,1,1,0
"08020929",ESC,Centre públic Dep. i CEB,Escola Germanes Bertomeu,Mataró,MVO,MVO,1,18,1,0,1,15,0,3,0,18,15,0,2,0,17,18,6,0,6,1,1,1,1,0
"08021041",ESC,Centre públic Dep. i CEB,Escola Josep Montserrat,Mataró,MVO,MVO,1,9,1,0,1,2,0,7,1,10,2,0,6,0,8,9,3,1,4,1,1,1,1,0
"08021260",INS,Centre públic Dep. i CEB,Institut Alexandre Satorras,Mataró,MVO,MVO,1,45,1,0,1,39,0,0,0,39,39,0,0,0,39,40,39,0,39,1,1,1,1,0
"08021302",INS,Centre públic Dep. i CEB,Institut Damià Campeny,Mataró,MVO,MVO,1,27,2,0,2,20,0,0,0,20,20,0,0,0,20,22,0,0,0,2,2,1,1,0
"08021326",ESC,Centre públic Dep. i CEB,Escola La Fassina,Mediona,BCO,PEN,1,9,0,0,0,1,0,4,0,5,1,0,4,0,5,5,2,0,2,0,0,1,1,0
"08021351",ESC,Centre públic Dep. i CEB,Escola El Palau,Molins de Rei,BLL,BLL,1,9,1,0,1,9,0,0,0,9,8,0,0,0,8,9,5,0,5,1,1,1,1,0
"08021363",ESC,Centre públic Dep. i CEB,Escola L'Alzina,Molins de Rei,BLL,BLL,1,9,0,0,0,7,0,0,2,9,7,0,0,2,9,9,7,2,9,0,0,1,1,0
"08021430",INS,Centre públic Dep. i CEB,Institut Lluís de Requesens,Molins de Rei,BLL,BLL,1,31,1,10,11,0,1,0,15,16,0,1,0,15,16,17,0,0,0,11,8,1,1,0
"08021442",ESC,Centre públic Dep. i CEB,Escola Castell Ciuró,Molins de Rei,BLL,BLL,1,14,3,0,3,16,0,0,0,16,11,0,0,0,11,14,0,0,0,3,3,1,1,0
"08021466",ESC,Centre públic Dep. i CEB,Escola Col·legis Nous,Mollet del Vallès,MVO,MVO,1,11,0,0,0,9,3,0,0,12,9,2,0,0,11,11,9,2,11,0,0,1,1,0
"08021570",ESC,Centre públic Dep. i CEB,Escola del Bosc,Mollet del Vallès,MVO,MVO,1,9,1,2,3,9,0,0,0,9,8,0,0,0,8,9,2,0,2,1,1,1,1,0
"08021582",ESC,Centre públic Dep. i CEB,Escola Joan Salvat Papasseit,Mollet del Vallès,MVO,MVO,1,9,1,1,2,18,2,0,0,20,8,0,0,0,8,9,8,0,8,1,1,1,1,0
"08021594",INS,Centre públic Dep. i CEB,Institut de Mollet del Vallès,Mollet del Vallès,MVO,MVO,1,33,0,0,0,20,0,0,2,22,20,0,0,2,22,22,20,2,22,0,0,1,1,0
"08021600",INS,Centre públic Dep. i CEB,Institut Vicenç Plantada,Mollet del Vallès,MVO,MVO,1,32,0,0,0,26,0,0,0,26,26,0,0,0,26,26,26,0,26,0,0,1,1,0
"08021612",EE,EE municipals,CEE Can Vila,Mollet del Vallès,MVO,MVO,0,1,0,0,0,0,0,0,0,0,4,0,0,0,4,4,0,0,0,0,0,0,1,0
"08021685",ESC,Centre públic Dep. i CEB,Escola Font Freda,Montcada i Reixac,VOC,VOC,1,14,2,1,3,14,0,0,0,14,12,0,0,0,12,14,12,0,12,2,2,1,1,0
"08021764",ESC,Centre públic Dep. i CEB,Escola Mitja Costa,Montcada i Reixac,VOC,VOC,1,9,1,0,1,9,0,0,0,9,8,0,0,0,8,9,8,0,8,1,1,1,1,0
"08021788",INS,Centre públic Dep. i CEB,Institut Montserrat Miró i Vila,Montcada i Reixac,VOC,VOC,1,20,0,0,0,16,2,0,0,18,16,2,0,0,18,18,16,2,18,0,0,1,1,0
"08021880",ESC,Centre públic Dep. i CEB,Escola Salvador Espriu,Montgat,MVO,MVO,1,16,5,0,5,0,0,11,1,12,0,0,11,0,11,16,11,0,11,5,5,1,1,0
"08021892",ESC,Centre públic Dep. i CEB,Escola Sant Pere,Monistrol de Montserrat,CCE,CCE,1,10,0,0,0,9,0,0,1,10,9,0,0,1,10,10,3,0,3,0,0,1,1,0
"08021934",ESC-ZER,Centre públic Dep. i CEB,Escola L'Esqueix - ZER El Moianès Ponent,Monistrol de Calders,CCE,CCE,1,4,1,0,1,1,0,0,1,2,1,0,0,1,2,3,1,1,2,1,1,1,0,0
"08021961",ESC,Centre públic Dep. i CEB,Escola El Rocal,Montesquiu,CCE,CCE,1,9,1,3,4,0,4,0,1,5,0,4,0,1,5,6,4,1,5,4,3,1,1,0
"08021983",ESC-ZER,Centre públic Dep. i CEB,Escola Gira-sol - ZER Baix Berguedà,Montmajor,CCE,CCE,1,4,2,0,2,2,0,0,0,2,2,0,0,0,2,4,2,0,2,2,2,1,0,0
"08022008",ESC,Centre públic Dep. i CEB,Escola Montmany,Figaró-Montmany,MVO,MVO,1,9,2,0,2,0,2,0,0,2,0,2,0,0,2,4,0,2,2,2,2,1,1,0
"08022011",ESC,Centre públic Dep. i CEB,Escola Pau Casals,Montmeló,MVO,MVO,1,13,1,0,1,15,0,0,0,15,12,0,0,0,12,13,5,0,5,1,1,1,1,0
"08022045",ESC,Centre públic Dep. i CEB,Escola Sant Jordi,Montmeló,MVO,MVO,1,18,0,0,0,18,0,0,0,18,18,0,0,0,18,18,0,0,0,0,0,1,1,0
"08022057",ESC,Centre públic Dep. i CEB,Escola Sant Sadurní,Montornès del Vallès,MVO,MVO,1,9,0,5,5,1,1,4,0,6,1,1,4,0,6,6,5,1,6,3,3,1,1,0
"08022070",ESC,Centre públic Dep. i CEB,Escola Marinada,Montornès del Vallès,MVO,MVO,1,16,1,0,1,23,2,0,0,25,15,0,0,0,15,16,15,0,15,1,1,1,1,0
"08022082",ESC-ZER,Centre públic Dep. i CEB,Escola Puig Drau - ZER Baix Montseny,Montseny,MVO,MVO,1,3,1,0,1,0,0,0,0,0,0,0,0,0,0,1,0,0,0,1,1,1,0,2
"08022094",ESC,Centre públic Dep. i CEB,Escola Josep Orriols i Roca,Moià,CCE,CCE,1,19,0,0,0,18,0,0,0,18,18,0,0,0,18,18,18,0,18,0,0,1,1,0
"08022197",ESC,Centre públic Dep. i CEB,Escola Catalunya,Navarcles,CCE,CCE,1,19,14,17,31,0,0,2,0,2,0,0,2,0,2,16,0,0,0,17,5,1,1,0
"08022331",ESC-ZER,Centre públic Dep. i CEB,Escola d'Olvan - ZER Baix Berguedà,Olvan,CCE,CCE,1,6,2,0,2,2,0,0,2,4,2,0,0,2,4,6,2,2,4,2,2,1,0,0
"08022343",ESC,Centre públic Dep. i CEB,Escola Circell,Moja (Olèrdola),BCO,PEN,1,10,1,2,3,0,0,10,0,10,0,0,9,0,9,10,0,0,0,1,1,1,1,0
"08022367",ESC,Centre públic Dep. i CEB,Escola Rossend Montané,Sant Pere Molanta (Olèrdola),BCO,PEN,1,9,1,0,1,9,0,0,0,9,8,0,0,0,8,9,8,0,8,1,1,1,1,0
"08022379",ESC,Centre públic Dep. i CEB,Escola Pont de l'Arcada,Olesa de Bonesvalls,BCO,PEN,1,9,0,0,0,3,4,0,0,7,3,4,0,0,7,7,0,4,4,0,0,1,1,0
"08022380",ESC,Centre públic Dep. i CEB,Escola Mare de Déu de Montserrat,Olesa de Montserrat,BLL,BLL,1,11,1,0,1,12,0,0,1,13,10,0,0,0,10,11,10,0,10,1,1,1,1,0
"08022461",ESC,Centre públic Dep. i CEB,Escola Sant Bernat,Olesa de Montserrat,BLL,BLL,1,17,1,0,1,22,0,0,4,26,16,0,0,0,16,17,16,0,16,1,1,1,1,0
"08022495",ESC,Centre públic Dep. i CEB,Escola Terra Nostra,Olost,CCE,CCE,1,9,2,1,3,5,0,0,2,7,5,0,0,2,7,9,5,2,7,2,2,1,1,0
"08022549",ESC-ZER,Centre públic Dep. i CEB,Escola Llevant - ZER Gavarresa,Oristà,CCE,CCE,1,2,0,0,0,1,0,0,1,2,1,0,0,1,2,2,1,1,2,0,0,1,0,0
"08022574",ESC,Centre públic Dep. i CEB,Escola Òrrius,Òrrius,MVO,MVO,1,9,2,1,3,2,0,2,0,4,2,0,2,0,4,6,3,0,3,3,3,1,1,0
"08022586",ESC,Centre públic Dep. i CEB,Escola El Drac,Pacs del Penedès,BCO,PEN,1,9,1,0,1,0,0,6,0,6,0,0,6,0,6,7,6,0,6,1,1,1,1,0
"08022598",ESC,Centre públic Dep. i CEB,Escola Les Ferreries de Palafolls,Palafolls,MVO,MVO,1,18,1,0,1,0,19,0,0,19,0,17,0,0,17,18,0,17,17,1,1,1,1,0
"08022616",ESC,Centre públic Dep. i CEB,Escola Josep Maria Folch i Torres,Palau-solità i Plegamans,VOC,VOC,1,11,0,5,5,5,2,0,0,7,5,2,0,0,7,7,0,0,0,4,3,1,1,0
"08022665",ESC,Centre públic Dep. i CEB,Escola Àngel Guimerà,Pallejà,BLL,BLL,1,9,0,0,0,4,5,0,0,9,4,5,0,0,9,9,4,5,9,0,0,1,1,0
"08022677",ESC,Centre públic Dep. i CEB,Escola Jacint Verdaguer,Pallejà,BLL,BLL,1,9,1,0,1,9,0,0,0,9,8,0,0,0,8,9,8,0,8,1,1,1,1,0
"08022689",ESC,Centre públic Dep. i CEB,Escola Pau Vila,El Papiol,BLL,BLL,1,18,1,1,2,0,0,16,5,21,0,0,16,1,17,18,11,0,11,1,1,1,1,0
"08022690",ESC,Centre públic Dep. i CEB,Escola Lluís Piquer,Parets del Vallès,MVO,MVO,1,18,1,3,4,18,0,0,0,18,17,0,0,0,17,18,2,0,2,1,1,1,1,0
"08022707",ESC,Centre públic Dep. i CEB,Escola Pompeu Fabra,Parets del Vallès,MVO,MVO,1,9,1,0,1,7,3,0,0,10,7,1,0,0,8,9,7,1,8,1,1,1,1,0
"08022720",ESC,EPRI & ESO Municipals no CEB,Escola Municipal Pau Vila,Parets del Vallès,MVO,MVO,0,18,0,0,0,0,0,0,0,0,18,0,0,0,18,18,0,0,0,0,0,0,1,0
"08022768",ESC,Centre públic Dep. i CEB,Escola Herois del Bruc,Piera,CCE,PEN,1,20,0,0,0,14,6,0,0,20,14,6,0,0,20,20,14,6,20,0,0,1,1,0
"08022801",ESC,Centre públic Dep. i CEB,Escola Antoni Doltra,Pineda de Mar,MVO,MVO,1,11,1,3,4,0,0,4,0,4,0,0,4,0,4,5,1,0,1,4,3,1,1,0
"08022835",ESC,Centre públic Dep. i CEB,Escola Jaume I,Pineda de Mar,MVO,MVO,1,16,1,0,1,13,0,0,1,14,13,0,0,1,14,15,13,1,14,1,1,1,1,0
"08022847",ESC,Centre públic Dep. i CEB,Escola Sants Abdó i Senén,El Pla del Penedès,BCO,PEN,1,9,2,1,3,6,3,0,0,9,6,1,0,0,7,9,6,1,7,2,2,1,1,0
"08022859",ESC,Centre públic Dep. i CEB,Escola Maria Borés,La Pobla de Claramunt,CCE,PEN,1,9,1,0,1,0,0,1,0,1,0,0,1,0,1,2,0,0,0,1,1,1,1,0
"08022860",ESC,Centre públic Dep. i CEB,Escola Lillet a Güell,La Pobla de Lillet,CCE,CCE,1,9,1,0,1,4,0,0,0,4,4,0,0,0,4,5,4,0,4,1,1,1,1,0
"08022884",ESC,Centre públic Dep. i CEB,Escola Joan Maragall,El Prat de Llobregat,BLL,BLL,1,9,1,1,2,10,0,0,4,14,8,0,0,0,8,9,8,0,8,1,1,1,1,0
"08022902",ESC,Centre públic Dep. i CEB,Escola del Parc,El Prat de Llobregat,BLL,BLL,1,18,0,0,0,18,0,0,0,18,18,0,0,0,18,18,6,0,6,0,0,1,1,0
"08022914",ESC,Centre públic Dep. i CEB,Escola Jaume Balmes,El Prat de Llobregat,BLL,BLL,1,18,3,1,4,21,3,0,0,24,15,0,0,0,15,18,15,0,15,3,3,1,1,0
"08022926",EE,Centre públic Dep. i CEB,CEE Can Rigol,El Prat de Llobregat,BLL,BLL,1,11,4,1,5,0,0,18,1,19,0,0,7,0,7,11,7,0,7,4,3,1,1,0
"08022938",ESC,Centre públic Dep. i CEB,Escola Jacint Verdaguer,El Prat de Llobregat,BLL,BLL,1,18,5,0,5,11,0,0,0,11,11,0,0,0,11,16,11,0,11,5,5,1,1,0
"08023131",INS,Centre públic Dep. i CEB,Institut Baldiri Guilera,El Prat de Llobregat,BLL,BLL,1,26,18,0,18,6,0,0,0,6,6,0,0,0,6,24,0,0,0,18,7,1,1,0
"08023141",ESC-ZER,Centre públic Dep. i CEB,Escola Mare de Déu del Portal - ZER Vent d'Avall,Els Prats de Rei,CCE,CCE,1,4,1,3,4,0,0,2,0,2,0,0,2,0,2,3,0,0,0,2,2,1,0,0
"08023189",ESC,Concertada 30% NESE,FEDAC-Prats,Prats de Lluçanès,CCE,CCE,0,4,0,0,0,0,0,0,0,0,4,0,0,0,4,4,0,0,0,0,0,0,1,0
"08023207",ESC,Centre públic Dep. i CEB,Escola Lluçanès,Prats de Lluçanès,CCE,CCE,1,9,0,0,0,9,0,0,0,9,9,0,0,0,9,9,5,0,5,0,0,1,1,0
"08023232",ESC,Centre públic Dep. i CEB,Escola Sant Cristòfol,Premià de Mar,MVO,MVO,1,14,0,0,0,12,3,0,0,15,12,2,0,0,14,14,0,0,0,0,0,1,1,0
"08023335",ESC,Centre públic Dep. i CEB,Escola Montserrat,Premià de Mar,MVO,MVO,1,17,0,7,7,5,0,4,1,10,5,0,4,1,10,10,0,1,1,7,5,1,1,0
"08023359",ESC-ZER,Centre públic Dep. i CEB,Escola Virolai - ZER Cep de Sis,Puigdàlber,BCO,PEN,1,4,1,1,2,0,0,3,0,3,0,0,3,0,3,4,1,0,1,1,1,1,0,0
"08023372",ESC,Centre públic Dep. i CEB,Escola Alfred Mata,Puig-reig,CCE,CCE,1,9,1,1,2,0,4,0,0,4,0,4,0,0,4,5,0,4,4,2,2,1,1,0
"08023426",ESC,Centre públic Dep. i CEB,Escola Gassó i Vidal,Ripollet,VOC,VOC,1,9,1,0,1,8,1,0,0,9,8,0,0,0,8,9,8,0,8,1,1,1,1,0
"08023542",ESC,Centre públic Dep. i CEB,Escola Tiana de la Riba,Ripollet,VOC,VOC,1,9,1,0,1,10,0,0,0,10,8,0,0,0,8,9,3,0,3,1,1,1,1,0
"08023554",ESC,Centre públic Dep. i CEB,Escola Josep Maria Ginesta,Ripollet,VOC,VOC,1,18,1,0,1,18,0,0,0,18,17,0,0,0,17,18,17,0,17,1,1,1,1,0
"08023566",ESC,Centre públic Dep. i CEB,Escola Anselm Clavé,Ripollet,VOC,VOC,1,16,1,0,1,16,0,0,0,16,15,0,0,0,15,16,4,0,4,1,1,1,1,0
"08023591",ESC,Centre públic Dep. i CEB,Escola Pilar Mestres-Jaume Torrens,La Roca del Vallès,MVO,MVO,1,9,0,0,0,6,3,0,0,9,6,3,0,0,9,9,0,2,2,0,0,1,1,0
"08023669",ESC,Centre públic Dep. i CEB,Escola Mare de Déu del Sòl del Pont,Roda de Ter,CCE,CCE,1,18,7,2,9,9,0,0,0,9,9,0,0,0,9,16,9,0,9,9,5,1,1,0
"08023852",ESC,Centre públic Dep. i CEB,Escola Joan Maragall,Rubí,VOC,VOC,1,15,1,0,1,19,0,1,1,21,14,0,0,0,14,15,14,0,14,1,1,1,1,0
"08023918",ESC,Centre públic Dep. i CEB,Escola Concòrdia,Sabadell,VOC,VOC,1,18,0,0,0,18,0,0,0,18,18,0,0,0,18,18,18,0,18,0,0,1,1,0
"08023921",ESC,Centre públic Dep. i CEB,Escola Espronceda,Sabadell,VOC,VOC,1,17,1,0,1,19,0,0,0,19,16,0,0,0,16,17,16,0,16,1,1,1,1,0
"08023931",ESC,Centre públic Dep. i CEB,Escola Enric Casassas,Sabadell,VOC,VOC,1,9,2,0,2,7,0,0,0,7,7,0,0,0,7,9,7,0,7,2,2,1,1,0
"08023943",ESC,Centre públic Dep. i CEB,Escola Gaudí,Sabadell,VOC,VOC,1,9,1,0,1,9,0,0,0,9,8,0,0,0,8,9,8,0,8,1,1,1,1,0
"08023955",ESC,Centre públic Dep. i CEB,Escola Cifuentes,Sabadell,VOC,VOC,1,18,1,0,1,26,1,0,0,27,17,0,0,0,17,18,13,1,14,1,1,1,1,0
"08023979",ESC,Centre públic Dep. i CEB,Escola Joan Montllor,Sabadell,VOC,VOC,1,9,1,4,5,6,0,0,0,6,6,0,0,0,6,7,6,0,6,3,3,1,1,0
"08023980",ESC,Centre públic Dep. i CEB,Escola Juan Ramón Jiménez,Sabadell,VOC,VOC,1,9,1,0,1,2,5,0,0,7,2,5,0,0,7,8,0,0,0,1,1,1,1,0
"08024005",ESC,Centre públic Dep. i CEB,Escola Joan Maragall,Sabadell,VOC,VOC,1,11,9,0,9,5,1,0,0,6,2,0,0,0,2,11,2,0,2,9,3,1,1,0
"08024017",ESC,Centre públic Dep. i CEB,Escola Miquel Carreras,Sabadell,VOC,VOC,1,10,2,0,2,9,0,0,0,9,8,0,0,0,8,10,8,0,8,2,2,1,1,0
"08024030",ESC,Centre públic Dep. i CEB,Escola Samuntada,Sabadell,VOC,VOC,1,11,4,5,9,0,0,6,0,6,0,0,6,0,6,10,0,0,0,5,3,1,1,0
"08024042",ESC,Centre públic Dep. i CEB,Escola La Romànica,Sabadell,VOC,VOC,1,18,1,0,1,17,0,0,0,17,17,0,0,0,17,18,6,0,6,1,1,1,1,0
"08024066",ESC,Centre públic Dep. i CEB,Escola Tarlatana,Sabadell,VOC,VOC,1,9,1,0,1,1,0,8,1,10,1,0,7,0,8,9,8,0,8,1,1,1,1,0
"08024741",INS,Centre públic Dep. i CEB,Institut Escola Industrial,Sabadell,VOC,VOC,1,36,0,0,0,40,2,0,0,42,36,0,0,0,36,36,0,36,36,0,0,1,1,0
"08024765",INS,Centre públic Dep. i CEB,Institut Arraona,Sabadell,VOC,VOC,1,25,18,0,18,0,10,0,0,10,0,7,0,0,7,25,0,0,0,18,7,1,1,0
"08024777",INS,Centre públic Dep. i CEB,Institut Egara,Terrassa,VOC,VOC,1,20,6,0,6,18,0,0,0,18,14,0,0,0,14,20,14,0,14,6,6,1,1,0
"08024789",EE,Centre públic Dep. i CEB,CEE Francesc Bellapart,Sabadell,VOC,VOC,1,14,5,0,5,18,10,5,0,33,9,0,0,0,9,14,9,0,9,5,4,1,1,0
"08024790",ESC,Centre públic Dep. i CEB,Escola Roureda,Sabadell,VOC,VOC,1,18,0,0,0,17,1,0,0,18,17,1,0,0,18,18,17,0,17,0,0,1,1,0
"08024807",ESC,Centre públic Dep. i CEB,Escola Agnès Armengol,Sabadell,VOC,VOC,1,9,1,3,4,0,0,10,0,10,0,0,8,0,8,9,5,0,5,1,1,1,1,0
"08024819",ESC,Centre públic Dep. i CEB,Escola Calvet d'Estrella,Sabadell,VOC,VOC,1,9,1,0,1,9,0,0,0,9,8,0,0,0,8,9,8,0,8,1,1,1,1,0
"08024820",ESC,Centre públic Dep. i CEB,Escola Pau Casals,Sabadell,VOC,VOC,1,18,1,0,1,17,0,0,0,17,17,0,0,0,17,18,9,0,9,1,1,1,1,0
"08024832",ESC,Centre públic Dep. i CEB,Escola Floresta,Sabadell,VOC,VOC,1,9,2,4,6,9,0,0,0,9,7,0,0,0,7,9,5,0,5,2,2,1,1,0
"08024844",ESC,Centre públic Dep. i CEB,Escola Torreguitart,Sabadell,VOC,VOC,1,9,1,0,1,8,1,0,0,9,8,0,0,0,8,9,8,0,8,1,1,1,1,0
"08024856",ESC,Centre públic Dep. i CEB,Escola Font Rosella,Sabadell,VOC,VOC,1,18,2,0,2,0,21,0,2,23,0,16,0,0,16,18,0,16,16,2,2,1,1,0
"08024871",INS,Centre públic Dep. i CEB,Institut Pau Vila,Sabadell,VOC,VOC,1,34,1,2,3,28,0,0,0,28,28,0,0,0,28,29,28,0,28,3,3,1,1,0
"08024881",INS,Centre públic Dep. i CEB,Institut Ferran Casablancas,Sabadell,VOC,VOC,1,39,0,0,0,0,34,0,0,34,0,34,0,0,34,34,0,34,34,0,0,1,1,0
"08024893",FP,Centre públic Dep. i CEB,Institut Castellarnau,Sabadell,VOC,VOC,1,27,0,0,0,16,4,1,2,23,16,4,1,2,23,23,17,6,23,0,0,1,1,0
"08024972",ESC,Centre públic Dep. i CEB,Escola Torres Amat,Sallent,CCE,CCE,1,19,0,0,0,18,0,0,0,18,18,0,0,0,18,18,18,0,18,0,0,1,1,0
"08025058",ESC,Centre públic Dep. i CEB,Escola Riu d'Or,Santpedor,CCE,CCE,1,18,1,7,8,8,2,0,0,10,8,2,0,0,10,11,8,2,10,8,5,1,1,0
"08025071",ESC,Centre públic Dep. i CEB,Escola Dones d'Aigua,Sant Iscle de Vallalta,MVO,MVO,1,9,1,0,1,0,0,0,1,1,0,0,0,1,1,2,0,1,1,1,1,1,1,0
"08025083",ESC,Centre públic Dep. i CEB,Escola Pompeu Fabra,Sant Adrià de Besòs,BCO,BCO,1,18,1,0,1,20,0,0,0,20,17,0,0,0,17,18,0,0,0,1,1,1,1,0
"08025228",EE,EE Privats,Ntra. Sra. de la Esperanza,Sant Adrià de Besòs,BCO,BCO,0,1,0,0,0,0,0,0,0,0,2,0,0,0,2,2,0,0,0,0,0,0,1,0
"08025241",ESC,Centre públic Dep. i CEB,Escola Joan Maragall,Sant Andreu de la Barca,BLL,BLL,1,9,1,1,2,7,2,0,0,9,7,1,0,0,8,9,5,2,7,1,1,1,1,0
"08025265",ESC,Centre públic Dep. i CEB,Escola Àngel Guimerà,Sant Andreu de la Barca,BLL,BLL,1,18,0,0,0,4,0,0,0,4,4,0,0,0,4,4,4,0,4,0,0,1,1,0
"08025319",ESC,Centre públic Dep. i CEB,Escola Joan Casas,Sant Antoni de Vilamajor,MVO,MVO,1,17,0,0,0,4,0,0,0,4,4,0,0,0,4,4,4,0,4,0,0,1,1,0
"08025320",ESC,Centre públic Dep. i CEB,Escola La Monjoia,Sant Bartomeu del Grau,CCE,CCE,1,9,1,1,2,4,0,0,1,5,4,0,0,1,5,6,4,1,5,2,2,1,1,0
"08025344",ESC,Centre públic Dep. i CEB,Escola Amat Verdú,Sant Boi de Llobregat,BLL,BLL,1,11,1,0,1,0,11,0,0,11,0,10,0,0,10,11,0,10,10,1,1,1,1,0
"08025526",ESC,Centre públic Dep. i CEB,Escola Ciutat Cooperativa,Sant Boi de Llobregat,BLL,BLL,1,9,1,0,1,9,0,0,0,9,8,0,0,0,8,9,5,0,5,1,1,1,1,0
"08025587",ESC,Centre públic Dep. i CEB,Escola Casablanca,Sant Boi de Llobregat,BLL,BLL,1,18,5,0,5,18,0,0,0,18,13,0,0,0,13,18,8,0,8,5,5,1,1,0
"08025599",ESC,Centre públic Dep. i CEB,Escola Marianao,Sant Boi de Llobregat,BLL,BLL,1,11,3,0,3,4,0,0,7,11,4,0,0,4,8,11,4,4,8,3,3,1,1,0
"08025605",INS,Centre públic Dep. i CEB,Institut Camps Blancs,Sant Boi de Llobregat,BLL,BLL,1,38,0,0,0,0,45,0,0,45,0,38,0,0,38,38,0,38,38,0,0,1,1,0
"08025642",ESC,Centre públic Dep. i CEB,Escola Josep Maria Ciurana,Sant Boi de Llobregat,BLL,BLL,1,16,1,0,1,5,11,0,0,16,5,10,0,0,15,16,5,10,15,1,1,1,1,0
"08025654",INS,Centre públic Dep. i CEB,Institut Joaquim Rubió i Ors,Sant Boi de Llobregat,BLL,BLL,1,28,3,0,3,24,0,0,0,24,24,0,0,0,24,27,0,0,0,3,3,1,1,0
"08025666",ESC-ZER,Centre públic Dep. i CEB,Escola Aurora - ZER Alt Lluçanès,Sant Boi de Lluçanès,CCE,CCE,1,3,1,0,1,0,0,0,1,1,0,0,0,1,1,2,0,0,0,1,1,1,0,0
"08025812",ESC,Centre públic Dep. i CEB,Escola Sant Climent,Sant Climent de Llobregat,BLL,BLL,1,18,0,0,0,18,0,0,0,18,18,0,0,0,18,18,10,0,10,0,0,1,1,0
"08025824",ESC,Centre públic Dep. i CEB,Escola La Floresta,La Floresta (Sant Cugat del Vallès),VOC,VOC,1,10,0,0,0,8,0,0,1,9,8,0,0,1,9,9,8,1,9,0,0,1,1,0
"08025927",ESC,Centre públic Dep. i CEB,Escola Pi d'en Xandri,Sant Cugat del Vallès,VOC,VOC,1,19,1,15,16,19,0,0,0,19,18,0,0,0,18,19,18,0,18,1,1,1,1,0
"08026026",ESC,Centre públic Dep. i CEB,Escola Pins del Vallès,Sant Cugat del Vallès,VOC,VOC,1,19,1,1,2,18,1,0,0,19,18,0,0,0,18,19,18,0,18,1,1,1,1,0
"08026087",ESC,Centre públic Dep. i CEB,Escola Jaume Ferran i Clua,Valldoreix (Sant Cugat del Vallès),VOC,VOC,1,18,1,0,1,16,0,0,1,17,16,0,0,1,17,18,16,1,17,1,1,1,1,0
"08026099",ESC,Centre públic Dep. i CEB,Escola Les Vinyes,Sant Cugat Sesgarrigues,BCO,PEN,1,9,1,2,3,0,0,3,1,4,0,0,3,1,4,5,3,1,4,3,3,1,1,0
"08026117",ESC,Centre públic Dep. i CEB,Escola Vallmanya,Sant Esteve de Palautordera,MVO,MVO,1,17,0,0,0,16,0,0,0,16,16,0,0,0,16,16,8,0,8,0,0,1,1,0
"08026130",ESC,Centre públic Dep. i CEB,Escola La Roureda,Sant Esteve Sesrovires,BLL,BLL,1,14,0,0,0,14,0,0,1,15,14,0,0,0,14,14,14,0,14,0,0,1,1,0
"08026154",ESC,Centre públic Dep. i CEB,Escola Joaquim Abril,Sant Fost de Campsentelles,MVO,MVO,1,18,1,0,1,11,1,0,0,12,11,1,0,0,12,13,4,0,4,1,1,1,1,0
"08026208",ESC,Centre públic Dep. i CEB,Escola Jaume Balmes,Sant Feliu de Codines,MVO,MVO,1,15,1,0,1,15,2,0,0,17,14,0,0,0,14,15,6,2,8,1,1,1,1,0
"08026211",ESC,Centre públic Dep. i CEB,Escola Nadal,Sant Feliu de Llobregat,BLL,BLL,1,17,1,1,2,17,0,0,0,17,16,0,0,0,16,17,8,0,8,1,1,1,1,0
"08026221",ESC,Centre públic Dep. i CEB,Escola Falguera,Sant Feliu de Llobregat,BLL,BLL,1,9,1,0,1,9,0,0,0,9,8,0,0,0,8,9,5,0,5,1,1,1,1,0
"08026373",ESC,Centre públic Dep. i CEB,Escola Josep Monmany Amat,Sant Feliu de Llobregat,BLL,BLL,1,11,1,0,1,12,1,0,0,13,10,0,0,0,10,11,10,0,10,1,1,1,1,0
"08026385",ESC,Centre públic Dep. i CEB,Escola Arquitecte Gaudí,Sant Feliu de Llobregat,BLL,BLL,1,9,2,0,2,6,0,0,1,7,6,0,0,1,7,9,3,0,3,2,2,1,1,0
"08026397",INS,Centre públic Dep. i CEB,Institut Olorda,Sant Feliu de Llobregat,BLL,BLL,1,26,0,0,0,25,0,0,0,25,25,0,0,0,25,25,0,0,0,0,0,1,1,0
"08026415",ESC-ZER,Centre públic Dep. i CEB,Escola Els Roures - ZER Gavarresa,Sant Feliu Sasserra,CCE,CCE,1,5,2,0,2,0,0,0,0,0,0,0,0,0,0,2,0,0,0,2,2,1,0,3
"08026464",ESC,Centre públic Dep. i CEB,Escola Monsenyor Gibert,Sant Fruitós de Bages,CCE,CCE,1,18,0,0,0,18,0,0,0,18,18,0,0,0,18,18,6,0,6,0,0,1,1,0
"08026476",ESC,Centre públic Dep. i CEB,Escola Francesc Macià,Vilassar de Dalt,MVO,MVO,1,20,1,0,1,17,0,0,0,17,17,0,0,0,17,18,0,0,0,1,1,1,1,0
"08026567",ESC,Centre públic Dep. i CEB,Escola Sant Francesc d'Assís,Sant Joan Despí,BLL,BLL,1,18,0,0,0,22,2,2,0,26,18,0,0,0,18,18,18,0,18,0,0,1,1,0
"08026661",ESC,Centre públic Dep. i CEB,Escola Pau Casals,Sant Joan Despí,BLL,BLL,1,18,1,0,1,17,0,0,0,17,17,0,0,0,17,18,8,0,8,1,1,1,1,0
"08026671",ESC,Centre públic Dep. i CEB,Escola Joan Perich i Valls,Sant Joan Despí,BLL,BLL,1,10,1,0,1,14,1,0,0,15,9,0,0,0,9,10,9,0,9,1,1,1,1,0
"08026683",INS,Centre públic Dep. i CEB,Institut Francesc Ferrer i Guàrdia,Sant Joan Despí,BLL,BLL,1,27,0,0,0,27,3,0,0,30,27,0,0,0,27,27,27,0,27,0,0,1,1,0
"08026725",ESC,Centre públic Dep. i CEB,Escola Joncadella,Sant Joan de Vilatorrada,CCE,CCE,1,18,0,9,9,10,0,0,0,10,10,0,0,0,10,10,10,0,10,8,5,1,1,0
"08026749",ESC,Centre públic Dep. i CEB,Escola Pérez Sala,Vilassar de Mar,MVO,MVO,1,15,1,4,5,15,0,0,0,15,14,0,0,0,14,15,14,0,14,1,1,1,1,0
"08026786",ESC,Centre públic Dep. i CEB,Escola Bellpuig,Sant Julià de Vilatorta,CCE,CCE,1,9,1,0,1,9,0,0,0,9,8,0,0,0,8,9,8,0,8,1,1,1,1,0
"08026816",ESC,Centre públic Dep. i CEB,Escola Montserrat,Sant Just Desvern,BLL,BLL,1,19,1,0,1,18,0,0,0,18,18,0,0,0,18,19,18,0,18,1,1,1,1,0
"08026889",ESC,Centre públic Dep. i CEB,Escola Vinyes Verdes,La Beguda Alta (Masquefa),CCE,PEN,1,18,4,3,7,6,0,0,0,6,6,0,0,0,6,10,0,0,0,7,5,1,1,0
"08026907",ESC,Centre públic Dep. i CEB,Escola Pau Casals,Sant Llorenç d'Hortons,BCO,PEN,1,9,1,0,1,0,1,8,0,9,0,1,7,0,8,9,5,0,5,1,1,1,1,0
"08026919",ESC,Centre públic Dep. i CEB,Escola Josep Gras,Sant Llorenç Savall,VOC,VOC,1,9,0,0,0,8,1,0,0,9,8,1,0,0,9,9,8,1,9,0,0,1,1,0
"08026956",ESC,Centre públic Dep. i CEB,Escola Cérvola Blanca,Sant Martí de Tous,CCE,PEN,1,9,0,0,0,0,1,7,0,8,0,1,7,0,8,8,7,0,7,0,0,1,1,0
"08027018",ESC,Centre públic Dep. i CEB,Escola Jaume Balmes,Sant Martí Sarroca,BCO,PEN,1,14,1,0,1,14,0,0,0,14,13,0,0,0,13,14,13,0,13,1,1,1,1,0
"08027021",ESC-ZER,Centre públic Dep. i CEB,Escola Font de l'Anoia - ZER Vent d'Avall,Sant Martí Sesgueioles,CCE,CCE,1,1,1,0,1,2,0,0,0,2,0,0,0,0,0,1,0,0,0,1,1,1,0,0
"08027110",ESC,Centre públic Dep. i CEB,Escola El Pi,Sant Pere de Ribes,BCO,PEN,1,9,0,2,2,0,0,9,0,9,0,0,9,0,9,9,9,0,9,0,0,1,1,0
"08027134",ESC,Centre públic Dep. i CEB,Escola Les Roquetes,Les Roquetes (Sant Pere de Ribes),BCO,PEN,1,15,0,5,5,21,2,0,0,23,15,0,0,0,15,15,15,0,15,0,0,1,1,0
"08027146",ESC,Centre públic Dep. i CEB,Escola Sant Jeroni,Sant Pere de Riudebitlles,BCO,PEN,1,9,0,0,0,0,10,0,0,10,0,9,0,0,9,9,0,4,4,0,0,1,1,0
"08027183",ESC,Centre públic Dep. i CEB,Escola Torre Roja,Sant Pere de Vilamajor,MVO,MVO,1,23,0,0,0,7,8,1,0,16,7,8,1,0,16,16,3,6,9,0,0,1,1,0
"08027225",ESC,Centre públic Dep. i CEB,Escola Sant Pau,Sant Pol de Mar,MVO,MVO,1,20,1,0,1,20,0,0,0,20,19,0,0,0,19,20,6,0,6,1,1,1,1,0
"08027249",ESC,Centre públic Dep. i CEB,Escola Segimon Comas,Sant Quirze de Besora,CCE,CCE,1,11,2,0,2,0,10,0,0,10,0,9,0,0,9,11,0,9,9,2,2,1,1,0
"08027432",ESC,Centre públic Dep. i CEB,Escola Wagner,Santa Coloma de Gramenet,BCO,BCO,1,9,1,0,1,0,4,0,4,8,0,4,0,4,8,9,0,8,8,1,1,1,1,0
"08027456",ESC,Centre públic Dep. i CEB,Escola Ferran de Sagarra,Santa Coloma de Gramenet,BCO,BCO,1,18,1,7,8,19,0,0,0,19,17,0,0,0,17,18,17,0,17,1,1,1,1,0
"08027471",ESC,Centre públic Dep. i CEB,Escola Sant Just,Santa Coloma de Gramenet,BCO,BCO,1,18,1,0,1,17,0,0,0,17,17,0,0,0,17,18,0,0,0,1,1,1,1,0
"08027511",ESC,Centre públic Dep. i CEB,Escola Torre Balldovina,Santa Coloma de Gramenet,BCO,BCO,1,18,1,0,1,18,0,0,0,18,17,0,0,0,17,18,6,0,6,1,1,1,1,0
"08027754",IE,Concertada 30% NESE,Virgen del Carmen,Santa Coloma de Gramenet,BCO,BCO,0,12,0,0,0,0,0,0,0,0,12,0,0,0,12,12,0,0,0,0,0,0,1,0
"08027870",ESC,Centre públic Dep. i CEB,Escola Les Palmeres,Santa Coloma de Gramenet,BCO,BCO,1,18,3,1,4,14,0,0,0,14,14,0,0,0,14,17,14,0,14,4,4,1,1,0
"08027973",ESC,Centre públic Dep. i CEB,Escola Beethoven,Santa Coloma de Gramenet,BCO,BCO,1,9,1,0,1,9,0,0,0,9,8,0,0,0,8,9,8,0,8,1,1,1,1,0
"08027985",ESC,Centre públic Dep. i CEB,Escola Jaume Salvatella,Santa Coloma de Gramenet,BCO,BCO,1,18,1,0,1,18,0,0,0,18,17,0,0,0,17,18,17,0,17,1,1,1,1,0
"08028035",ESC,Centre públic Dep. i CEB,Escola Ausiàs March,Santa Coloma de Gramenet,BCO,BCO,1,9,1,0,1,4,0,0,0,4,4,0,0,0,4,5,0,0,0,1,1,1,1,0
"08028047",INS,Centre públic Dep. i CEB,Institut Puig Castellar,Santa Coloma de Gramenet,BCO,BCO,1,30,0,0,0,29,0,0,0,29,29,0,0,0,29,29,29,0,29,0,0,1,1,0
"08028059",ESC,Centre públic Dep. i CEB,Escola Jacint Verdaguer,Santa Eugènia de Berga,CCE,CCE,1,9,1,0,1,9,0,2,0,11,8,0,0,0,8,9,8,0,8,1,1,1,1,0
"08028072",ESC,Centre públic Dep. i CEB,Escola El Roure Gros,Santa Eulàlia de Riuprimer,CCE,CCE,1,9,1,0,1,0,0,0,0,0,0,0,0,0,0,1,0,0,0,1,1,1,1,8
"08028102",ESC,Centre públic Dep. i CEB,Escola Ronçana,El Rieral (Santa Eulàlia de Ronçana),MVO,MVO,1,11,1,0,1,5,2,0,0,7,5,2,0,0,7,8,1,2,3,1,1,1,1,0
"08028151",ESC-ZER,Centre públic Dep. i CEB,Escola Les Moreres - ZER Cep de Sis,Santa Fe del Penedès,BCO,PEN,1,4,1,1,2,0,0,1,1,2,0,0,1,1,2,3,1,1,2,2,2,1,0,0
"08028163",ESC,Centre públic Dep. i CEB,Escola Montbou,Santa Margarida de Montbui,CCE,PEN,1,9,1,0,1,7,1,0,0,8,7,1,0,0,8,9,7,1,8,1,1,1,1,0
"08028217",ESC,Centre públic Dep. i CEB,Escola Doctor Samaranch i Fina,Els Monjos (Santa Margarida i els Monjos),BCO,PEN,1,18,1,0,1,18,0,0,0,18,17,0,0,0,17,18,17,0,17,1,1,1,1,0
"08028229",ESC,Centre públic Dep. i CEB,Escola Elisa Badia,Barberà del Vallès,VOC,VOC,1,18,4,0,4,13,1,0,0,14,13,1,0,0,14,18,5,1,6,4,4,1,1,0
"08028333",ESC,TANCA el curs 2023-24,Escola El Cabrerès,L'Esquirol,CCE,CCE,1,0,0,0,0,9,0,0,0,9,0,0,0,0,0,0,0,0,0,0,0,1,0,0
"08028345",ESC,Centre públic Dep. i CEB,Escola Les Mimoses,Santa Maria de Martorelles,MVO,MVO,1,9,0,1,1,5,0,2,0,7,5,0,2,0,7,7,3,0,3,1,1,1,1,0
"08028382",ESC,Centre públic Dep. i CEB,Escola Sesmon d'Oló,Santa Maria d'Oló,CCE,CCE,1,9,2,0,2,0,0,1,0,1,0,0,1,0,1,3,1,0,1,2,2,1,1,0
"08028424",ESC,Centre públic Dep. i CEB,Escola Fontmartina,Santa Maria de Palautordera,MVO,MVO,1,16,2,0,2,14,1,0,0,15,14,0,0,0,14,16,14,0,14,2,2,1,1,0
"08028436",ESC,Centre públic Dep. i CEB,Escola La Florida,Santa Perpètua de Mogoda,VOC,VOC,1,18,0,0,0,18,0,0,0,18,18,0,0,0,18,18,12,0,12,0,0,1,1,0
"08028497",ESC,Centre públic Dep. i CEB,Escola Santa Perpètua,Santa Perpètua de Mogoda,VOC,VOC,1,15,1,0,1,16,0,0,0,16,14,0,0,0,14,15,6,0,6,1,1,1,1,0
"08028515",ESC,Centre públic Dep. i CEB,Escola Santa Susanna,Santa Susanna,MVO,MVO,1,9,0,0,0,0,9,0,0,9,0,9,0,0,9,9,0,9,9,0,0,1,1,0
"08028576",ESC,Centre públic Dep. i CEB,Escola Sant Vicenç,Sant Vicenç de Castellet,CCE,CCE,1,18,0,0,0,16,0,4,0,20,16,0,2,0,18,18,0,6,6,0,0,1,1,0
"08028588",ESC,Centre públic Dep. i CEB,Escola Sant Jordi,Sant Vicenç dels Horts,BLL,BLL,1,9,1,0,1,0,8,0,0,8,0,8,0,0,8,9,0,8,8,1,1,1,1,0
"08028591",ESC,Centre públic Dep. i CEB,Escola La Vinyala,Sant Vicenç dels Horts,BLL,BLL,1,11,1,0,1,0,10,2,0,12,0,10,0,0,10,11,2,8,10,1,1,1,1,0
"08028667",ESC,Centre públic Dep. i CEB,Escola Joan Juncadella,Sant Vicenç dels Horts,BLL,BLL,1,16,0,1,1,16,0,0,0,16,16,0,0,0,16,16,10,0,10,0,0,1,1,0
"08028709",ESC,Centre públic Dep. i CEB,Escola Lloriana,Sant Vicenç de Torelló,CCE,CCE,1,9,1,0,1,9,1,0,0,10,8,0,0,0,8,9,8,0,8,1,1,1,1,0
"08028746",ESC,Centre públic Dep. i CEB,Escola Sant Martí,Cerdanyola del Vallès,VOC,VOC,1,9,1,0,1,6,0,0,2,8,6,0,0,2,8,9,3,2,5,1,1,1,1,0
"08028758",ESC,Centre públic Dep. i CEB,Escola Les Fontetes,Cerdanyola del Vallès,VOC,VOC,1,12,1,0,1,8,0,0,0,8,8,0,0,0,8,9,8,0,8,1,1,1,1,0
"08028783",ESC,Centre públic Dep. i CEB,Escola Serraparera,Cerdanyola del Vallès,VOC,VOC,1,17,1,0,1,21,2,0,0,23,16,0,0,0,16,17,16,0,16,1,1,1,1,0
"08028813",ESC,EPRI & ESO Municipals no CEB,Escola La Sínia,Cerdanyola del Vallès,VOC,VOC,0,9,0,0,0,0,0,0,0,0,9,0,0,0,9,9,0,0,0,0,0,0,1,0
"08028904",ESC,Centre públic Dep. i CEB,Escola Carles Buïgas,Cerdanyola del Vallès,VOC,VOC,1,9,1,0,1,8,0,0,1,9,8,0,0,0,8,9,8,0,8,1,1,1,1,0
"08028916",ESC,TANCA el curs 2023-24,Escola Las Seguidillas,Badia del Vallès,VOC,VOC,1,0,0,0,0,0,19,0,0,19,0,0,0,0,0,0,0,0,0,0,0,1,0,0
"08028928",ESC,TANCA el curs 2023-24,Escola La Jota,Badia del Vallès,VOC,VOC,1,0,1,0,1,18,0,0,0,18,0,0,0,0,0,1,0,0,0,1,0,1,0,0
"08028941",ESC,TANCA el curs 2023-24,Escola La Sardana,Badia del Vallès,VOC,VOC,1,0,0,0,0,13,0,0,0,13,0,0,0,0,0,0,0,0,0,0,0,1,0,0
"08028990",ESC,Centre públic Dep. i CEB,Escola Can Sorts,Sentmenat,VOC,VOC,1,25,1,0,1,25,0,0,1,26,24,0,0,0,24,25,24,0,24,1,1,1,1,0
"08029015",ESC,Centre públic Dep. i CEB,Escola Sant Salvador,Sant Jordi de Cercs (Cercs),CCE,CCE,1,9,0,0,0,6,0,0,0,6,6,0,0,0,6,6,6,0,6,0,0,1,1,0
"08029027",ESC,Centre públic Dep. i CEB,Escola Farigola,Seva,CCE,CCE,1,9,1,0,1,9,0,0,0,9,8,0,0,0,8,9,8,0,8,1,1,1,1,0
"08029088",ESC,Centre públic Dep. i CEB,Escola Miquel Utrillo,Sitges,BCO,PEN,1,20,0,2,2,9,0,10,0,19,9,0,10,0,19,19,10,0,10,1,1,1,1,0
"08029143",ESC-ZER,Centre públic Dep. i CEB,Escola Subirats - ZER Subirats,Lavern (Subirats),BCO,PEN,1,5,2,0,2,0,0,3,0,3,0,0,3,0,3,5,3,0,3,2,2,1,0,0
"08029155",ESC-ZER,Centre públic Dep. i CEB,Escola El Montcau - ZER Subirats,Ordal (Subirats),BCO,PEN,1,6,1,0,1,5,0,0,0,5,5,0,0,0,5,6,3,0,3,1,1,1,0,0
"08029192",ESC,Centre públic Dep. i CEB,Escola Sant Jordi,Sant Pau d'Ordal (Subirats),BCO,PEN,1,9,1,3,4,6,0,3,1,10,6,0,2,0,8,9,8,0,8,1,1,1,1,0
"08029209",ESC,Centre públic Dep. i CEB,Escola Salipota,Súria,CCE,CCE,1,9,1,0,1,6,2,0,0,8,6,2,0,0,8,9,2,2,4,1,1,1,1,0
"08029222",ESC,Centre públic Dep. i CEB,Escola Francesc Macià,Súria,CCE,CCE,1,9,0,0,0,0,9,0,0,9,0,9,0,0,9,9,0,9,9,0,0,1,1,0
"08029283",ESC-ZER,Centre públic Dep. i CEB,Escola El Gurri - ZER Guilleries,El Gurri (Taradell),CCE,CCE,1,2,0,2,2,1,0,0,0,1,1,0,0,0,1,1,0,0,0,1,1,1,0,0
"08029301",ESC,Centre públic Dep. i CEB,Escola Les Pinediques,Taradell,CCE,CCE,1,18,0,0,0,12,0,2,4,18,12,0,2,4,18,18,14,4,18,0,0,1,1,0
"08029350",ESC,Centre públic Dep. i CEB,Escola França,Terrassa,VOC,VOC,1,19,0,0,0,21,2,2,2,27,19,0,0,0,19,19,19,0,19,0,0,1,1,0
"08029374",ESC,Centre públic Dep. i CEB,Escola Bisbat d'Egara,Terrassa,VOC,VOC,1,28,0,0,0,32,0,9,0,41,28,0,0,0,28,28,28,0,28,0,0,1,1,0
"08029386",ESC,Centre públic Dep. i CEB,Escola Ramón y Cajal,Terrassa,VOC,VOC,1,18,2,0,2,7,0,18,0,25,7,0,9,0,16,18,16,0,16,2,2,1,1,0
"08029507",ESC,Centre públic Dep. i CEB,Escola Isaac Peral,Terrassa,VOC,VOC,1,9,1,0,1,6,0,0,0,6,6,0,0,0,6,7,3,0,3,1,1,1,1,0
"08030091",IE,Concertada 30% NESE,Ramon Pont,Terrassa,VOC,VOC,0,13,0,0,0,0,0,0,0,0,13,0,0,0,13,13,0,0,0,0,0,0,1,0
"08030169",EE,EE municipals,CEE El Pi,Terrassa,VOC,VOC,0,1,0,0,0,0,0,0,0,0,2,0,0,0,2,2,0,0,0,0,0,0,1,0
"08030200",ESC,Centre públic Dep. i CEB,Escola Marià Galí Guix,Terrassa,VOC,VOC,1,10,1,0,1,9,0,0,0,9,9,0,0,0,9,10,9,0,9,1,1,1,1,0
"08030212",ESC,Centre públic Dep. i CEB,Escola Josep Ventalló i Vintró,Terrassa,VOC,VOC,1,12,2,3,5,11,1,0,0,12,10,0,0,0,10,12,4,0,4,2,2,1,1,0
"08030248",ESC,Centre públic Dep. i CEB,Escola Pau Vila i Dinarès,Terrassa,VOC,VOC,1,19,2,1,3,22,3,2,0,27,17,0,0,0,17,19,15,2,17,2,2,1,1,0
"08030261",EE,EE municipals,CEE Fàtima,Terrassa,VOC,VOC,0,1,0,0,0,0,0,0,0,0,3,0,0,0,3,3,0,0,0,0,0,0,1,0
"08030285",ESC,Centre públic Dep. i CEB,Escola Auró,Terrassa,VOC,VOC,1,11,4,2,6,0,0,10,0,10,0,0,7,0,7,11,5,0,5,4,3,1,1,0
"08030297",ESC,Centre públic Dep. i CEB,Escola Salvador Vinyals i Galí,Terrassa,VOC,VOC,1,9,1,2,3,7,0,0,0,7,7,0,0,0,7,8,7,0,7,2,2,1,1,0
"08030315",ESC,Centre públic Dep. i CEB,Escola Joan XXIII,Terrassa,VOC,VOC,1,19,1,3,4,18,0,0,1,19,18,0,0,0,18,19,18,0,18,1,1,1,1,0
"08030339",INS,Centre públic Dep. i CEB,Institut de Terrassa,Terrassa,VOC,VOC,1,43,1,20,21,54,1,0,0,55,42,0,0,0,42,43,42,0,42,1,1,1,1,0
"08030340",INS,Centre públic Dep. i CEB,Institut Investigador Blanxart,Terrassa,VOC,VOC,1,32,1,0,1,1,5,0,0,6,1,5,0,0,6,7,0,5,5,1,1,1,1,0
"08030364",ESC,Centre públic Dep. i CEB,Escola El Cim,Teià,MVO,MVO,1,21,0,0,0,19,0,0,0,19,19,0,0,0,19,19,19,0,19,0,0,1,1,0
"08030388",ESC,Centre públic Dep. i CEB,Escola Lola Anglada,Tiana,MVO,MVO,1,18,0,0,0,0,23,0,0,23,0,18,0,0,18,18,0,18,18,0,0,1,1,0
"08030421",ESC,Centre públic Dep. i CEB,Escola L'Era de Dalt,Tona,CCE,CCE,1,18,0,0,0,18,0,0,0,18,18,0,0,0,18,18,18,0,18,0,0,1,1,0
"08030467",ESC,Centre públic Dep. i CEB,Escola Ignasi Iglesias,Tordera,MVO,MVO,1,20,1,0,1,28,2,0,0,30,19,0,0,0,19,20,19,0,19,1,1,1,1,0
"08030510",ESC,Centre públic Dep. i CEB,Escola Doctor Fortià i Solà,Torelló,CCE,CCE,1,18,6,0,6,0,0,18,0,18,0,0,12,0,12,18,0,0,0,6,5,1,1,0
"08030522",ESC,Centre públic Dep. i CEB,Escola Vall del Ges,Torelló,CCE,CCE,1,9,0,4,4,5,1,0,0,6,5,1,0,0,6,6,5,1,6,3,3,1,1,0
"08030534",IE,Concertada 30% NESE,Rocaprevera,Torelló,CCE,CCE,0,13,0,0,0,0,0,0,0,0,13,0,0,0,13,13,0,0,0,0,0,0,1,0
"08030583",ESC,Centre públic Dep. i CEB,Escola La Torre,La Torre Alta (La Torre de Claramunt),CCE,PEN,1,9,0,0,0,7,1,0,0,8,7,1,0,0,8,8,7,1,8,0,0,1,1,0
"08030595",ESC,Centre públic Dep. i CEB,Escola Torrescasana,Vilanova d'Espoia (La Torre de Claramunt),CCE,PEN,1,9,0,6,6,3,0,0,0,3,3,0,0,0,3,3,0,0,0,6,3,1,1,0
"08030613",ESC,Centre públic Dep. i CEB,Escola J.J. Ràfols,Torrelavit,BCO,PEN,1,9,0,1,1,8,0,0,0,8,8,0,0,0,8,8,8,0,8,1,1,1,1,0
"08030637",ESC,Centre públic Dep. i CEB,Escola Guerau de Peguera,Torrelles de Foix,BCO,PEN,1,9,0,0,0,7,2,0,0,9,7,2,0,0,9,9,2,7,9,0,0,1,1,0
"08030662",ESC,Centre públic Dep. i CEB,Escola Serralavella,Ullastrell,VOC,VOC,1,14,1,0,1,15,0,0,0,15,13,0,0,0,13,14,13,0,13,1,1,1,1,0
"08030686",ESC,Centre públic Dep. i CEB,Escola Pau Casals,Vacarisses,VOC,VOC,1,19,1,0,1,17,0,0,0,17,17,0,0,0,17,18,17,0,17,1,1,1,1,0
"08030698",ESC,Centre públic Dep. i CEB,Escola Josep Masclans,Vallbona d'Anoia,CCE,PEN,1,9,0,0,0,0,0,0,5,5,0,0,0,5,5,5,0,5,5,0,0,1,1,0
"08030728",ESC-ZER,Centre públic Dep. i CEB,Escola Serrat Voltor - ZER Alt Berguedà,Vallcebre,CCE,CCE,1,1,2,0,2,0,0,0,1,1,0,0,0,0,0,2,0,0,0,1,1,1,0,0
"08030789",ESC,Centre públic Dep. i CEB,Escola Pompeu Fabra,Vallirana,BLL,BLL,1,9,0,0,0,0,5,0,5,10,0,5,0,4,9,9,0,9,9,0,0,1,1,0
"08030819",ESC,Centre públic Dep. i CEB,Escola Sentfores,Vic,CCE,CCE,1,10,1,6,7,0,0,2,1,3,0,0,2,1,3,4,2,1,3,7,3,1,1,0
"08030881",ESC,Concertada 30% NESE,Dominiques Vic,Vic,CCE,CCE,0,9,0,0,0,0,0,0,0,0,9,0,0,0,9,9,0,0,0,0,0,0,1,0
"08030911",IE,Concertada 30% NESE,Sagrat Cor de Jesús,Vic,CCE,CCE,0,26,0,0,0,0,0,0,0,0,26,0,0,0,26,26,0,0,0,0,0,0,1,0
"08030947",IE,Concertada 30% NESE,Vedruna Escorial Vic,Vic,CCE,CCE,0,39,0,0,0,0,0,0,0,0,39,0,0,0,39,39,0,0,0,0,0,0,1,0
"08030960",IE,Concertada 30% NESE,FEDAC-Vic,Vic,CCE,CCE,0,26,0,0,0,0,0,0,0,0,26,0,0,0,26,26,0,0,0,0,0,0,1,0
"08031009",ESC,Centre públic Dep. i CEB,Escola Doctor Joaquim Salarich,Vic,CCE,CCE,1,20,0,4,4,15,1,0,0,16,15,1,0,0,16,16,0,0,0,4,4,1,1,0
"08031022",INS,Centre públic Dep. i CEB,Institut de Vic,Vic,CCE,CCE,1,47,1,0,1,5,1,42,0,48,5,1,40,0,46,47,1,0,1,1,1,1,1,0
"08031034",INS,Centre públic Dep. i CEB,Institut Jaume Callís,Vic,CCE,CCE,1,33,3,4,7,24,0,0,0,24,24,0,0,0,24,27,24,0,24,7,7,1,1,0
"08031046",ESC-ZER,Centre públic Dep. i CEB,Escola Serra de Picamill - ZER Berguedà Centre,Vilada,CCE,CCE,1,2,1,0,1,0,0,0,0,0,0,0,0,0,0,1,0,0,0,1,1,1,0,1
"08031061",ESC,Centre públic Dep. i CEB,Escola Rosella,Viladecavalls,VOC,VOC,1,19,1,1,2,24,0,0,0,24,18,0,0,0,18,19,0,0,0,1,1,1,1,0
"08031083",ESC,Centre públic Dep. i CEB,Escola Àngela Roca,Viladecans,BLL,BLL,1,9,2,0,2,10,0,0,0,10,7,0,0,0,7,9,0,0,0,2,2,1,1,0
"08031101",ESC,Centre públic Dep. i CEB,Escola Montserratina,Viladecans,BLL,BLL,1,18,0,1,1,12,4,0,2,18,12,4,0,2,18,18,4,6,10,0,0,1,1,0
"08031204",ESC,Centre públic Dep. i CEB,Escola El Garrofer,Viladecans,BLL,BLL,1,18,1,0,1,16,2,0,0,18,16,1,0,0,17,18,10,2,12,1,1,1,1,0
"08031228",INS,Centre públic Dep. i CEB,Institut Torre Roja,Viladecans,BLL,BLL,1,33,0,5,5,5,13,10,8,36,5,13,10,5,33,33,0,1,1,0,0,1,1,0
"08031277",ESC,Centre públic Dep. i CEB,Escola Joan Maragall,Vilanova del Camí,CCE,PEN,1,19,0,0,0,18,1,0,0,19,18,1,0,0,19,19,10,0,10,0,0,1,1,0
"08031290",ESC,Centre públic Dep. i CEB,Escola Les Roques,Vilanova de Sau,CCE,CCE,1,9,0,0,0,2,1,0,0,3,2,1,0,0,3,3,0,0,0,0,0,1,1,0
"08031319",ESC,Centre públic Dep. i CEB,Escola Llebeig,Vilobí del Penedès,BCO,PEN,1,10,1,0,1,8,1,0,0,9,8,1,0,0,9,10,8,1,9,1,1,1,1,0
"08031320",ESC,Centre públic Dep. i CEB,Escola Estalella i Graells,Vilafranca del Penedès,BCO,PEN,1,18,0,20,20,0,1,4,1,6,0,1,4,1,6,6,0,0,0,12,5,1,1,0
"08031332",ESC,Centre públic Dep. i CEB,Escola Josep Baltà i Elias,Vilafranca del Penedès,BCO,PEN,1,18,1,13,14,2,0,12,0,14,2,0,12,0,14,15,0,0,0,4,4,1,1,0
"08031459",INS,Centre públic Dep. i CEB,Institut Eugeni d'Ors,Vilafranca del Penedès,BCO,PEN,1,35,0,1,1,30,1,0,0,31,30,1,0,0,31,31,16,1,17,1,1,1,1,0
"08031460",ESC,Centre públic Dep. i CEB,Escola Trentapasses,Vilalba Sasserra,MVO,MVO,1,9,1,0,1,0,0,0,1,1,0,0,0,1,1,2,0,0,0,1,1,1,1,0
"08031472",ESC,Centre públic Dep. i CEB,Escola Pompeu Fabra,Vilanova i la Geltrú,BCO,PEN,1,18,4,0,4,0,18,0,0,18,0,14,0,0,14,18,0,14,14,4,4,1,1,0
"08031484",ESC,Centre públic Dep. i CEB,Escola Ginesta,Vilanova i la Geltrú,BCO,PEN,1,18,0,0,0,15,0,0,0,15,15,0,0,0,15,15,15,0,15,0,0,1,1,0
"08031666",ESC,Centre públic Dep. i CEB,Escola Canigó,Vilanova i la Geltrú,BCO,PEN,1,17,0,4,4,0,0,16,2,18,0,0,16,1,17,17,4,2,6,0,0,1,1,0
"08031681",INS,Centre públic Dep. i CEB,Institut Francesc Xavier Lluch i Rafecas,Vilanova i la Geltrú,BCO,PEN,1,31,1,0,1,0,2,28,0,30,0,2,28,0,30,31,28,2,30,1,1,1,1,0
"08031711",INS,Centre públic Dep. i CEB,Institut Manuel de Cabanyes,Vilanova i la Geltrú,BCO,PEN,1,32,0,0,0,19,2,4,4,29,19,2,4,4,29,29,23,6,29,0,0,1,1,0
"08031757",INS,Centre públic Dep. i CEB,Institut Forat del Vent,Cerdanyola del Vallès,VOC,VOC,1,34,1,0,1,21,2,0,0,23,21,2,0,0,23,24,21,2,23,1,1,1,1,0
"08031770",INS,Centre públic Dep. i CEB,Institut Can Jofresa,Terrassa,VOC,VOC,1,28,1,0,1,21,0,0,0,21,21,0,0,0,21,22,0,0,0,1,1,1,1,0
"08031794",ESC,Centre públic Dep. i CEB,Escola Palma de Mallorca,Barcelona,CEB,CEB,1,9,1,0,1,9,0,0,0,9,8,0,0,0,8,9,5,0,5,1,1,1,1,0
"08031800",ESC,Centre públic Dep. i CEB,Escola Pau Casals,Barcelona,CEB,CEB,1,9,0,0,0,9,0,0,0,9,9,0,0,0,9,9,3,0,3,0,0,1,1,0
"08031812",INS,Centre públic Dep. i CEB,Institut Valldemossa,Barcelona,CEB,CEB,1,18,0,1,1,12,4,0,0,16,12,4,0,0,16,16,2,0,2,1,1,1,1,0
"08031836",FP,Centre públic Dep. i CEB,Institut Illa dels Banyols,El Prat de Llobregat,BLL,BLL,1,12,0,0,0,0,36,0,0,36,0,12,0,0,12,12,10,2,12,0,0,1,1,0
"08031861",INS,Centre públic Dep. i CEB,Institut Leonardo da Vinci,Sant Cugat del Vallès,VOC,VOC,1,30,6,0,6,6,2,0,0,8,6,2,0,0,8,14,6,2,8,6,6,1,1,0
"08031873",INS,Centre públic Dep. i CEB,Institut Arnau Cadell,Sant Cugat del Vallès,VOC,VOC,1,28,1,0,1,0,0,27,0,27,0,0,27,0,27,28,27,0,27,1,1,1,1,0
"08032105",EE,EE Privats,Nen Déu,Barcelona,CEB,CEB,0,1,0,0,0,0,0,0,0,0,4,0,0,0,4,4,0,0,0,0,0,0,1,0
"08032270",EE,EE municipals,CEE Virolai,Cornellà de Llobregat,BLL,BLL,0,1,0,0,0,0,0,0,0,0,2,0,0,0,2,2,0,0,0,0,0,0,1,0
"08032300",ESC,Centre públic Dep. i CEB,Escola Fray Luis de León,Santa Coloma de Gramenet,BCO,BCO,1,18,1,0,1,17,1,0,0,18,17,0,0,0,17,18,5,1,6,1,1,1,1,0
"08032312",ESC,Centre públic Dep. i CEB,Escola Miguel de Unamuno,Santa Coloma de Gramenet,BCO,BCO,1,18,5,0,5,18,0,0,0,18,13,0,0,0,13,18,13,0,13,5,5,1,1,0
"08032348",ESC,Centre públic Dep. i CEB,Escola 25 de Setembre,Rubí,VOC,VOC,1,27,0,0,0,26,1,0,0,27,26,1,0,0,27,27,9,0,9,0,0,1,1,0
"08032351",ESC,Centre públic Dep. i CEB,Escola Pau Casals,Rubí,VOC,VOC,1,18,1,9,10,1,0,15,0,16,1,0,15,0,16,17,3,0,3,2,2,1,1,0
"08032385",FP,Centre públic Dep. i CEB,Institut Mitjans Audiovisuals,Barcelona,CEB,CEB,1,10,0,0,0,0,4,0,0,4,0,4,0,0,4,4,0,0,0,0,0,1,1,0
"08032476",ESC,Centre públic Dep. i CEB,Escola Prat de la Riba,Esplugues de Llobregat,BLL,BLL,1,10,6,2,8,2,0,0,1,3,2,0,0,1,3,9,0,0,0,7,3,1,1,0
"08032491",ESC,Centre públic Dep. i CEB,Escola Sant Vicenç,Mollet del Vallès,MVO,MVO,1,17,1,0,1,15,0,0,0,15,15,0,0,0,15,16,0,0,0,1,1,1,1,0
"08032521",ESC,Centre públic Dep. i CEB,Escola Vall de Palau,Sant Andreu de la Barca,BLL,BLL,1,18,0,4,4,14,4,0,0,18,14,4,0,0,18,18,14,4,18,0,0,1,1,0
"08032531",EE,EE Privats,Xaloc,Sabadell,VOC,VOC,0,1,0,0,0,0,0,0,0,0,3,0,0,0,3,3,0,0,0,0,0,0,1,0
"08032580",ESC,Centre públic Dep. i CEB,Escola Canigó,Sant Just Desvern,BLL,BLL,1,20,1,0,1,19,0,0,0,19,19,0,0,0,19,20,7,0,7,1,1,1,1,0
"08032592",ESC,Centre públic Dep. i CEB,Escola Sant Jordi,Sant Vicenç de Montalt,MVO,MVO,1,9,1,2,3,7,0,0,1,8,7,0,0,1,8,9,0,0,0,1,1,1,1,0
"08032634",ESC,Centre públic Dep. i CEB,Escola Ferrer i Guàrdia,Barcelona,CEB,CEB,1,18,5,17,22,0,0,4,1,5,0,0,4,1,5,10,4,0,4,13,5,1,1,0
"08032658",ESC,Centre públic Dep. i CEB,Escola L'Eramprunyà,Gavà,BLL,BLL,1,18,1,0,1,18,0,0,0,18,17,0,0,0,17,18,6,0,6,1,1,1,1,0
"08032713",ESC,Centre públic Dep. i CEB,Escola Sant Jordi,Mollet del Vallès,MVO,MVO,1,17,0,2,2,17,0,0,0,17,17,0,0,0,17,17,0,0,0,0,0,1,1,0
"08032725",ESC,Centre públic Dep. i CEB,Escola Honorable Josep Tarradellas,El Prat de Llobregat,BLL,BLL,1,20,1,0,1,18,2,0,0,20,18,1,0,0,19,20,0,2,2,1,1,1,1,0
"08032737",ESC,Centre públic Dep. i CEB,Escola Can Rull,Sabadell,VOC,VOC,1,18,1,0,1,20,0,0,0,20,17,0,0,0,17,18,17,0,17,1,1,1,1,0
"08032750",ESC,Centre públic Dep. i CEB,Escola Pau Casals,Viladecans,BLL,BLL,1,18,1,0,1,0,18,0,0,18,0,17,0,0,17,18,0,17,17,1,1,1,1,0
"08032762",ESC,Centre públic Dep. i CEB,Escola Doctor Trueta,Viladecans,BLL,BLL,1,18,0,0,0,18,0,0,0,18,18,0,0,0,18,18,18,0,18,0,0,1,1,0
"08033341",ESC,Centre públic Dep. i CEB,Escola Banús,Santa Coloma de Gramenet,BCO,BCO,1,15,1,1,2,7,0,0,0,7,7,0,0,0,7,8,7,0,7,2,2,1,1,0
"08033407",ESC,Centre públic Dep. i CEB,Escola Purificació Salas i Xandri,Sant Quirze del Vallès,VOC,VOC,1,9,10,0,10,6,0,1,0,7,0,0,0,0,0,10,0,0,0,9,3,1,1,0
"08033432",EE,EE Privats,Rel,Barcelona,CEB,CEB,0,1,0,0,0,0,0,0,0,0,2,0,0,0,2,2,0,0,0,0,0,0,1,0
"08033444",EE,EE Privats,Tramuntana,Sant Feliu de Llobregat,BLL,BLL,0,1,0,0,0,0,0,0,0,0,2,0,0,0,2,2,0,0,0,0,0,0,1,0
"08033468",ESC,Centre públic Dep. i CEB,Escola La Salut,Collbató,BLL,BLL,1,23,0,0,0,10,1,0,0,11,10,1,0,0,11,11,10,1,11,0,0,1,1,0
"08033501",ESC,Centre públic Dep. i CEB,Escola Antoni Brusi,Barcelona,CEB,CEB,1,19,0,0,0,16,3,0,0,19,16,3,0,0,19,19,16,3,19,0,0,1,1,0
"08033523",ESC,Centre públic Dep. i CEB,Escola La Muntanyeta,Barcelona,CEB,CEB,1,9,0,0,0,8,1,0,0,9,8,1,0,0,9,9,8,1,9,0,0,1,1,0
"08033535",ESC,Centre públic Dep. i CEB,Escola Joan Maragall,Esplugues de Llobregat,BLL,BLL,1,18,1,0,1,23,0,0,0,23,17,0,0,0,17,18,17,0,17,1,1,1,1,0
"08033560",ESC,Centre públic Dep. i CEB,Escola Màrius Torres,L'Hospitalet de Llobregat,BCO,BCO,1,20,1,0,1,19,2,0,0,21,19,0,0,0,19,20,19,0,19,1,1,1,1,0
"08033602",ESC,Centre públic Dep. i CEB,Escola Can Serra,Barberà del Vallès,VOC,VOC,1,18,0,0,0,19,0,0,0,19,18,0,0,0,18,18,10,0,10,0,0,1,1,0
"08033781",EE,EE municipals,CEE Maria Felip,Gavà,BLL,BLL,0,1,0,0,0,0,0,0,0,0,2,0,0,0,2,2,0,0,0,0,0,0,1,0
"08033869",INS,Centre públic Dep. i CEB,Institut Pau Casals,Badalona,BCO,BCO,1,22,0,19,19,12,0,0,8,20,12,0,0,8,20,20,12,8,20,2,2,1,1,0
"08033894",INS,Centre públic Dep. i CEB,Institut Teresa Pàmies,Barcelona,CEB,CEB,1,26,1,0,1,0,32,0,0,32,0,25,0,0,25,26,0,0,0,1,1,1,1,0
"08033900",INS,Centre públic Dep. i CEB,Institut Joan Miró,Cornellà de Llobregat,BLL,BLL,1,28,1,0,1,20,0,0,0,20,20,0,0,0,20,21,0,0,0,1,1,1,1,0
"08033912",INS,Centre públic Dep. i CEB,Institut Mercè Rodoreda,L'Hospitalet de Llobregat,BCO,BCO,1,22,0,0,0,21,1,0,0,22,21,1,0,0,22,22,21,1,22,0,0,1,1,0
"08033924",INS,Centre públic Dep. i CEB,Institut Pius Font i Quer,Manresa,CCE,CCE,1,27,2,0,2,26,0,0,10,36,25,0,0,0,25,27,25,0,25,2,2,1,1,0
"08033948",ESC,Centre públic Dep. i CEB,Escola Enric Tatché i Pol,Ripollet,VOC,VOC,1,20,0,0,0,13,6,0,0,19,13,6,0,0,19,19,13,6,19,0,0,1,1,0
"08033961",INS,Centre públic Dep. i CEB,Institut Rafael Casanova,Sant Boi de Llobregat,BLL,BLL,1,36,0,0,0,25,0,0,0,25,25,0,0,0,25,25,25,0,25,0,0,1,1,0
"08033973",INS,Centre públic Dep. i CEB,Institut Jaume Salvador i Pedrol,Sant Joan Despí,BLL,BLL,1,25,0,0,0,39,2,1,4,46,25,0,0,0,25,25,25,0,25,0,0,1,1,0
"08033985",INS,Centre públic Dep. i CEB,Institut de Sant Just Desvern,Sant Just Desvern,BLL,BLL,1,25,0,0,0,21,0,0,0,21,21,0,0,0,21,21,0,0,0,0,0,1,1,0
"08033997",ESC,Centre públic Dep. i CEB,Escola Primavera,Santa Coloma de Gramenet,BCO,BCO,1,9,1,0,1,8,0,0,0,8,8,0,0,0,8,9,8,0,8,1,1,1,1,0
"08034001",INS,Centre públic Dep. i CEB,Institut Terra Roja,Santa Coloma de Gramenet,BCO,BCO,1,29,0,2,2,21,0,0,0,21,21,0,0,0,21,21,0,0,0,2,2,1,1,0
"08034011",INS,Centre públic Dep. i CEB,Institut Frederic Mompou,Sant Vicenç dels Horts,BLL,BLL,1,29,0,0,0,18,0,4,0,22,18,0,4,0,22,22,0,0,0,0,0,1,1,0
"08034035",INS,Centre públic Dep. i CEB,Institut Federica Montseny,Badia del Vallès,VOC,VOC,1,19,2,0,2,17,0,0,0,17,17,0,0,0,17,19,17,0,17,2,2,1,1,0
"08034059",INS,Centre públic Dep. i CEB,Institut Nicolau Copèrnic,Terrassa,VOC,VOC,1,25,1,2,3,26,2,0,0,28,24,0,0,0,24,25,0,0,0,1,1,1,1,0
"08034060",ESC,Centre públic Dep. i CEB,Escola Mossèn Cinto Verdaguer,Rubí,VOC,VOC,1,18,1,3,4,20,1,4,0,25,17,0,0,0,17,18,17,0,17,1,1,1,1,0
"08034084",ESC,Centre públic Dep. i CEB,Escola Can Roca,Castelldefels,BLL,BLL,1,18,0,0,0,18,1,0,0,19,18,0,0,0,18,18,18,0,18,0,0,1,1,0
"08034096",ESC,Centre públic Dep. i CEB,Escola Antoni Gaudí,Castelldefels,BLL,BLL,1,18,0,0,0,17,1,0,0,18,17,1,0,0,18,18,17,1,18,0,0,1,1,0
"08034102",ESC,Centre públic Dep. i CEB,Escola Josep Maria Madorell,Molins de Rei,BLL,BLL,1,10,1,0,1,11,0,0,0,11,9,0,0,0,9,10,9,0,9,1,1,1,1,0
"08034126",ESC,Centre públic Dep. i CEB,Escola Pau Boada,Vilafranca del Penedès,BCO,PEN,1,12,2,1,3,6,0,5,0,11,6,0,4,0,10,12,0,0,0,2,2,1,1,0
"08034138",FP,Centre públic Dep. i CEB,Institut Poblenou,Barcelona,CEB,CEB,1,18,0,0,0,11,0,0,0,11,11,0,0,0,11,11,0,0,0,0,0,1,1,0
"08034163",EE,EE Privats,Centre Pilot  Sant Just Desvern,Sant Just Desvern,BLL,BLL,0,1,0,0,0,0,0,0,0,0,3,0,0,0,3,3,0,0,0,0,0,0,1,0
"08034187",INS,Centre públic Dep. i CEB,Institut Domènec Perramon,Arenys de Munt,MVO,MVO,1,18,1,0,1,12,15,0,0,27,12,5,0,0,17,18,0,0,0,1,1,1,1,0
"08034205",INS,Centre públic Dep. i CEB,Institut La Guineueta,Barcelona,CEB,CEB,1,34,0,0,0,0,37,0,0,37,0,34,0,0,34,34,0,34,34,0,0,1,1,0
"08034217",INS,Centre públic Dep. i CEB,Institut Bernat el Ferrer,Molins de Rei,BLL,BLL,1,38,1,1,2,36,0,0,0,36,36,0,0,0,36,37,36,0,36,2,2,1,1,0
"08034229",ESC,Centre públic Dep. i CEB,Escola Bonavista,Castellar del Vallès,VOC,VOC,1,9,1,0,1,9,0,0,0,9,8,0,0,0,8,9,8,0,8,1,1,1,1,0
"08034242",ESC,Centre públic Dep. i CEB,Escola Pablo Neruda,L'Hospitalet de Llobregat,BCO,BCO,1,9,1,0,1,9,0,0,0,9,8,0,0,0,8,9,3,0,3,1,1,1,1,0
"08034266",ESC,Centre públic Dep. i CEB,Escola Joan Maragall,L'Hospitalet de Llobregat,BCO,BCO,1,9,0,11,11,0,4,0,5,9,0,4,0,5,9,9,0,9,9,0,0,1,1,0
"08034278",ESC,Centre públic Dep. i CEB,Escola Vicente Aleixandre,Martorell,BLL,BLL,1,14,2,0,2,14,0,0,0,14,12,0,0,0,12,14,12,0,12,2,2,1,1,0
"08034291",EE,EE municipals,CEE Escola Llevant,Badalona,BCO,BCO,0,1,0,0,0,0,0,0,0,0,6,0,0,0,6,6,0,0,0,0,0,0,1,0
"08034308",EE,EE Privats,L'Arboç,Mataró,MVO,MVO,0,1,0,0,0,0,0,0,0,0,2,0,0,0,2,2,0,0,0,0,0,0,1,0
"08034321",ESC,Centre públic Dep. i CEB,Escola Torre Llauder,Mataró,MVO,MVO,1,10,1,0,1,6,4,0,0,10,6,3,0,0,9,10,3,3,6,1,1,1,1,0
"08034333",ESC,Centre públic Dep. i CEB,Escola La Llàntia,Mataró,MVO,MVO,1,19,1,3,4,14,2,4,0,20,14,2,2,0,18,19,14,2,16,1,1,1,1,0
"08034357",ESC,Centre públic Dep. i CEB,Escola Vista Alegre,Mataró,MVO,MVO,1,9,1,3,4,0,0,6,0,6,0,0,6,0,6,7,0,0,0,3,3,1,1,0
"08034382",ESC,Centre públic Dep. i CEB,Escola Ramon Llull,Rubí,VOC,VOC,1,17,1,0,1,25,1,0,0,26,16,0,0,0,16,17,16,0,16,1,1,1,1,0
"08034400",ESC,Centre públic Dep. i CEB,Escola Antoni Gaudí,Sant Boi de Llobregat,BLL,BLL,1,9,1,0,1,9,0,0,0,9,8,0,0,0,8,9,8,0,8,1,1,1,1,0
"08034412",ESC,Centre públic Dep. i CEB,Escola Can Massallera,Sant Boi de Llobregat,BLL,BLL,1,9,1,1,2,7,4,0,0,11,7,1,0,0,8,9,7,1,8,1,1,1,1,0
"08034448",ESC,Centre públic Dep. i CEB,Escola Santa Eulàlia,Les Roquetes (Sant Pere de Ribes),BCO,PEN,1,17,1,12,13,11,1,0,0,12,11,1,0,0,12,13,11,1,12,5,5,1,1,0
"08034461",ESC,Centre públic Dep. i CEB,Escola Bernat de Mogoda,Santa Perpètua de Mogoda,VOC,VOC,1,13,1,1,2,14,0,0,0,14,12,0,0,0,12,13,12,0,12,1,1,1,1,0
"08034485",ESC,TANCA el curs 2023-24,Escola Joan Marquès i Casals,Terrassa,VOC,VOC,1,0,1,0,1,16,2,0,0,18,0,0,0,0,0,1,0,0,0,1,0,1,0,0
"08034497",ESC,Centre públic Dep. i CEB,Escola L'Aragai,Vilanova i la Geltrú,BCO,PEN,1,11,0,0,0,11,0,0,0,11,11,0,0,0,11,11,11,0,11,0,0,1,1,0
"08034527",ESC,Centre públic Dep. i CEB,Escola Ramon Muntaner,L'Hospitalet de Llobregat,BCO,BCO,1,9,1,0,1,9,0,0,0,9,8,0,0,0,8,9,5,0,5,1,1,1,1,0
"08034564",INS,Centre públic Dep. i CEB,Institut Les Corts,Barcelona,CEB,CEB,1,30,0,0,0,20,2,0,0,22,20,2,0,0,22,22,20,2,22,0,0,1,1,0
"08034576",INS,Centre públic Dep. i CEB,Institut Joan Salvat i Papasseit,Barcelona,CEB,CEB,1,19,0,0,0,10,0,0,0,10,10,0,0,0,10,10,0,0,0,0,0,1,1,0
"08034591",INS,Centre públic Dep. i CEB,Institut Joan Oliver,Sabadell,VOC,VOC,1,20,1,2,3,15,0,0,0,15,15,0,0,0,15,16,0,0,0,3,3,1,1,0
"08034606",INS,Centre públic Dep. i CEB,Institut Baix Montseny,Sant Celoni,MVO,MVO,1,40,0,0,0,4,5,0,0,9,4,5,0,0,9,9,4,5,9,0,0,1,1,0
"08034621",INS,Centre públic Dep. i CEB,Institut de Sales,Viladecans,BLL,BLL,1,32,1,17,18,1,5,4,0,10,1,5,4,0,10,11,4,6,10,18,9,1,1,0
"08034643",INS,Centre públic Dep. i CEB,Institut Les Vinyes,Santa Coloma de Gramenet,BCO,BCO,1,32,0,0,0,29,2,0,1,32,29,2,0,1,32,32,29,3,32,0,0,1,1,0
"08034667",ESC,Centre públic Dep. i CEB,Escola Esteve Barrachina,Sitges,BCO,PEN,1,18,1,0,1,18,0,0,0,18,17,0,0,0,17,18,6,0,6,1,1,1,1,0
"08034709",INS,Centre públic Dep. i CEB,Institut Narcís Monturiol,Barcelona,CEB,CEB,1,8,0,0,0,1,1,0,0,2,1,1,0,0,2,2,1,1,2,0,0,1,1,0
"08034734",ESC,Centre públic Dep. i CEB,Escola Camí del Mig,Mataró,MVO,MVO,1,20,1,1,2,18,0,0,1,19,18,0,0,1,19,20,7,1,8,1,1,1,1,0
"08034746",ESC,Centre públic Dep. i CEB,Escola Rocafonda,Mataró,MVO,MVO,1,20,1,0,1,18,0,0,0,18,18,0,0,0,18,19,18,0,18,1,1,1,1,0
"08034783",ESC,Centre públic Dep. i CEB,Escola Elvira Cuyàs,Montcada i Reixac,VOC,VOC,1,18,1,0,1,18,1,0,0,19,17,0,0,0,17,18,17,0,17,1,1,1,1,0
"08034795",ESC-ZER,Centre públic Dep. i CEB,Escola Heurom - ZER Alt Lluçanès,Perafita,CCE,CCE,1,3,2,0,2,0,0,1,0,1,0,0,1,0,1,3,1,0,1,2,1,1,0,0
"08034801",EE,EE Privats,L'Heura,Terrassa,VOC,VOC,0,1,0,0,0,0,0,0,0,0,6,0,0,0,6,6,0,0,0,0,0,0,1,0
"08034837",ESC,Centre públic Dep. i CEB,Escola Bernat Desclot,L'Hospitalet de Llobregat,BCO,BCO,1,10,0,1,1,9,0,0,9,18,9,0,0,1,10,10,9,0,9,0,0,1,1,0
"08034850",ESC,Centre públic Dep. i CEB,Escola Pau Casals,L'Hospitalet de Llobregat,BCO,BCO,1,20,2,0,2,16,2,0,0,18,16,2,0,0,18,20,16,2,18,2,2,1,1,0
"08034862",ESC,Centre públic Dep. i CEB,Escola Ausiàs March,L'Hospitalet de Llobregat,BCO,BCO,1,9,0,0,0,10,0,0,0,10,9,0,0,0,9,9,9,0,9,0,0,1,1,0
"08034904",ESC,Centre públic Dep. i CEB,Escola Emili Carles i Tolrà,Castellar del Vallès,VOC,VOC,1,9,1,0,1,5,0,0,3,8,5,0,0,3,8,9,3,0,3,1,1,1,1,0
"08034965",ESC,Centre públic Dep. i CEB,Escola Margarida Xirgu,Badalona,BCO,BCO,1,18,1,11,12,18,0,0,0,18,17,0,0,0,17,18,17,0,17,1,1,1,1,0
"08034989",ESC,Centre públic Dep. i CEB,Escola Catalunya,Sant Adrià de Besòs,BCO,BCO,1,17,2,0,2,17,0,0,0,17,15,0,0,0,15,17,15,0,15,2,2,1,1,0
"08034990",ESC,Centre públic Dep. i CEB,Escola Parellada,Sant Boi de Llobregat,BLL,BLL,1,17,11,0,11,6,0,0,0,6,6,0,0,0,6,17,6,0,6,11,5,1,1,0
"08035003",INS,Centre públic Dep. i CEB,EA de Vic,Vic,CCE,CCE,1,20,0,0,0,8,3,0,0,11,8,3,0,0,11,11,0,0,0,0,0,1,1,0
"08035039",FP,Centre públic Dep. i CEB,Institut Bonanova,Barcelona,CEB,CEB,1,18,0,0,0,0,5,0,0,5,0,5,0,0,5,5,0,0,0,0,0,1,1,0
"08035064",EE,EE Privats,Fàsia-Eixample,Barcelona,CEB,CEB,0,1,0,0,0,0,0,0,0,0,2,0,0,0,2,2,0,0,0,0,0,0,1,0
"08035091",EE,EE Privats,Gavina,Barcelona,CEB,CEB,0,1,0,0,0,0,0,0,0,0,2,0,0,0,2,2,0,0,0,0,0,0,1,0
"08035143",INS,Centre públic Dep. i CEB,Institut Miquel Martí i Pol,Cornellà de Llobregat,BLL,BLL,1,34,0,4,4,27,15,0,0,42,27,7,0,0,34,34,27,7,34,0,0,1,1,0
"08035155",INS,Centre públic Dep. i CEB,Institut Els Tres Turons,Arenys de Mar,MVO,MVO,1,27,0,0,0,32,0,0,0,32,27,0,0,0,27,27,0,0,0,0,0,1,1,0
"08035167",INS,Centre públic Dep. i CEB,Institut Barcelona-Congrés,Barcelona,CEB,CEB,1,26,0,0,0,12,4,0,0,16,12,4,0,0,16,16,0,0,0,0,0,1,1,0
"08035209",INS,Centre públic Dep. i CEB,Institut Pablo R. Picasso,Barcelona,CEB,CEB,1,20,0,0,0,14,2,0,0,16,14,2,0,0,16,16,6,0,6,0,0,1,1,0
"08035222",INS,Centre públic Dep. i CEB,Institut Manuel Blancafort,La Garriga,MVO,MVO,1,22,0,0,0,12,0,0,6,18,12,0,0,6,18,18,12,6,18,0,0,1,1,0
"08035234",INS,Centre públic Dep. i CEB,Institut Vil·la Romana,La Garriga,MVO,MVO,1,30,2,0,2,0,2,0,0,2,0,2,0,0,2,4,0,2,2,2,2,1,1,0
"08035246",INS,Centre públic Dep. i CEB,Institut Gelida,Gelida,BCO,PEN,1,19,1,1,2,1,14,0,0,15,1,14,0,0,15,16,0,14,14,2,2,1,1,0
"08035258",INS,Centre públic Dep. i CEB,Institut Apel·les Mestres,L'Hospitalet de Llobregat,BCO,BCO,1,22,2,0,2,0,30,0,0,30,0,20,0,0,20,22,0,20,20,2,2,1,1,0
"08035283",ESC,Centre públic Dep. i CEB,Escola Reixac,Montcada i Reixac,VOC,VOC,1,18,1,0,1,11,1,6,0,18,11,1,5,0,17,18,17,0,17,1,1,1,1,0
"08035295",INS,Centre públic Dep. i CEB,Institut Palau Ausit,Ripollet,VOC,VOC,1,28,0,0,0,25,1,4,0,30,25,1,2,0,28,28,9,1,10,0,0,1,1,0
"08035301",INS,Centre públic Dep. i CEB,Institut Duc de Montblanc,Rubí,VOC,VOC,1,33,36,0,36,2,1,0,0,3,0,0,0,0,0,36,0,0,0,33,9,1,1,0
"08035313",INS,Centre públic Dep. i CEB,Institut Quercus,Sant Joan de Vilatorrada,CCE,CCE,1,32,29,5,34,0,2,4,2,8,0,2,1,0,3,32,3,0,3,29,9,1,1,0
"08035325",INS,Centre públic Dep. i CEB,Institut Torrent de les Bruixes,Santa Coloma de Gramenet,BCO,BCO,1,27,2,2,4,0,0,16,0,16,0,0,16,0,16,18,16,0,16,4,4,1,1,0
"08035349",INS,Centre públic Dep. i CEB,Institut La Romànica,Barberà del Vallès,VOC,VOC,1,32,2,0,2,0,0,37,0,37,0,0,30,0,30,32,0,0,0,2,2,1,1,0
"08035350",ESC,Centre públic Dep. i CEB,Escola Sant Josep,Sant Vicenç dels Horts,BLL,BLL,1,16,0,0,0,16,0,0,0,16,16,0,0,0,16,16,16,0,16,0,0,1,1,0
"08035362",INS,Centre públic Dep. i CEB,Institut Alt Penedès,Vilafranca del Penedès,BCO,PEN,1,28,0,0,0,20,5,0,4,29,20,5,0,3,28,28,20,8,28,0,0,1,1,0
"08035398",ESC,Centre públic Dep. i CEB,Escola Miguel Hernández,Badalona,BCO,BCO,1,9,1,0,1,0,3,0,1,4,0,3,0,1,4,5,0,0,0,1,1,1,1,0
"08035404",ESC,Centre públic Dep. i CEB,Escola Joan Miró,Badalona,BCO,BCO,1,9,1,1,2,9,0,0,0,9,8,0,0,0,8,9,0,0,0,1,1,1,1,0
"08035416",ESC,Centre públic Dep. i CEB,Escola Josep Boada,Badalona,BCO,BCO,1,18,1,0,1,0,12,0,6,18,0,12,0,5,17,18,0,17,17,1,1,1,1,0
"08035428",ESC,Centre públic Dep. i CEB,Escola La Farigola del Clot,Barcelona,CEB,CEB,1,20,1,0,1,16,2,0,0,18,16,2,0,0,18,19,16,2,18,1,1,1,1,0
"08035431",ESC,Centre públic Dep. i CEB,Escola Bogatell,Barcelona,CEB,CEB,1,18,0,0,0,14,4,0,0,18,14,4,0,0,18,18,14,4,18,0,0,1,1,0
"08035441",ESC,Centre públic Dep. i CEB,Escola Catalònia,Barcelona,CEB,CEB,1,18,1,0,1,18,0,0,0,18,17,0,0,0,17,18,12,0,12,1,1,1,1,0
"08035453",ESC,Centre públic Dep. i CEB,Escola Tomàs Moro,Barcelona,CEB,CEB,1,9,1,0,1,0,0,2,0,2,0,0,2,0,2,3,2,0,2,1,1,1,1,0
"08035465",ESC,Centre públic Dep. i CEB,Escola Mare Nostrum,Barcelona,CEB,CEB,1,18,1,0,1,0,0,17,0,17,0,0,17,0,17,18,0,0,0,1,1,1,1,0
"08035477",ESC,Centre públic Dep. i CEB,Escola Santiago Rusiñol,Barcelona,CEB,CEB,1,18,0,0,0,0,18,0,0,18,0,18,0,0,18,18,0,18,18,0,0,1,1,0
"08035519",ESC,Centre públic Dep. i CEB,Escola Antoni Gaudí,Santa Coloma de Gramenet,BCO,BCO,1,17,1,0,1,5,12,0,0,17,5,11,0,0,16,17,5,11,16,1,1,1,1,0
"08035532",EE,EE Privats,L'Alba,Barcelona,CEB,CEB,0,1,0,0,0,0,0,0,0,0,3,0,0,0,3,3,0,0,0,0,0,0,1,0
"08035544",EE,Centre públic Dep. i CEB,CEE Josep Pla,Barcelona,CEB,CEB,1,4,5,0,5,9,0,0,0,9,0,0,0,0,0,5,0,0,0,4,2,1,1,0
"08035623",EE,Centre públic Dep. i CEB,CEE Jeroni de Moragas,Cerdanyola del Vallès,VOC,VOC,1,6,3,2,5,4,1,0,0,5,3,0,0,0,3,6,3,0,3,3,2,1,1,0
"08035684",ESC,Centre públic Dep. i CEB,Escola Marià Manent,Premià de Dalt,MVO,MVO,1,18,1,1,2,18,0,0,0,18,17,0,0,0,17,18,17,0,17,1,1,1,1,0
"08035696",ESC,Centre públic Dep. i CEB,Escola Sant Julià,Sabadell,VOC,VOC,1,11,4,3,7,10,2,0,0,12,7,0,0,0,7,11,7,0,7,4,3,1,1,0
"08035854",ESC,Centre públic Dep. i CEB,Escola Llorens i Artigas,Badalona,BCO,BCO,1,18,0,1,1,18,0,0,0,18,18,0,0,0,18,18,18,0,18,0,0,1,1,0
"08035878",ESC,Centre públic Dep. i CEB,Escola Pere de Tera,Badalona,BCO,BCO,1,17,1,0,1,0,16,0,0,16,0,16,0,0,16,17,0,16,16,1,1,1,1,0
"08035881",ESC,Centre públic Dep. i CEB,Escola L'Areny,Cornellà de Llobregat,BLL,BLL,1,18,0,0,0,16,4,0,0,20,16,2,0,0,18,18,0,0,0,0,0,1,1,0
"08035945",ESC,Centre públic Dep. i CEB,Escola La Carpa,L'Hospitalet de Llobregat,BCO,BCO,1,27,1,0,1,27,0,0,0,27,26,0,0,0,26,27,0,0,0,1,1,1,1,0
"08035957",ESC,Centre públic Dep. i CEB,Escola Can Deu,Sabadell,VOC,VOC,1,9,1,0,1,0,10,0,0,10,0,8,0,0,8,9,0,8,8,1,1,1,1,0
"08035969",ESC,Centre públic Dep. i CEB,Escola Joaquim Blume,Sabadell,VOC,VOC,1,15,9,4,13,0,0,15,0,15,0,0,6,0,6,15,6,0,6,9,4,1,1,0
"08035994",ESC,Centre públic Dep. i CEB,Escola Salvador Espriu,Sant Feliu de Llobregat,BLL,BLL,1,18,0,2,2,21,0,0,0,21,18,0,0,0,18,18,0,2,2,0,0,1,1,0
"08036007",ESC,Centre públic Dep. i CEB,Escola Pau Vila,Sant Feliu de Llobregat,BLL,BLL,1,9,1,0,1,16,2,0,0,18,8,0,0,0,8,9,7,0,7,1,1,1,1,0
"08036044",ESC,Centre públic Dep. i CEB,Escola Pau Vila,Esparreguera,BLL,BLL,1,18,0,20,20,17,1,0,0,18,17,1,0,0,18,18,5,1,6,0,0,1,1,0
"08036056",ESC,Centre públic Dep. i CEB,Escola Folch i Torres,Esplugues de Llobregat,BLL,BLL,1,18,1,5,6,15,3,0,0,18,15,2,0,0,17,18,15,2,17,1,1,1,1,0
"08036101",ESC,Centre públic Dep. i CEB,Escola Sagrada Família,Santa Coloma de Gramenet,BCO,BCO,1,18,1,0,1,18,0,0,0,18,17,0,0,0,17,18,17,0,17,1,1,1,1,0
"08036111",ESC,Centre públic Dep. i CEB,Escola Mas i Perera,Vilafranca del Penedès,BCO,PEN,1,18,1,3,4,0,0,18,0,18,0,0,17,0,17,18,17,0,17,1,1,1,1,0
"08036135",ESC,Centre públic Dep. i CEB,Escola Joan Coret,Badalona,BCO,BCO,1,17,0,6,6,15,1,1,0,17,15,1,1,0,17,17,15,1,16,0,0,1,1,0
"08036147",ESC,Centre públic Dep. i CEB,Escola Pau Picasso,Badalona,BCO,BCO,1,15,2,1,3,20,1,0,0,21,13,0,0,0,13,15,10,1,11,2,2,1,1,0
"08036196",EE,EE Privats,Carrilet,Barcelona,CEB,CEB,0,1,0,0,0,0,0,0,0,0,1,0,0,0,1,1,0,0,0,0,0,0,1,0
"08036305",EE,EE Privats,Jeroni de Moragas,Santpedor,CCE,CCE,0,1,0,0,0,0,0,0,0,0,8,0,0,0,8,8,0,0,0,0,0,0,1,0
"08036317",EE,EE Privats,Bellaire,Cerdanyola del Vallès,VOC,VOC,0,1,0,0,0,0,0,0,0,0,2,0,0,0,2,2,0,0,0,0,0,0,1,0
"08036330",INS,Centre públic Dep. i CEB,Institut J.V. Foix,Rubí,VOC,VOC,1,21,3,0,3,17,2,0,0,19,17,1,0,0,18,21,10,3,13,3,3,1,1,0
"08036342",ESC,Centre públic Dep. i CEB,Escola Joan Llongueras,Badalona,BCO,BCO,1,9,2,0,2,9,0,0,0,9,7,0,0,0,7,9,7,0,7,2,2,1,1,0
"08036366",ESC,Centre públic Dep. i CEB,Escola Lola Anglada,L'Hospitalet de Llobregat,BCO,BCO,1,9,1,2,3,8,1,0,0,9,8,0,0,0,8,9,2,0,2,1,1,1,1,0
"08036378",ESC,Centre públic Dep. i CEB,Escola Charlie Rivel,L'Hospitalet de Llobregat,BCO,BCO,1,9,1,0,1,9,0,0,0,9,8,0,0,0,8,9,5,0,5,1,1,1,1,0
"08036391",INS,Centre públic Dep. i CEB,Institut Arquitecte Manuel Raspall,Cardedeu,MVO,MVO,1,29,0,0,0,20,0,0,0,20,20,0,0,0,20,20,20,0,20,0,0,1,1,0
"08036411",ESC,Centre públic Dep. i CEB,Escola Saltells,Cerdanyola del Vallès,VOC,VOC,1,13,0,0,0,9,0,0,4,13,9,0,0,4,13,13,5,4,9,0,0,1,1,0
"08037000",EE,EE Privats,Iris,Sant Vicenç dels Horts,BLL,BLL,0,1,0,0,0,0,0,0,0,0,3,0,0,0,3,3,0,0,0,0,0,0,1,0
"08037085",EE,EE Privats,Santa Maria de Queralt,Berga,CCE,CCE,0,1,0,0,0,0,0,0,0,0,2,0,0,0,2,2,0,0,0,0,0,0,1,0
"08037097",EE,EE Privats,Crespinell,Terrassa,VOC,VOC,0,1,0,0,0,0,0,0,0,0,2,0,0,0,2,2,0,0,0,0,0,0,1,0
"08037152",INS,Centre públic Dep. i CEB,Institut Joan Oró,Martorell,BLL,BLL,1,37,1,0,1,60,5,0,0,65,36,0,0,0,36,37,36,0,36,1,1,1,1,0
"08037176",INS,Centre públic Dep. i CEB,Institut La Bastida,Santa Coloma de Gramenet,BCO,BCO,1,30,1,0,1,23,0,0,0,23,23,0,0,0,23,24,0,0,0,1,1,1,1,0
"08037206",INS,Centre públic Dep. i CEB,Institut Lluís Companys,Ripollet,VOC,VOC,1,20,0,0,0,20,0,8,0,28,20,0,0,0,20,20,6,0,6,0,0,1,1,0
"08037280",FP,TANCA el curs 2023-24,CEE Escola Viver Castell de Sant Foix,Santa Maria de Martorelles,CEB,MVO,0,0,0,0,0,0,0,0,0,0,0,0,0,0,0,0,0,0,0,0,0,1,0,0
"08037292",EE,Centre públic Dep. i CEB,CEE Centre de Formació i Treball Flor de Maig,Cerdanyola del Vallès,VOC,VOC,1,19,8,0,8,6,0,0,0,6,6,0,0,0,6,14,6,0,6,8,5,1,1,0
"08037504",ESC,Centre públic Dep. i CEB,Escola Montnegre,La Batllòria (Sant Celoni),MVO,MVO,1,9,1,1,2,0,6,0,0,6,0,6,0,0,6,7,0,3,3,2,2,1,1,0
"08037528",ESC,Centre públic Dep. i CEB,Escola Sant Domènec,La Ràpita (Santa Margarida i els Monjos),BCO,PEN,1,9,2,0,2,9,0,0,0,9,7,0,0,0,7,9,7,0,7,2,2,1,1,0
"08037553",ESC,EPRI & ESO Municipals no CEB,Escola Municipal Salvador Llobet,Granollers,MVO,MVO,0,18,0,0,0,0,0,0,0,0,18,0,0,0,18,18,0,0,0,0,0,0,1,0
"08037681",EE,EE Privats,Esclat,Barcelona,CEB,CEB,0,1,0,0,0,0,0,0,0,0,2,0,0,0,2,2,0,0,0,0,0,0,1,0
"08037735",EE,EE Privats,Balmes I,Sant Boi de Llobregat,BLL,BLL,0,1,0,0,0,0,0,0,0,0,3,0,0,0,3,3,0,0,0,0,0,0,1,0
"08037814",ESC,Centre públic Dep. i CEB,Escola Alexandre Galí,Barcelona,CEB,CEB,1,18,9,3,12,11,0,3,0,14,9,0,0,0,9,18,3,0,3,9,5,1,1,0
"08037841",ESC,Centre públic Dep. i CEB,Escola Splai,Barcelona,CEB,CEB,1,9,1,0,1,0,2,0,4,6,0,2,0,4,6,7,0,6,6,1,1,1,1,0
"08037863",ESC,Centre públic Dep. i CEB,Escola Seat,Barcelona,CEB,CEB,1,18,10,2,12,6,0,0,0,6,6,0,0,0,6,16,6,0,6,12,5,1,1,0
"08037875",ESC,Centre públic Dep. i CEB,Escola Rafael Casanova,Badalona,BCO,BCO,1,18,1,0,1,15,0,0,0,15,15,0,0,0,15,16,15,0,15,1,1,1,1,0
"08037887",ESC,Centre públic Dep. i CEB,Escola Baldiri Reixac,Badalona,BCO,BCO,1,10,1,0,1,11,0,0,0,11,9,0,0,0,9,10,6,0,6,1,1,1,1,0
"08037899",ESC,Centre públic Dep. i CEB,Escola Folch i Torres,Badalona,BCO,BCO,1,9,1,0,1,9,0,0,0,9,8,0,0,0,8,9,8,0,8,1,1,1,1,0
"08037917",ESC,Centre públic Dep. i CEB,Escola Joan Miró,Can Diviu (Canovelles),MVO,MVO,1,10,0,0,0,0,9,0,0,9,0,9,0,0,9,9,0,0,0,0,0,1,1,0
"08037929",ESC,Centre públic Dep. i CEB,Escola Torre Barona,Castelldefels,BLL,BLL,1,16,0,0,0,19,1,1,0,21,16,0,0,0,16,16,16,0,16,0,0,1,1,0
"08037930",ESC,Centre públic Dep. i CEB,Escola Margalló,Castelldefels,BLL,BLL,1,12,2,0,2,14,1,2,0,17,10,0,0,0,10,12,10,0,10,2,2,1,1,0
"08037966",ESC,Centre públic Dep. i CEB,Escola Ignasi Iglésias,Cornellà de Llobregat,BLL,BLL,1,18,0,0,0,13,0,0,3,16,13,0,0,3,16,16,0,0,0,0,0,1,1,0
"08037978",ESC,Centre públic Dep. i CEB,Escola Suris,Cornellà de Llobregat,BLL,BLL,1,18,1,0,1,18,4,0,0,22,17,0,0,0,17,18,17,0,17,1,1,1,1,0
"08037981",ESC-ZER,Centre públic Dep. i CEB,Escola de L'Estany - ZER El Moianès Llevant,L'Estany,CCE,CCE,1,3,1,0,1,2,1,0,0,3,2,0,0,0,2,3,2,0,2,1,1,1,0,0
"08037991",ESC,Centre públic Dep. i CEB,Escola Marcel·lí Moragas,Gavà,BLL,BLL,1,17,1,0,1,15,1,0,0,16,15,1,0,0,16,17,15,1,16,1,1,1,1,0
"08038004",ESC,Centre públic Dep. i CEB,Escola Josep Janés,L'Hospitalet de Llobregat,BCO,BCO,1,17,20,0,20,3,0,0,0,3,0,0,0,0,0,20,0,0,0,17,5,1,1,0
"08038031",ESC,Centre públic Dep. i CEB,Escola Rosa Sensat,El Masnou,MVO,MVO,1,9,0,2,2,1,1,8,0,10,1,1,7,0,9,9,3,1,4,0,0,1,1,0
"08038041",ESC,Centre públic Dep. i CEB,Escola Federico García Lorca,Mollet del Vallès,MVO,MVO,1,9,1,2,3,3,0,0,0,3,3,0,0,0,3,4,0,0,0,3,3,1,1,0
"08038065",ESC,Centre públic Dep. i CEB,Escola Montseny,Mollet del Vallès,MVO,MVO,1,17,0,0,0,21,0,1,4,26,17,0,0,0,17,17,6,4,10,0,0,1,1,0
"08038077",ESC,Centre públic Dep. i CEB,Escola Can Parera,Montornès del Vallès,MVO,MVO,1,18,1,0,1,15,0,0,0,15,15,0,0,0,15,16,4,0,4,1,1,1,1,0
"08038089",ESC-ZER,Centre públic Dep. i CEB,Escola Sant Esteve - ZER El Cardener,Valls de Torroella (Sant Mateu de Bages),CCE,CCE,1,5,2,0,2,1,1,0,0,2,1,1,0,0,2,4,0,0,0,2,2,1,0,0
"08038090",ESC,Centre públic Dep. i CEB,Escola Sant Jaume,El Prat de Llobregat,BLL,BLL,1,20,0,6,6,15,2,1,0,18,15,2,1,0,18,18,16,2,18,2,2,1,1,0
"08038156",ESC,Centre públic Dep. i CEB,Escola Escursell i Bartalot,Ripollet,VOC,VOC,1,17,1,0,1,0,0,22,0,22,0,0,16,0,16,17,16,0,16,1,1,1,1,0
"08038168",ESC,Centre públic Dep. i CEB,Escola La Torreta,La Torreta (La Roca del Vallès),MVO,MVO,1,12,2,2,4,8,0,0,0,8,8,0,0,0,8,10,0,0,0,4,4,1,1,0
"08038171",ESC,Centre públic Dep. i CEB,Escola Montessori,Rubí,VOC,VOC,1,18,1,0,1,17,0,0,1,18,17,0,0,0,17,18,17,0,17,1,1,1,1,0
"08038181",ESC,Centre públic Dep. i CEB,Escola Serra i Húnter,Manresa,CCE,CCE,1,18,0,6,6,0,14,0,0,14,0,14,0,0,14,14,0,14,14,4,4,1,1,0
"08038201",ESC-ZER,Centre públic Dep. i CEB,Escola La Baumeta - ZER Els Castells,Santa Maria de Besora,CCE,CCE,1,2,1,1,2,0,0,0,0,0,0,0,0,0,0,1,0,0,0,2,1,1,0,1
"08038211",ESC,Centre públic Dep. i CEB,Escola José Juan Ortiz,Sant Andreu de la Barca,BLL,BLL,1,14,0,0,0,22,0,0,0,22,14,0,0,0,14,14,14,0,14,0,0,1,1,0
"08038223",ESC,Centre públic Dep. i CEB,Escola Benviure,Sant Boi de Llobregat,BLL,BLL,1,18,1,1,2,19,3,0,0,22,17,0,0,0,17,18,17,0,17,1,1,1,1,0
"08038247",ESC,Centre públic Dep. i CEB,Escola Pompeu Fabra,Vilanova del Camí,CCE,PEN,1,18,0,0,0,18,2,0,0,20,18,0,0,0,18,18,10,0,10,0,0,1,1,0
"08038259",ESC,Centre públic Dep. i CEB,Escola Antoni Tàpies,Sant Boi de Llobregat,BLL,BLL,1,18,3,2,5,16,0,0,0,16,15,0,0,0,15,18,6,0,6,3,3,1,1,0
"08038260",ESC,Centre públic Dep. i CEB,Escola Joan Maragall,Sant Cugat del Vallès,VOC,VOC,1,19,1,0,1,2,2,6,9,19,2,2,6,8,18,19,8,10,18,1,1,1,1,0
"08038272",ESC,Centre públic Dep. i CEB,Escola García Lorca,Santa Margarida de Montbui,CCE,PEN,1,18,0,0,0,18,0,0,0,18,18,0,0,0,18,18,18,0,18,0,0,1,1,0
"08038284",ESC,Centre públic Dep. i CEB,Escola La Guàrdia,Sant Vicenç dels Horts,BLL,BLL,1,9,1,0,1,11,1,0,0,12,8,0,0,0,8,9,8,0,8,1,1,1,1,0
"08038314",ESC,Centre públic Dep. i CEB,Escola Mare de Déu de Montserrat,Terrassa,VOC,VOC,1,9,1,0,1,8,0,0,1,9,8,0,0,0,8,9,0,0,0,1,1,1,1,0
"08038326",ESC,Centre públic Dep. i CEB,Escola El Vallès,Terrassa,VOC,VOC,1,11,2,0,2,7,0,0,0,7,7,0,0,0,7,9,0,4,4,2,2,1,1,0
"08038351",ESC,Centre públic Dep. i CEB,Escola Xarau,Cerdanyola del Vallès,VOC,VOC,1,10,1,0,1,10,0,0,0,10,9,0,0,0,9,10,3,0,3,1,1,1,1,0
"08038533",INS,Centre públic Dep. i CEB,EA Massana,Barcelona,CEB,CEB,1,7,0,0,0,3,4,0,0,7,3,4,0,0,7,7,0,2,2,0,0,1,1,0
"08038545",APD,APD & FP Municipals no CEB,EA Municipal Arsenal,Vilafranca del Penedès,BCO,PEN,0,6,0,0,0,0,0,0,0,0,6,0,0,0,6,6,0,0,0,0,0,0,0,0
"08038557",APD,APD & FP Municipals no CEB,EA de Terrassa,Terrassa,VOC,VOC,0,0,0,0,0,0,0,0,0,0,0,0,0,0,0,0,0,0,0,0,0,0,0,0
"08038569",APD,APD & FP Municipals no CEB,EA de Vilanova i la Geltrú,Vilanova i la Geltrú,BCO,PEN,0,16,0,0,0,0,0,0,0,0,16,0,0,0,16,16,0,0,0,0,0,0,1,0
"08038570",EOI,Centre públic Dep. i CEB,EOI de Barcelona,Barcelona,CEB,CEB,1,271,0,0,0,46,10,0,0,56,46,10,0,0,56,56,0,10,10,0,0,1,1,0
"08038582",ESC,Centre públic Dep. i CEB,Escola Catalunya,Sabadell,VOC,VOC,1,18,1,0,1,18,0,0,0,18,17,0,0,0,17,18,10,0,10,1,1,1,1,0
"08039057",INS,Centre públic Dep. i CEB,Institut L'Alzina,Barcelona,CEB,CEB,1,21,1,0,1,16,2,0,0,18,16,2,0,0,18,19,16,2,18,1,1,1,1,0
"08039069",INS,Centre públic Dep. i CEB,Institut Margarida Xirgu,L'Hospitalet de Llobregat,BCO,BCO,1,24,1,0,1,15,5,0,0,20,15,5,0,0,20,21,0,5,5,1,1,1,1,0
"08039203",INS,Centre públic Dep. i CEB,Institut Agustí Serra i Fontanet,Sabadell,VOC,VOC,1,47,2,0,2,33,0,0,0,33,33,0,0,0,33,35,33,0,33,2,2,1,1,0
"08039264",ESC,Centre públic Dep. i CEB,Escola Mestres Munguet-Cortés,Vilanova del Vallès,MVO,MVO,1,17,1,2,3,17,0,0,0,17,16,0,0,0,16,17,0,0,0,1,1,1,1,0
"08039288",ESC,Centre públic Dep. i CEB,Escola Renaixença,Sant Pere Sacarrera i Urbanització Font (Mediona),BCO,PEN,1,9,1,0,1,0,4,0,0,4,0,4,0,0,4,5,0,4,4,1,1,1,1,0
"08039291",ESC,Centre públic Dep. i CEB,Escola Cristòfor Mestre,Vilafranca del Penedès,BCO,PEN,1,19,1,1,2,19,0,0,0,19,18,0,0,0,18,19,6,0,6,1,1,1,1,0
"08039306",ESC-ZER,Centre públic Dep. i CEB,Escola Els Pins - ZER El Moianès Ponent,Cabrianes (Sallent),CCE,CCE,1,3,1,0,1,0,0,0,0,0,0,0,0,0,0,1,0,0,0,1,1,1,0,2
"08039318",ESC,Centre públic Dep. i CEB,Escola Puigberenguer,Manresa,CCE,CCE,1,19,6,0,6,13,0,0,0,13,13,0,0,0,13,19,8,0,8,6,5,1,1,0
"08039343",ESC,Centre públic Dep. i CEB,Escola Josep Ferrà i Esteva,Olesa de Montserrat,BLL,BLL,1,18,4,21,25,12,0,0,0,12,12,0,0,0,12,16,12,0,12,6,5,1,1,0
"08039355",ESC,Centre públic Dep. i CEB,Escola Ramon Llull,El Prat de Llobregat,BLL,BLL,1,18,0,0,0,0,18,0,0,18,0,18,0,0,18,18,0,0,0,0,0,1,1,0
"08039367",ESC,Centre públic Dep. i CEB,Escola Josep Pla,Sant Andreu de la Barca,BLL,BLL,1,18,1,0,1,18,0,0,0,18,17,0,0,0,17,18,0,0,0,1,1,1,1,0
"08039379",ESC,Centre públic Dep. i CEB,Escola Rafael Casanova,Sant Boi de Llobregat,BLL,BLL,1,15,1,6,7,15,4,0,0,19,14,0,0,0,14,15,0,4,4,1,1,1,1,0
"08039380",ESC,Centre públic Dep. i CEB,Escola Germans Amat i Targa,Viladecans,BLL,BLL,1,17,0,0,0,5,12,0,0,17,5,12,0,0,17,17,5,12,17,0,0,1,1,0
"08039434",ESC,Centre públic Dep. i CEB,Escola Doctor Ferran i Clua,Barcelona,CEB,CEB,1,23,3,0,3,19,0,0,0,19,19,0,0,0,19,22,19,0,19,3,3,1,1,0
"08039471",ESC,Centre públic Dep. i CEB,Escola Mercè Rodoreda,Barcelona,CEB,CEB,1,18,1,0,1,18,0,0,0,18,17,0,0,0,17,18,17,0,17,1,1,1,1,0
"08039483",ESC,Centre públic Dep. i CEB,Escola Els Horts,Barcelona,CEB,CEB,1,9,4,0,4,9,0,0,0,9,5,0,0,0,5,9,0,0,0,4,3,1,1,0
"08039495",ESC,Centre públic Dep. i CEB,Escola La Palmera,Barcelona,CEB,CEB,1,18,1,0,1,15,0,0,2,17,15,0,0,2,17,18,15,2,17,1,1,1,1,0
"08039525",ESC,Centre públic Dep. i CEB,Escola La Sedeta,Barcelona,CEB,CEB,1,9,0,0,0,6,0,3,0,9,6,0,3,0,9,9,9,0,9,0,0,1,1,0
"08039537",ESC,Centre públic Dep. i CEB,Escola Torrent d'en Melis,Barcelona,CEB,CEB,1,17,0,5,5,0,16,0,0,16,0,16,0,0,16,16,0,16,16,1,1,1,1,0
"08039562",ESC,Centre públic Dep. i CEB,Escola Prat de la Manta,L'Hospitalet de Llobregat,BCO,BCO,1,10,1,0,1,10,0,0,0,10,9,0,0,0,9,10,9,0,9,1,1,1,1,0
"08039574",ESC,Centre públic Dep. i CEB,Escola Pau Sans,L'Hospitalet de Llobregat,BCO,BCO,1,9,0,0,0,8,1,0,0,9,8,1,0,0,9,9,2,1,3,0,0,1,1,0
"08039586",ESC,Centre públic Dep. i CEB,Escola L'Arjau,Vilanova i la Geltrú,BCO,PEN,1,17,0,0,0,15,3,0,0,18,15,2,0,0,17,17,15,2,17,0,0,1,1,0
"08039598",ESC,Centre públic Dep. i CEB,Escola Sant Miquel del Cros,Argentona,MVO,MVO,1,13,4,3,7,7,0,0,0,7,7,0,0,0,7,11,0,0,0,6,4,1,1,0
"08039604",ESC,Centre públic Dep. i CEB,Escola Francesc Ferrer i Guàrdia,El Masnou,MVO,MVO,1,9,1,0,1,2,0,0,0,2,2,0,0,0,2,3,2,0,2,1,1,1,1,0
"08039616",ESC,Centre públic Dep. i CEB,Escola Camí del Cros,Mataró,MVO,MVO,1,18,1,3,4,15,0,0,0,15,15,0,0,0,15,16,15,0,15,3,3,1,1,0
"08039628",ESC,Centre públic Dep. i CEB,Escola Pompeu Fabra,Manlleu,CCE,CCE,1,19,0,2,2,14,0,4,0,18,14,0,4,0,18,18,18,0,18,1,1,1,1,0
"08039631",ESC,Centre públic Dep. i CEB,Escola L'Agullola,Rupit (Rupit i Pruit),CCE,CCE,1,9,0,0,0,0,0,0,1,1,0,0,0,1,1,1,0,0,0,0,0,1,1,0
"08039641",ESC,Centre públic Dep. i CEB,Escola Pablo Picasso,Barberà del Vallès,VOC,VOC,1,14,0,0,0,13,2,0,0,15,13,1,0,0,14,14,5,2,7,0,0,1,1,0
"08039653",ESC,Centre públic Dep. i CEB,Escola Agustí Bartra,Terrassa,VOC,VOC,1,19,2,0,2,0,1,0,18,19,0,1,0,16,17,19,0,10,10,2,2,1,1,0
"08039665",ESC,Centre públic Dep. i CEB,Escola Lanaspa-Giralt,Terrassa,VOC,VOC,1,9,3,1,4,8,2,0,0,10,6,0,0,0,6,9,3,0,3,3,3,1,1,0
"08039677",ESC,Centre públic Dep. i CEB,Escola Congost,Can Castells (Canovelles),MVO,MVO,1,17,1,1,2,10,3,4,0,17,10,3,3,0,16,17,14,2,16,1,1,1,1,0
"08039690",ESC,Centre públic Dep. i CEB,Escola Germans Corbella,Cardedeu,MVO,MVO,1,19,0,2,2,14,1,3,1,19,14,1,3,1,19,19,0,2,2,0,0,1,1,0
"08039707",ESC,Centre públic Dep. i CEB,Escola Tagamanent,La Garriga,MVO,MVO,1,9,0,0,0,12,1,0,0,13,9,0,0,0,9,9,9,0,9,0,0,1,1,0
"08039719",ESC,Centre públic Dep. i CEB,Escola Les Planes,La Llagosta,MVO,MVO,1,15,1,3,4,17,0,0,0,17,14,0,0,0,14,15,5,0,5,1,1,1,1,0
"08039744",ESC-ZER,Centre públic Dep. i CEB,Escola del Pont Trencat - ZER Baix Montseny,Santa Maria de Palautordera,MVO,MVO,1,4,1,0,1,4,0,0,0,4,3,0,0,0,3,4,3,0,3,1,1,1,0,0
"08039835",ESC,Centre públic Dep. i CEB,Escola de les Aigües,Barcelona,CEB,CEB,1,19,1,0,1,19,0,0,0,19,18,0,0,0,18,19,18,0,18,1,1,1,1,0
"08039896",ESC,Centre públic Dep. i CEB,Escola Bellaterra,Cerdanyola del Vallès,VOC,VOC,1,18,0,0,0,0,0,16,2,18,0,0,16,2,18,18,0,0,0,0,0,1,1,0
"08039963",EE,EE Privats,Fàsia-Sarrià,Barcelona,CEB,CEB,0,1,0,0,0,0,0,0,0,0,3,0,0,0,3,3,0,0,0,0,0,0,1,0
"08040011",APD,APD & FP Municipals no CEB,EA de Sant Cugat del Vallès,Sant Cugat del Vallès,VOC,VOC,0,2,0,0,0,0,0,0,0,0,2,0,0,0,2,2,0,0,0,0,0,0,1,0
"08040047",EE,Centre públic Dep. i CEB,CEE Josep Sol i Rodríguez,Santa Coloma de Gramenet,BCO,BCO,1,12,14,3,17,0,0,15,3,18,0,0,0,0,0,14,0,0,0,12,4,1,1,0
"08040059",ESC,Centre públic Dep. i CEB,Escola Joan Salvat i Papasseit,Santa Coloma de Gramenet,BCO,BCO,1,17,1,0,1,23,4,0,0,27,16,0,0,0,16,17,16,0,16,1,1,1,1,0
"08040060",ESC,Centre públic Dep. i CEB,Escola del Mar,Vilassar de Mar,MVO,MVO,1,18,0,3,3,0,15,0,0,15,0,15,0,0,15,15,0,10,10,3,3,1,1,0
"08040138",INS,Centre públic Dep. i CEB,Institut La Sedeta,Barcelona,CEB,CEB,1,14,3,0,3,12,0,0,0,12,11,0,0,0,11,14,0,0,0,3,3,1,1,0
"08040141",INS,Centre públic Dep. i CEB,Institut Icària,Barcelona,CEB,CEB,1,27,0,0,0,23,0,0,0,23,23,0,0,0,23,23,0,0,0,0,0,1,1,0
"08040333",ESC,Centre públic Dep. i CEB,Escola Bernat Metge,El Prat de Llobregat,BLL,BLL,1,9,1,0,1,8,1,0,0,9,8,0,0,0,8,9,3,0,3,1,1,1,1,0
"08040345",ESC,Centre públic Dep. i CEB,Escola Mercè Rodoreda,Badalona,BCO,BCO,1,9,0,0,0,7,2,0,0,9,7,2,0,0,9,9,2,1,3,0,0,1,1,0
"08040357",EE,Centre públic Dep. i CEB,CEE Folch i Camarasa,Barcelona,CEB,CEB,1,3,1,0,1,1,0,3,0,4,1,0,1,0,2,3,1,0,1,1,1,1,1,0
"08040382",ESC,Centre públic Dep. i CEB,Escola Mercè Rodoreda,Santa Coloma de Gramenet,BCO,BCO,1,18,1,5,6,0,0,3,3,6,0,0,3,3,6,7,0,0,0,6,5,1,1,0
"08040400",ESC,Centre públic Dep. i CEB,Escola Amadeu Vives,Sabadell,VOC,VOC,1,18,0,0,0,0,12,6,2,20,0,12,6,0,18,18,18,0,18,0,0,1,1,0
"08040412",ESC,Centre públic Dep. i CEB,Escola El Margalló,Vilanova i la Geltrú,BCO,PEN,1,9,1,0,1,13,0,0,0,13,8,0,0,0,8,9,7,1,8,1,1,1,1,0
"08040527",INS,Centre públic Dep. i CEB,Institut La Llauna,Badalona,BCO,BCO,1,27,2,0,2,20,2,0,0,22,20,2,0,0,22,24,0,0,0,2,2,1,1,0
"08040539",INS,Centre públic Dep. i CEB,Institut Les Marines,Castelldefels,BLL,BLL,1,29,1,1,2,20,0,0,0,20,20,0,0,0,20,21,20,0,20,2,2,1,1,0
"08040540",INS,Centre públic Dep. i CEB,Institut El Cairat,Esparreguera,BLL,BLL,1,34,0,0,0,23,0,0,0,23,23,0,0,0,23,23,0,0,0,0,0,1,1,0
"08040552",INS,Centre públic Dep. i CEB,Institut Antoni Pous i Argila,Manlleu,CCE,CCE,1,28,19,9,28,12,0,5,0,17,9,0,0,0,9,28,0,0,0,19,8,1,1,0
"08040564",INS,Centre públic Dep. i CEB,Institut Jaume Almera,Vilassar de Dalt,MVO,MVO,1,22,0,0,0,17,0,0,0,17,17,0,0,0,17,17,0,0,0,0,0,1,1,0
"08040618",ESC,Centre públic Dep. i CEB,Escola Can Vidalet,Esplugues de Llobregat,BLL,BLL,1,9,1,0,1,9,0,0,0,9,8,0,0,0,8,9,0,0,0,1,1,1,1,0
"08040849",INS,Centre públic Dep. i CEB,Institut Fort Pius,Barcelona,CEB,CEB,1,15,0,0,0,12,0,0,2,14,12,0,0,2,14,14,0,2,2,0,0,1,1,0
"08041076",EE,EE Privats,Taiga,Barcelona,CEB,CEB,0,1,0,0,0,0,0,0,0,0,2,0,0,0,2,2,0,0,0,0,0,0,1,0
"08041131",ESC,Centre públic Dep. i CEB,Escola Sant Antoni,Sant Vicenç dels Horts,BLL,BLL,1,9,0,0,0,6,3,3,3,15,6,3,0,0,9,9,9,0,9,0,0,1,1,0
"08041167",ESC,Centre públic Dep. i CEB,Escola Josep Carner,Badalona,BCO,BCO,1,18,2,1,3,18,0,0,0,18,16,0,0,0,16,18,16,0,16,2,2,1,1,0
"08041179",ESC,Centre públic Dep. i CEB,Escola Mestre Enric Gibert i Camins,Barcelona,CEB,CEB,1,19,0,7,7,19,0,0,0,19,19,0,0,0,19,19,0,0,0,0,0,1,1,0
"08041180",ESC,Centre públic Dep. i CEB,Escola Rosselló Pòrcel,Santa Coloma de Gramenet,BCO,BCO,1,9,1,0,1,4,0,4,0,8,4,0,4,0,8,9,8,0,8,1,1,1,1,0
"08041210",ESC,Centre públic Dep. i CEB,Escola del Bosc,Barberà del Vallès,VOC,VOC,1,17,1,1,2,0,17,0,0,17,0,16,0,0,16,17,0,9,9,1,1,1,1,0
"08041222",ESC,Centre públic Dep. i CEB,Escola Can Cladellas,Palau-solità i Plegamans,VOC,VOC,1,18,1,0,1,20,0,2,0,22,17,0,0,0,17,18,0,0,0,1,1,1,1,0
"08041234",ESC,Centre públic Dep. i CEB,Escola Collserola,Sant Cugat del Vallès,VOC,VOC,1,19,3,0,3,0,0,15,2,17,0,0,15,1,16,19,0,0,0,3,3,1,1,0
"08041246",ESC,Centre públic Dep. i CEB,Escola Francesc Aldea i Pérez,Terrassa,VOC,VOC,1,9,0,0,0,11,0,1,2,14,9,0,0,0,9,9,9,0,9,0,0,1,1,0
"08041374",INS,Centre públic Dep. i CEB,Institut La Mallola,Esplugues de Llobregat,BLL,BLL,1,25,4,10,14,8,0,0,0,8,8,0,0,0,8,12,0,0,0,14,7,1,1,0
"08041519",INS,Centre públic Dep. i CEB,Institut Martí Dot,Sant Feliu de Llobregat,BLL,BLL,1,35,1,0,1,30,6,0,0,36,30,4,0,0,34,35,0,6,6,1,1,1,1,0
"08041556",ESC,Centre públic Dep. i CEB,Escola Montseny,Sant Just Desvern,BLL,BLL,1,11,1,0,1,10,0,0,0,10,10,0,0,0,10,11,5,0,5,1,1,1,1,0
"08041568",ESC,Centre públic Dep. i CEB,Escola Jungfrau,Badalona,BCO,BCO,1,19,1,0,1,19,0,0,0,19,18,0,0,0,18,19,6,0,6,1,1,1,1,0
"08041571",ESC,Centre públic Dep. i CEB,Escola Artur Martorell,Badalona,BCO,BCO,1,11,1,1,2,10,0,0,0,10,10,0,0,0,10,11,10,0,10,1,1,1,1,0
"08041581",ESC,Centre públic Dep. i CEB,Escola Gitanjali,Badalona,BCO,BCO,1,9,1,0,1,9,0,0,0,9,8,0,0,0,8,9,8,0,8,1,1,1,1,0
"08041601",ESC,Centre públic Dep. i CEB,Escola Torre de la Llebre,Rubí,VOC,VOC,1,10,1,0,1,9,0,0,0,9,9,0,0,0,9,10,0,0,0,1,1,1,1,0
"08041611",ESC,Centre públic Dep. i CEB,Escola Joanot Alisanda,Sabadell,VOC,VOC,1,19,2,5,7,4,3,11,0,18,4,3,10,0,17,19,15,2,17,2,2,1,1,0
"08041647",ESC,Centre públic Dep. i CEB,Escola Ponent,Granollers,MVO,MVO,1,18,1,0,1,18,0,0,0,18,17,0,0,0,17,18,17,0,17,1,1,1,1,0
"08041659",ESC,Centre públic Dep. i CEB,Escola Mestres Montaña,Granollers,MVO,MVO,1,18,1,0,1,0,18,0,0,18,0,17,0,0,17,18,0,17,17,1,1,1,1,0
"08041660",ESC,Centre públic Dep. i CEB,Escola Pont de la Cadena,Molins de Rei,BLL,BLL,1,9,0,1,1,8,1,0,0,9,8,1,0,0,9,9,8,1,9,0,0,1,1,0
"08041672",ESC,Centre públic Dep. i CEB,Escola Creu Alta,Sabadell,VOC,VOC,1,10,1,0,1,10,0,0,0,10,9,0,0,0,9,10,9,0,9,1,1,1,1,0
"08041684",ESC,Centre públic Dep. i CEB,Escola Espai 3,Sant Joan Despí,BLL,BLL,1,18,0,2,2,18,0,0,0,18,18,0,0,0,18,18,0,0,0,0,0,1,1,0
"08041696",ESC,Centre públic Dep. i CEB,Escola Vaixell Burriac,Vilassar de Mar,MVO,MVO,1,18,1,1,2,16,2,0,0,18,16,1,0,0,17,18,16,1,17,1,1,1,1,0
"08041714",ESC,Centre públic Dep. i CEB,Escola Les Basseroles,Sant Miquel (Seva),CCE,CCE,1,9,1,0,1,1,0,1,5,7,1,0,1,5,7,8,2,5,7,1,1,1,1,0
"08041726",ESC,Centre públic Dep. i CEB,Escola Roc Blanc,Viladecavalls,VOC,VOC,1,12,1,2,3,12,0,0,0,12,11,0,0,0,11,12,11,0,11,1,1,1,1,0
"08041751",ESC,Centre públic Dep. i CEB,Escola La Caixa,Barcelona,CEB,CEB,1,11,0,0,0,10,2,0,0,12,10,1,0,0,11,11,3,2,5,0,0,1,1,0
"08041866",INS,Centre públic Dep. i CEB,Institut El Calamot,Gavà,BLL,BLL,1,31,6,0,6,32,4,0,0,36,25,0,0,0,25,31,0,0,0,6,6,1,1,0
"08041911",ESC,Centre públic Dep. i CEB,Escola Els Pins,Barcelona,CEB,CEB,1,9,0,0,0,2,1,0,2,5,2,1,0,2,5,5,2,3,5,0,0,1,1,0
"08041933",FP,TANCA el curs 2023-24,Institut Rubió i Tudurí,Barcelona,CEB,CEB,1,0,0,0,0,0,0,0,0,0,0,0,0,0,0,0,0,0,0,0,0,1,0,0
"08041969",ESC,Centre públic Dep. i CEB,Escola Pau Vila,Barcelona,CEB,CEB,1,9,0,0,0,4,0,7,0,11,4,0,5,0,9,9,9,0,9,0,0,1,1,0
"08041970",ESC,Centre públic Dep. i CEB,Escola Tres Pins,Barcelona,CEB,CEB,1,10,1,3,4,6,4,0,0,10,6,3,0,0,9,10,6,3,9,1,1,1,1,0
"08042019",INS,Centre públic Dep. i CEB,Institut Badalona VII,Badalona,BCO,BCO,1,20,0,0,0,0,18,0,2,20,0,18,0,2,20,20,1,0,1,0,0,1,1,0
"08042020",INS,Centre públic Dep. i CEB,Institut Vallès,Sabadell,VOC,VOC,1,25,4,0,4,24,0,0,0,24,21,0,0,0,21,25,21,0,21,4,4,1,1,0
"08042044",INS,Centre públic Dep. i CEB,Institut Mig-Món,Súria,CCE,CCE,1,20,0,0,0,1,16,0,0,17,1,16,0,0,17,17,1,16,17,0,0,1,1,0
"08042056",INS,Centre públic Dep. i CEB,Institut Can Puig,Sant Pere de Ribes,BCO,PEN,1,36,1,0,1,0,24,0,0,24,0,24,0,0,24,25,0,24,24,1,1,1,1,0
"08042093",INS,Centre públic Dep. i CEB,Institut Vinyes Velles,Montornès del Vallès,MVO,MVO,1,29,1,0,1,22,0,0,0,22,22,0,0,0,22,23,22,0,22,1,1,1,1,0
"08042101",INS,Centre públic Dep. i CEB,Institut Manuel Vázquez Montalbán,Sant Adrià de Besòs,BCO,BCO,1,20,0,0,0,16,0,0,2,18,16,0,0,2,18,18,16,2,18,0,0,1,1,0
"08042196",APD,APD & FP Municipals no CEB,EA de Manresa,Manresa,CCE,CCE,0,3,0,0,0,0,0,0,0,0,3,0,0,0,3,3,0,0,0,0,0,0,1,0
"08042287",ESC,Centre públic Dep. i CEB,Escola Salvador Espriu,Granollers,MVO,MVO,1,18,1,4,5,18,0,0,0,18,17,0,0,0,17,18,6,0,6,1,1,1,1,0
"08042299",ESC,Centre públic Dep. i CEB,Escola Sant Miquel,Cornellà de Llobregat,BLL,BLL,1,22,0,0,0,18,2,0,0,20,18,2,0,0,20,20,18,0,18,0,0,1,1,0
"08042305",ESC,Centre públic Dep. i CEB,Escola Joan Miró,Barcelona,CEB,CEB,1,18,2,0,2,18,0,0,0,18,16,0,0,0,16,18,16,0,16,2,2,1,1,0
"08042329",ESC,Centre públic Dep. i CEB,Escola Els Xiprers,Barcelona,CEB,CEB,1,9,0,0,0,5,0,4,0,9,5,0,4,0,9,9,1,0,1,0,0,1,1,0
"08042330",INS,Centre públic Dep. i CEB,Institut Sant Ramon,Cardona,CCE,CCE,1,8,0,8,8,4,2,0,0,6,4,2,0,0,6,6,2,0,2,2,2,1,1,0
"08042342",INS,Centre públic Dep. i CEB,Institut de Badia del Vallès,Badia del Vallès,VOC,VOC,1,27,0,0,0,23,2,0,0,25,23,2,0,0,25,25,23,2,25,0,0,1,1,0
"08042354",INS,Centre públic Dep. i CEB,EA La Industrial,Barcelona,CEB,CEB,1,9,0,0,0,7,8,0,0,15,7,2,0,0,9,9,7,2,9,0,0,1,1,0
"08042573",INS,Centre públic Dep. i CEB,Institut Lluïsa Cura,Barcelona,CEB,CEB,1,11,0,0,0,2,0,7,0,9,2,0,7,0,9,9,0,0,0,0,0,1,1,0
"08042585",EE,Centre públic Dep. i CEB,CEE Pont del Dragó,Barcelona,CEB,CEB,1,8,0,0,0,2,2,0,0,4,2,2,0,0,4,4,2,2,4,0,0,1,1,0
"08042780",ESC,Centre públic Dep. i CEB,Escola Josep Maria Jujol,Barcelona,CEB,CEB,1,18,0,0,0,17,2,0,0,19,17,1,0,0,18,18,17,1,18,0,0,1,1,0
"08042792",ESC,Centre públic Dep. i CEB,Escola Damià Mateu,Llinars del Vallès,MVO,MVO,1,10,1,0,1,10,0,0,0,10,9,0,0,0,9,10,9,0,9,1,1,1,1,0
"08042809",ESC,Centre públic Dep. i CEB,Escola Galileo Galilei,El Prat de Llobregat,BLL,BLL,1,18,1,1,2,18,0,0,0,18,17,0,0,0,17,18,17,0,17,1,1,1,1,0
"08042810",ESC,Centre públic Dep. i CEB,Escola Charles Darwin,El Prat de Llobregat,BLL,BLL,1,20,1,0,1,19,0,0,0,19,19,0,0,0,19,20,6,0,6,1,1,1,1,0
"08042834",ESC,Centre públic Dep. i CEB,Escola Can Palmer,Viladecans,BLL,BLL,1,11,1,0,1,0,11,0,1,12,0,10,0,0,10,11,0,0,0,1,1,1,1,0
"08042846",CFA,CFA Departament,CFA Cornellà de Llobregat,Cornellà de Llobregat,BLL,BLL,1,5,0,8,8,5,0,0,0,5,3,0,0,0,3,3,0,0,0,0,0,1,1,0
"08042858",CFA,CFA Departament,CFA Els Tarongers,Mataró,MVO,MVO,1,3,1,1,2,4,0,0,0,4,2,0,0,0,2,3,0,0,0,2,0,1,1,0
"08042861",ESC,Centre públic Dep. i CEB,Escola Lola Anglada,Esplugues de Llobregat,BLL,BLL,1,9,0,2,2,0,0,0,2,2,0,0,0,2,2,2,0,0,0,2,2,1,1,0
"08042871",ESC,Centre públic Dep. i CEB,Escola Patufet Sant Jordi-Francesc Batallé i Ara,L'Hospitalet de Llobregat,BCO,BCO,1,18,0,0,0,18,0,0,0,18,18,0,0,0,18,18,18,0,18,0,0,1,1,0
"08042883",ESC,Centre públic Dep. i CEB,Escola Sant Josep - El Pi,L'Hospitalet de Llobregat,BCO,BCO,1,9,2,2,4,9,0,0,0,9,7,0,0,0,7,9,5,0,5,2,2,1,1,0
"08042895",ESC,Centre públic Dep. i CEB,Escola Schola,Rubí,VOC,VOC,1,9,1,0,1,8,0,0,0,8,8,0,0,0,8,9,5,0,5,1,1,1,1,0
"08043012",APD,APD & FP Municipals no CEB,EA Illa,Sabadell,VOC,VOC,0,0,0,0,0,0,0,0,0,0,0,0,0,0,0,0,0,0,0,0,0,0,0,0
"08043103",ESC,Centre públic Dep. i CEB,Escola Antoni Balmanya,Barcelona,CEB,CEB,1,18,0,0,0,17,1,0,0,18,17,1,0,0,18,18,2,1,3,0,0,1,1,0
"08043115",ESC,Centre públic Dep. i CEB,Escola Provençals,Barcelona,CEB,CEB,1,18,1,18,19,16,0,0,0,16,16,0,0,0,16,17,0,0,0,2,2,1,1,0
"08043255",ESC,Centre públic Dep. i CEB,Escola Ítaca,Barcelona,CEB,CEB,1,18,0,0,0,18,0,0,0,18,18,0,0,0,18,18,0,0,0,0,0,1,1,0
"08043267",ESC,Centre públic Dep. i CEB,Escola Pau Casals-Gràcia,Barcelona,CEB,CEB,1,20,1,0,1,26,0,6,0,32,19,0,0,0,19,20,19,0,19,1,1,1,1,0
"08043279",ESC,Centre públic Dep. i CEB,Escola Pompeu Fabra,Barcelona,CEB,CEB,1,9,1,0,1,9,0,0,0,9,8,0,0,0,8,9,8,0,8,1,1,1,1,0
"08043292",ESC,Centre públic Dep. i CEB,Escola Tabor,Barcelona,CEB,CEB,1,19,0,0,0,19,0,0,0,19,19,0,0,0,19,19,15,0,15,0,0,1,1,0
"08043310",ESC,Centre públic Dep. i CEB,Escola Edumar,Castelldefels,BLL,BLL,1,18,1,0,1,15,3,0,0,18,15,2,0,0,17,18,5,3,8,1,1,1,1,0
"08043334",ESC,Centre públic Dep. i CEB,Escola Alexandre Galí,Cornellà de Llobregat,BLL,BLL,1,9,1,0,1,7,2,0,0,9,7,1,0,0,8,9,7,1,8,1,1,1,1,0
"08043346",ESC,Centre públic Dep. i CEB,Escola Montserrat,Esparreguera,BLL,BLL,1,9,0,0,0,9,0,0,0,9,9,0,0,0,9,9,9,0,9,0,0,1,1,0
"08043361",ESC,Centre públic Dep. i CEB,Escola El Turó,Montcada i Reixac,VOC,VOC,1,9,1,0,1,0,9,0,0,9,0,8,0,0,8,9,0,0,0,1,1,1,1,0
"08043371",ESC,Centre públic Dep. i CEB,Escola La Lió,Premià de Mar,MVO,MVO,1,9,0,0,0,4,2,2,1,9,4,2,2,1,9,9,5,0,5,0,0,1,1,0
"08043383",ESC,Centre públic Dep. i CEB,Escola Nostra Llar,Sabadell,VOC,VOC,1,19,2,0,2,18,1,0,0,19,17,0,0,0,17,19,17,0,17,2,2,1,1,0
"08043395",INS,Centre públic Dep. i CEB,Institut Alexandre de Riquer,Calaf,CCE,CCE,1,14,0,1,1,11,0,0,0,11,11,0,0,0,11,11,11,0,11,1,1,1,1,0
"08043401",ESC,Centre públic Dep. i CEB,Escola Barrufet,Sant Boi de Llobregat,BLL,BLL,1,13,1,0,1,14,0,0,0,14,12,0,0,0,12,13,0,0,0,1,1,1,1,0
"08043437",ESC,Centre públic Dep. i CEB,Escola Font de l'Alba,Terrassa,VOC,VOC,1,11,1,0,1,9,2,0,0,11,9,1,0,0,10,11,9,1,10,1,1,1,1,0
"08043462",INS,Centre públic Dep. i CEB,Institut Ernest Lluch,Barcelona,CEB,CEB,1,27,0,0,0,12,12,0,0,24,12,12,0,0,24,24,12,12,24,0,0,1,1,0
"08043474",ESC,Centre públic Dep. i CEB,Escola L'Estel,Barcelona,CEB,CEB,1,11,1,0,1,9,1,0,0,10,9,1,0,0,10,11,9,1,10,1,1,1,1,0
"08043486",INS,Centre públic Dep. i CEB,Institut Manolo Hugué,Caldes de Montbui,MVO,MVO,1,24,2,2,4,27,2,0,0,29,22,0,0,0,22,24,0,2,2,2,2,1,1,0
"08043504",INS,Centre públic Dep. i CEB,Institut Pere Calders,Cerdanyola del Vallès,VOC,VOC,1,20,0,0,0,2,3,18,0,23,2,3,15,0,20,20,0,0,0,0,0,1,1,0
"08043516",INS,Centre públic Dep. i CEB,Institut Santa Eulàlia,Terrassa,VOC,VOC,1,34,2,0,2,12,12,3,0,27,12,12,3,0,27,29,0,0,0,2,2,1,1,0
"08043589",INS,Centre públic Dep. i CEB,Institut Salvador Dalí,El Prat de Llobregat,BLL,BLL,1,28,0,0,0,21,1,0,0,22,21,1,0,0,22,22,0,0,0,0,0,1,1,0
"08043644",INS,Centre públic Dep. i CEB,Institut Carles Vallbona,Granollers,MVO,MVO,1,33,3,0,3,20,6,0,0,26,20,6,0,0,26,29,0,0,0,3,3,1,1,0
"08043656",INS,Centre públic Dep. i CEB,Institut Marina,La Llagosta,MVO,MVO,1,31,4,0,4,11,20,0,0,31,11,16,0,0,27,31,0,0,0,4,4,1,1,0
"08043668",INS,Centre públic Dep. i CEB,Institut L'Estatut,Rubí,VOC,VOC,1,23,0,0,0,22,0,0,0,22,22,0,0,0,22,22,22,0,22,0,0,1,1,0
"08043671",INS,Centre públic Dep. i CEB,Institut El Palau,Sant Andreu de la Barca,BLL,BLL,1,42,0,0,0,30,0,0,0,30,30,0,0,0,30,30,0,0,0,0,0,1,1,0
"08043681",INS,Centre públic Dep. i CEB,Institut Marianao,Sant Boi de Llobregat,BLL,BLL,1,26,0,0,0,25,2,0,0,27,25,1,0,0,26,26,0,2,2,0,0,1,1,0
"08043693",INS,Centre públic Dep. i CEB,Institut Joaquim Mir,Vilanova i la Geltrú,BCO,PEN,1,34,0,0,0,34,0,0,0,34,34,0,0,0,34,34,0,0,0,0,0,1,1,0
"08043747",ESC,Centre públic Dep. i CEB,Escola Baloo,Barcelona,CEB,CEB,1,9,0,0,0,0,0,7,0,7,0,0,7,0,7,7,2,0,2,0,0,1,1,0
"08043760",ESC,Centre públic Dep. i CEB,Escola Colònia Güell,La Colònia Güell (Santa Coloma de Cervelló),BLL,BLL,1,18,18,0,18,0,0,1,0,1,0,0,0,0,0,18,0,0,0,18,5,1,1,0
"08043784",ESC,Centre públic Dep. i CEB,Escola Àngels Garriga,Barcelona,CEB,CEB,1,9,1,0,1,5,0,1,0,6,5,0,1,0,6,7,3,0,3,1,1,1,1,0
"08043796",ESC,Centre públic Dep. i CEB,Escola Barrufet,Barcelona,CEB,CEB,1,18,2,0,2,18,0,0,0,18,16,0,0,0,16,18,6,0,6,2,2,1,1,0
"08043814",ESC,Centre públic Dep. i CEB,Escola Carlit,Barcelona,CEB,CEB,1,9,0,0,0,0,9,0,0,9,0,9,0,0,9,9,0,9,9,0,0,1,1,0
"08043838",ESC,Centre públic Dep. i CEB,Escola Turó del Cargol,Barcelona,CEB,CEB,1,10,0,0,0,7,0,0,2,9,7,0,0,2,9,9,8,1,9,0,0,1,1,0
"08043841",ESC,Centre públic Dep. i CEB,Escola Lavínia,Barcelona,CEB,CEB,1,9,0,0,0,9,0,0,0,9,9,0,0,0,9,9,7,0,7,0,0,1,1,0
"08043851",ESC,Centre públic Dep. i CEB,Escola Nabí,Barcelona,CEB,CEB,1,9,1,1,2,9,0,0,0,9,8,0,0,0,8,9,8,0,8,1,1,1,1,0
"08043863",ESC,Centre públic Dep. i CEB,Escola Orlandai,Barcelona,CEB,CEB,1,9,0,0,0,8,1,0,0,9,8,1,0,0,9,9,5,0,5,0,0,1,1,0
"08043875",ESC,Centre públic Dep. i CEB,Escola Pit-Roig,Barcelona,CEB,CEB,1,9,0,0,0,7,0,0,2,9,7,0,0,2,9,9,0,2,2,0,0,1,1,0
"08043887",ESC,Centre públic Dep. i CEB,Escola Sagrada Família,Barcelona,CEB,CEB,1,19,1,0,1,17,0,1,0,18,17,0,1,0,18,19,8,0,8,1,1,1,1,0
"08043899",ESC,Centre públic Dep. i CEB,Escola Tàber,Barcelona,CEB,CEB,1,17,0,0,0,18,0,0,0,18,17,0,0,0,17,17,10,0,10,0,0,1,1,0
"08043905",ESC,Centre públic Dep. i CEB,Escola El Dofí,Premià de Mar,MVO,MVO,1,9,0,4,4,0,0,6,1,7,0,0,6,1,7,7,4,0,4,2,2,1,1,0
"08043917",ESC,Centre públic Dep. i CEB,Escola Cossetània,Vilanova i la Geltrú,BCO,PEN,1,9,0,2,2,9,0,0,0,9,9,0,0,0,9,9,2,0,2,0,0,1,1,0
"08043929",ESC,Centre públic Dep. i CEB,Escola Llebetx,Vilanova i la Geltrú,BCO,PEN,1,9,1,1,2,9,0,0,0,9,8,0,0,0,8,9,0,0,0,1,1,1,1,0
"08043930",ESC,Centre públic Dep. i CEB,Escola Marinada,El Masnou,MVO,MVO,1,9,0,0,0,9,0,0,0,9,9,0,0,0,9,9,9,0,9,0,0,1,1,0
"08043942",ESC,Centre públic Dep. i CEB,Escola Montbui,Caldes de Montbui,MVO,MVO,1,18,1,1,2,22,3,5,1,31,17,0,0,0,17,18,14,3,17,1,1,1,1,0
"08043954",ESC,Centre públic Dep. i CEB,Escola Ribatallada,Sabadell,VOC,VOC,1,9,0,0,0,6,1,0,0,7,6,1,0,0,7,7,3,1,4,0,0,1,1,0
"08043966",ESC,Centre públic Dep. i CEB,Escola Heura,Barcelona,CEB,CEB,1,9,1,0,1,0,0,7,3,10,0,0,7,1,8,9,7,1,8,1,1,1,1,0
"08043978",INS,Centre públic Dep. i CEB,Institut Daniel Blanxart i Pedrals,Olesa de Montserrat,BLL,BLL,1,33,4,0,4,25,0,5,0,30,25,0,4,0,29,33,0,0,0,4,4,1,1,0
"08043981",INS,Centre públic Dep. i CEB,Institut Joan Ramon Benaprès,Sitges,BCO,PEN,1,34,0,0,0,34,2,0,0,36,34,0,0,0,34,34,0,0,0,0,0,1,1,0
"08044016",ESC,Centre públic Dep. i CEB,Escola Flama,Sant Fruitós de Bages,CCE,CCE,1,18,2,1,3,16,0,0,0,16,16,0,0,0,16,18,10,0,10,2,2,1,1,0
"08044028",EE,Centre públic Dep. i CEB,CEE Horitzó,Pineda de Mar,MVO,MVO,1,7,11,0,11,1,1,7,0,9,0,0,0,0,0,11,0,0,0,7,2,1,1,0
"08044041",APD,APD & FP Municipals no CEB,EA EDRA,Rubí,VOC,VOC,0,3,0,0,0,0,0,0,0,0,3,0,0,0,3,3,0,0,0,0,0,0,0,0
"08044053",FP,Centre públic Dep. i CEB,Institut Salvador Seguí,Barcelona,CEB,CEB,1,33,0,0,0,12,6,0,0,18,12,6,0,0,18,18,12,6,18,0,0,1,1,0
"08044077",APD,Centre públic Dep. i CEB,EA Josep Serra i Abella,L'Hospitalet de Llobregat,BCO,BCO,1,4,0,0,0,18,0,0,0,18,4,0,0,0,4,4,4,0,4,0,0,1,1,0
"08044120",CFA,CFA Departament,CFA Freire,Barcelona,CEB,CEB,1,3,0,0,0,3,1,0,5,9,3,0,0,0,3,3,0,0,0,0,0,1,1,0
"08044156",INS,Centre públic Dep. i CEB,EA Deià,Barcelona,CEB,CEB,1,10,0,0,0,8,0,0,0,8,8,0,0,0,8,8,0,0,0,0,0,1,1,0
"08044168",INS,Centre públic Dep. i CEB,Institut Pla de les Moreres,Vilanova del Camí,CCE,PEN,1,29,0,0,0,29,0,0,0,29,29,0,0,0,29,29,29,0,29,0,0,1,1,0
"08044201",ESC,Centre públic Dep. i CEB,Escola Dovella,Barcelona,CEB,CEB,1,9,1,2,3,3,6,1,0,10,3,5,0,0,8,9,4,4,8,1,1,1,1,0
"08044223",EE,Centre públic Dep. i CEB,CEE L'Estel- Can Bori,L'Hospitalet de Llobregat,BCO,BCO,1,11,11,0,11,10,0,0,0,10,0,0,0,0,0,11,0,0,0,11,3,1,1,0
"08044247",ESC,Centre públic Dep. i CEB,Escola Estel,Molins de Rei,BLL,BLL,1,9,1,0,1,5,4,0,0,9,5,3,0,0,8,9,5,3,8,1,1,1,1,0
"08044296",ESC,Centre públic Dep. i CEB,Escola Salvador Espriu,Badalona,BCO,BCO,1,18,0,0,0,18,0,0,0,18,18,0,0,0,18,18,18,0,18,0,0,1,1,0
"08044302",ESC,Centre públic Dep. i CEB,Escola Joan Abelló,Mollet del Vallès,MVO,MVO,1,19,0,0,0,16,2,0,0,18,16,2,0,0,18,18,8,0,8,0,0,1,1,0
"08044314",ESC,Centre públic Dep. i CEB,Escola Andreu Castells,Sabadell,VOC,VOC,1,18,0,0,0,0,9,0,0,9,0,9,0,0,9,9,0,0,0,0,0,1,1,0
"08044430",ESC,Centre públic Dep. i CEB,Escola La Garalda,Pallejà,BLL,BLL,1,19,0,12,12,16,0,0,0,16,16,0,0,0,16,16,16,0,16,3,3,1,1,0
"08044454",ESC,Centre públic Dep. i CEB,Escola Pilarín Bayés,Les Fonts (Sant Quirze del Vallès),VOC,VOC,1,19,1,0,1,18,0,0,0,18,18,0,0,0,18,19,18,0,18,1,1,1,1,0
"08044508",ESC,Centre públic Dep. i CEB,Escola Ítaca,Badalona,BCO,BCO,1,9,1,0,1,1,12,0,0,13,1,7,0,0,8,9,1,5,6,1,1,1,1,0
"08044511",EOI,Centre públic Dep. i CEB,EOI Barcelona-Vall d'Hebron,Barcelona,CEB,CEB,1,106,0,0,0,22,3,0,0,25,22,3,0,0,25,25,7,3,10,0,0,1,1,0
"08044521",ESC,Centre públic Dep. i CEB,Escola Els Pinetons,La Garriga,MVO,MVO,1,19,0,13,13,12,0,0,0,12,12,0,0,0,12,12,6,3,9,7,5,1,1,0
"08044533",INS,Centre públic Dep. i CEB,Institut La Ferreria,Montcada i Reixac,VOC,VOC,1,33,0,0,0,24,4,3,0,31,24,4,3,0,31,31,0,0,0,0,0,1,1,0
"08044545",ESC,Centre públic Dep. i CEB,Escola Collbaix,Sant Joan de Vilatorrada,CCE,CCE,1,11,1,0,1,0,0,0,9,9,0,0,0,9,9,10,0,9,9,1,1,1,1,0
"08044569",INS,Centre públic Dep. i CEB,Institut Pere Barnils,Centelles,CCE,CCE,1,30,1,0,1,25,2,0,0,27,25,2,0,0,27,28,25,2,27,1,1,1,1,0
"08044570",INS,Centre públic Dep. i CEB,Institut Vall d'Arús,Vallirana,BLL,BLL,1,34,5,3,8,24,4,0,0,28,24,4,0,0,28,33,24,4,28,6,6,1,1,0
"08044582",EOI,Centre públic Dep. i CEB,EOI de L'Hospitalet de Llobregat,L'Hospitalet de Llobregat,BCO,BCO,1,81,0,0,0,0,14,0,5,19,0,14,0,5,19,19,0,19,19,0,0,1,1,0
"08044594",INS,Centre públic Dep. i CEB,Institut Giola,Llinars del Vallès,MVO,MVO,1,30,0,0,0,4,0,28,4,36,4,0,26,0,30,30,8,0,8,0,0,1,1,0
"08044600",INS,Centre públic Dep. i CEB,Institut Moianès,Moià,CCE,CCE,1,18,0,0,0,18,1,0,0,19,18,0,0,0,18,18,0,0,0,0,0,1,1,0
"08044612",INS,Centre públic Dep. i CEB,Institut Torre de Malla,Parets del Vallès,MVO,MVO,1,37,1,0,1,20,5,0,0,25,20,5,0,0,25,26,0,0,0,1,1,1,1,0
"08044624",INS,Centre públic Dep. i CEB,Institut Sabadell,Sabadell,VOC,VOC,1,37,0,0,0,27,1,0,0,28,27,1,0,0,28,28,0,0,0,0,0,1,1,0
"08044636",EOI,Centre públic Dep. i CEB,EOI de Sabadell,Sabadell,VOC,VOC,1,69,0,0,0,0,26,0,0,26,0,26,0,0,26,26,0,4,4,0,0,1,1,0
"08044648",ESC,Centre públic Dep. i CEB,Escola La Roda,Terrassa,VOC,VOC,1,18,2,1,3,8,6,0,0,14,8,6,0,0,14,16,8,6,14,3,3,1,1,0
"08044715",INS,Centre públic Dep. i CEB,Institut Jaume Mimó,Cerdanyola del Vallès,VOC,VOC,1,24,16,8,24,7,0,0,0,7,7,0,0,0,7,23,0,0,0,17,7,1,1,0
"08044739",EE,EE Privats,Nadís,Barcelona,CEB,CEB,0,1,0,0,0,0,0,0,0,0,1,0,0,0,1,1,0,0,0,0,0,0,1,0
"08044910",ESC,Centre públic Dep. i CEB,Escola El Turonet,Sant Quirze del Vallès,VOC,VOC,1,9,1,0,1,10,1,0,0,11,8,0,0,0,8,9,8,0,8,1,1,1,1,0
"08044922",INS,Centre públic Dep. i CEB,Institut Dr. Puigvert,Barcelona,CEB,CEB,1,28,0,0,0,21,2,0,0,23,21,2,0,0,23,23,21,2,23,0,0,1,1,0
"08044934",FP,Centre públic Dep. i CEB,Institut Escola d'Hoteleria i Turisme de Barcelona,Barcelona,CEB,CEB,1,24,0,0,0,12,5,0,0,17,12,5,0,0,17,17,0,3,3,0,0,1,1,0
"08044958",INS,Centre públic Dep. i CEB,Institut Josep Pla,Barcelona,CEB,CEB,1,16,0,0,0,16,0,0,0,16,16,0,0,0,16,16,0,0,0,0,0,1,1,0
"08044971",INS,Centre públic Dep. i CEB,Institut Pere Fontdevila,Gironella,CCE,CCE,1,18,1,2,3,13,0,0,0,13,13,0,0,0,13,14,0,0,0,3,3,1,1,0
"08044983",INS,Centre públic Dep. i CEB,Institut Lluís Companys,Tordera,MVO,MVO,1,25,5,9,14,18,0,0,0,18,18,0,0,0,18,23,0,0,0,7,7,1,1,0
"08044995",INS,Centre públic Dep. i CEB,Institut Barres i Ones,Badalona,BCO,BCO,1,29,0,0,0,20,3,0,0,23,20,3,0,0,23,23,20,3,23,0,0,1,1,0
"08045011",INS,Centre públic Dep. i CEB,Institut Torre del Palau,Terrassa,VOC,VOC,1,31,0,0,0,25,1,0,0,26,25,1,0,0,26,26,1,1,2,0,0,1,1,0
"08045021",INS,Centre públic Dep. i CEB,Institut Estela Ibèrica,Santa Perpètua de Mogoda,VOC,VOC,1,22,0,0,0,0,24,0,1,25,0,22,0,0,22,22,1,1,2,0,0,1,1,0
"08045033",ESC,Centre públic Dep. i CEB,Escola Montpalau,Pineda de Mar,MVO,MVO,1,9,1,2,3,1,0,2,0,3,1,0,2,0,3,4,0,0,0,3,3,1,1,0
"08045045",ESC,Centre públic Dep. i CEB,Escola Mediterrània,Pineda de Mar,MVO,MVO,1,10,0,0,0,9,0,0,0,9,9,0,0,0,9,9,9,0,9,0,0,1,1,0
"08045057",ESC,Centre públic Dep. i CEB,Escola El Sagrer,Barcelona,CEB,CEB,1,18,0,1,1,17,1,0,0,18,17,1,0,0,18,18,17,1,18,0,0,1,1,0
"08045069",EE,EE Privats,Balmes II,Sant Boi de Llobregat,BLL,BLL,0,1,0,0,0,0,0,0,0,0,2,0,0,0,2,2,0,0,0,0,0,0,1,0
"08045070",INS,Centre públic Dep. i CEB,Institut Europa,L'Hospitalet de Llobregat,BCO,BCO,1,16,0,0,0,0,10,0,0,10,0,10,0,0,10,10,0,10,10,0,0,1,1,0
"08045203",INS,Casos especials,Institut Obert de Catalunya,Barcelona,BCO,CEB,1,0,0,0,0,5,0,11,0,16,0,0,0,0,0,0,0,0,0,0,0,1,0,0
"08045227",EE,Centre públic Dep. i CEB,CEE Les Aigües,Mataró,MVO,MVO,1,14,16,8,24,0,0,5,0,5,0,0,0,0,0,16,0,0,0,14,4,1,1,0
"08045306",INS,Centre públic Dep. i CEB,Institut Ramon Casas i Carbó,Palau-solità i Plegamans,VOC,VOC,1,33,1,0,1,28,0,0,0,28,28,0,0,0,28,29,0,0,0,1,1,1,1,0
"08045471",INS,Centre públic Dep. i CEB,Institut Pompeu Fabra,Badalona,BCO,BCO,1,30,0,0,0,30,0,0,0,30,30,0,0,0,30,30,30,0,30,0,0,1,1,0
"08045483",INS,Centre públic Dep. i CEB,Institut Vila de Gràcia,Barcelona,CEB,CEB,1,18,0,0,0,14,0,0,0,14,14,0,0,0,14,14,0,0,0,0,0,1,1,0
"08045495",APD,APD & FP Municipals no CEB,EA d'Igualada,Igualada,CCE,PEN,0,4,0,0,0,0,0,0,0,0,4,0,0,0,4,4,0,0,0,0,0,0,0,0
"08045513",INS,Centre públic Dep. i CEB,Institut Flos i Calcat,Barcelona,CEB,CEB,1,20,3,0,3,11,2,2,0,15,11,2,2,0,15,18,0,0,0,3,3,1,1,0
"08045525",INS,Centre públic Dep. i CEB,Institut Manuel Carrasco i Formiguera,Barcelona,CEB,CEB,1,12,0,0,0,13,1,0,0,14,12,0,0,0,12,12,12,0,12,0,0,1,1,0
"08045537",INS,Centre públic Dep. i CEB,Institut Josep Lluís Sert,Castelldefels,BLL,BLL,1,24,0,1,1,22,0,0,0,22,22,0,0,0,22,22,0,0,0,1,1,1,1,0
"08045549",INS,Centre públic Dep. i CEB,Institut Banús,Cerdanyola del Vallès,VOC,VOC,1,28,0,0,0,10,11,0,0,21,10,11,0,0,21,21,10,11,21,0,0,1,1,0
"08045562",INS,Centre públic Dep. i CEB,Institut Can Planas,Barberà del Vallès,VOC,VOC,1,27,0,0,0,25,0,0,0,25,25,0,0,0,25,25,25,0,25,0,0,1,1,0
"08045574",ESC,Centre públic Dep. i CEB,Escola Serra de Marina,Santa Coloma de Gramenet,BCO,BCO,1,18,1,0,1,18,0,0,0,18,17,0,0,0,17,18,10,0,10,1,1,1,1,0
"08045586",ESC,Centre públic Dep. i CEB,Escola Les Pruneres,Martorelles,MVO,MVO,1,9,1,0,1,7,0,0,0,7,7,0,0,0,7,8,3,0,3,1,1,1,1,0
"08045598",ESC,Centre públic Dep. i CEB,Escola Mil·lenari,Cardedeu,MVO,MVO,1,18,0,0,0,14,0,1,2,17,14,0,1,2,17,17,2,0,2,0,0,1,1,0
"08045604",INS,Centre públic Dep. i CEB,Institut Enric Borràs,Badalona,BCO,BCO,1,38,0,0,0,27,0,0,0,27,27,0,0,0,27,27,0,0,0,0,0,1,1,0
"08045628",INS,Centre públic Dep. i CEB,Institut Celestí Bellera,Granollers,MVO,MVO,1,30,0,0,0,20,0,0,0,20,20,0,0,0,20,20,20,0,20,0,0,1,1,0
"08045641",INS,Centre públic Dep. i CEB,Institut Lluís Domènech i Montaner,Canet de Mar,MVO,MVO,1,37,0,0,0,27,0,0,0,27,27,0,0,0,27,27,27,0,27,0,0,1,1,0
"08045653",INS,Centre públic Dep. i CEB,Institut Dolors Mallafrè i Ros,Vilanova i la Geltrú,BCO,PEN,1,22,0,0,0,26,2,0,0,28,22,0,0,0,22,22,22,0,22,0,0,1,1,0
"08045665",INS,Centre públic Dep. i CEB,Institut Ramon Turró i Darder,Malgrat de Mar,MVO,MVO,1,31,0,0,0,26,1,0,0,27,26,1,0,0,27,27,0,0,0,0,0,1,1,0
"08045677",INS,Centre públic Dep. i CEB,Institut Thalassa,Montgat,MVO,MVO,1,19,1,0,1,0,19,0,0,19,0,18,0,0,18,19,0,18,18,1,1,1,1,0
"08045689",INS,Centre públic Dep. i CEB,Institut Voltrera,Abrera,BLL,BLL,1,30,1,0,1,19,4,0,0,23,19,4,0,0,23,24,0,0,0,1,1,1,1,0
"08045768",EE,EE Privats,Barcanova,Santa Perpètua de Mogoda,VOC,VOC,0,1,0,0,0,0,0,0,0,0,5,0,0,0,5,5,0,0,0,0,0,0,1,0
"08045859",INS,Centre públic Dep. i CEB,Institut de Corbera de Llobregat,Corbera de Llobregat,BLL,BLL,1,33,2,0,2,18,0,0,0,18,18,0,0,0,18,20,18,0,18,2,2,1,1,0
"08045860",INS,Centre públic Dep. i CEB,Institut Miramar,Viladecans,BLL,BLL,1,23,1,0,1,0,33,0,0,33,0,22,0,0,22,23,0,0,0,1,1,1,1,0
"08046281",ESC,Centre públic Dep. i CEB,Escola Estel-Guinardó,Barcelona,CEB,CEB,1,9,0,0,0,9,1,0,0,10,9,0,0,0,9,9,9,0,9,0,0,1,1,0
"08046293",ESC,Centre públic Dep. i CEB,Escola Cavall Bernat,Barcelona,CEB,CEB,1,9,1,0,1,2,0,0,0,2,2,0,0,0,2,3,2,0,2,1,1,1,1,0
"08046396",EE,EE Privats,Xalest,Sabadell,VOC,VOC,0,1,0,0,0,0,0,0,0,0,4,0,0,0,4,4,0,0,0,0,0,0,1,0
"08046475",APD,APD & FP Municipals no CEB,EA de la Garriga,La Garriga,MVO,MVO,0,5,0,0,0,0,0,0,0,0,5,0,0,0,5,5,0,0,0,0,0,0,1,0
"08046581",INS,Centre públic Dep. i CEB,Institut Lluís Vives,Barcelona,CEB,CEB,1,16,0,0,0,9,3,0,0,12,9,3,0,0,12,12,0,3,3,0,0,1,1,0
"08046608",INS,Centre públic Dep. i CEB,Institut Príncep de Viana,Barcelona,CEB,CEB,1,22,2,0,2,0,19,0,0,19,0,19,0,0,19,21,0,0,0,2,2,1,1,0
"08046645",INS,Centre públic Dep. i CEB,Institut Molí de la Vila,Capellades,CCE,PEN,1,27,2,1,3,20,0,0,0,20,20,0,0,0,20,22,0,0,0,3,3,1,1,0
"08046657",INS,Centre públic Dep. i CEB,Institut Joaquim Blume,Esplugues de Llobregat,BLL,BLL,1,14,0,0,0,0,10,0,5,15,0,10,0,4,14,14,0,0,0,0,0,1,1,0
"08046669",INS,Centre públic Dep. i CEB,Institut Ribot i Serra,Sabadell,VOC,VOC,1,17,0,0,0,21,5,4,0,30,17,0,0,0,17,17,0,0,0,0,0,1,1,0
"08046670",INS,Centre públic Dep. i CEB,Institut Angeleta Ferrer i Sensat,Sant Cugat del Vallès,VOC,VOC,1,28,0,1,1,24,0,0,0,24,24,0,0,0,24,24,0,0,0,1,1,1,1,0
"08046682",INS,Centre públic Dep. i CEB,Institut de Castellar,Castellar del Vallès,VOC,VOC,1,30,0,0,0,30,0,0,0,30,30,0,0,0,30,30,0,0,0,0,0,1,1,0
"08046694",INS,Centre públic Dep. i CEB,Institut Centre d'Alt Rendiment Esportiu,Sant Cugat del Vallès,VOC,VOC,1,24,0,0,0,12,0,0,0,12,12,0,0,0,12,12,0,0,0,0,0,1,1,0
"08046724",INS,Centre públic Dep. i CEB,Institut Montserrat Roig,Terrassa,VOC,VOC,1,25,0,0,0,27,3,0,0,30,25,0,0,0,25,25,0,3,3,0,0,1,1,0
"08046736",INS,Centre públic Dep. i CEB,Institut Milà i Fontanals,Vilafranca del Penedès,BCO,PEN,1,32,1,12,13,20,2,0,0,22,20,2,0,0,22,23,0,2,2,10,9,1,1,0
"08046748",INS,Centre públic Dep. i CEB,Institut Thos i Codina,Mataró,MVO,MVO,1,30,1,0,1,0,0,4,4,8,0,0,4,4,8,9,0,4,4,1,1,1,1,0
"08046751",INS,Centre públic Dep. i CEB,Institut Ventura Gassol,Badalona,BCO,BCO,1,20,0,0,0,20,0,0,0,20,20,0,0,0,20,20,0,0,0,0,0,1,1,0
"08046761",INS,Centre públic Dep. i CEB,Institut Guillem Catà,Manresa,CCE,CCE,1,30,3,0,3,21,12,0,0,33,21,6,0,0,27,30,0,2,2,3,3,1,1,0
"08046785",INS,Centre públic Dep. i CEB,Institut d'Alella,Alella,MVO,MVO,1,25,2,0,2,23,3,0,0,26,23,0,0,0,23,25,23,0,23,2,2,1,1,0
"08046797",INS,Centre públic Dep. i CEB,Institut Laia l'Arquera,Mataró,MVO,MVO,1,25,28,1,29,14,0,0,0,14,0,0,0,0,0,28,0,0,0,25,7,1,1,0
"08046803",INS,Centre públic Dep. i CEB,Institut Vilatzara,Vilassar de Mar,MVO,MVO,1,32,35,0,35,0,10,0,0,10,0,0,0,0,0,35,0,0,0,32,9,1,1,0
"08046840",INS,Centre públic Dep. i CEB,Institut Castellet,Sant Vicenç de Castellet,CCE,CCE,1,30,0,0,0,6,1,10,7,24,6,1,10,7,24,24,0,0,0,0,0,1,1,0
"08046852",INS,Centre públic Dep. i CEB,Institut Llavaneres,Sant Andreu de Llavaneres,MVO,MVO,1,24,1,0,1,19,0,0,0,19,19,0,0,0,19,20,19,0,19,1,1,1,1,0
"08046864",INS,Centre públic Dep. i CEB,Institut Bellulla,Bellulla (Canovelles),MVO,MVO,1,27,0,1,1,29,0,0,0,29,27,0,0,0,27,27,0,0,0,0,0,1,1,0
"08046876",INS,Centre públic Dep. i CEB,Institut Miquel Bosch i Jover,Artés,CCE,CCE,1,17,0,0,0,6,9,0,0,15,6,9,0,0,15,15,0,0,0,0,0,1,1,0
"08047364",INS,Centre públic Dep. i CEB,Institut Joan Mercader,Igualada,CCE,PEN,1,30,1,16,17,19,1,0,4,24,19,1,0,4,24,25,19,5,24,6,6,1,1,0
"08047376",INS,Centre públic Dep. i CEB,Institut Llobregat,Sallent,CCE,CCE,1,20,10,0,10,7,5,0,0,12,7,3,0,0,10,20,0,0,0,10,6,1,1,0
"08047421",INS,Centre públic Dep. i CEB,Institut Montserrat Roig,Barcelona,CEB,CEB,1,20,0,0,0,14,2,0,0,16,14,2,0,0,16,16,0,0,0,0,0,1,1,0
"08047431",INS,Centre públic Dep. i CEB,Institut XXV Olimpíada,Barcelona,CEB,CEB,1,24,0,0,0,16,4,0,0,20,16,4,0,0,20,20,0,0,0,0,0,1,1,0
"08047467",INS,Centre públic Dep. i CEB,Institut Alexandre Galí,Les Roquetes (Sant Pere de Ribes),BCO,PEN,1,21,0,0,0,23,0,0,0,23,21,0,0,0,21,21,21,0,21,0,0,1,1,0
"08047479",INS,Centre públic Dep. i CEB,Institut Alba del Vallès,Sant Fost de Campsentelles,MVO,MVO,1,37,1,0,1,0,2,0,3,5,0,2,0,3,5,6,5,0,5,1,1,1,1,0
"08047480",INS,Centre públic Dep. i CEB,Institut Mediterrània,Castelldefels,BLL,BLL,1,31,0,0,0,29,0,1,0,30,29,0,1,0,30,30,4,0,4,0,0,1,1,0
"08047492",INS,Centre públic Dep. i CEB,Institut Ribera Baixa,El Prat de Llobregat,BLL,BLL,1,28,0,0,0,0,0,0,0,0,0,0,0,0,0,0,0,0,0,0,0,1,1,28
"08047509",INS,Centre públic Dep. i CEB,Institut Ítaca,Sant Boi de Llobregat,BLL,BLL,1,23,2,0,2,0,0,8,0,8,0,0,8,0,8,10,0,0,0,2,2,1,1,0
"08047583",INS,Centre públic Dep. i CEB,Institut Sant Quirze del Vallès,Sant Quirze del Vallès,VOC,VOC,1,42,0,32,32,2,0,4,1,7,2,0,4,1,7,7,6,1,7,32,11,1,1,0
"08047820",INS,Centre públic Dep. i CEB,Institut Guinovarda,Piera,CCE,PEN,1,30,0,0,0,19,1,5,0,25,19,1,5,0,25,25,0,0,0,0,0,1,1,0
"08047832",INS,Centre públic Dep. i CEB,Institut Joan Coromines,Pineda de Mar,MVO,MVO,1,27,2,0,2,22,0,0,0,22,22,0,0,0,22,24,4,0,4,2,2,1,1,0
"08051240",ESC,Centre públic Dep. i CEB,Escola Mediterrània,Cornellà de Llobregat,BLL,BLL,1,18,0,0,0,25,0,1,2,28,18,0,0,0,18,18,7,2,9,0,0,1,1,0
"08051264",INS,Centre públic Dep. i CEB,Institut Eduard Fontserè,L'Hospitalet de Llobregat,BCO,BCO,1,19,1,0,1,0,0,14,0,14,0,0,14,0,14,15,0,0,0,1,1,1,1,0
"08051306",ESC,Centre públic Dep. i CEB,Escola Abat Marcet,Terrassa,VOC,VOC,1,18,1,0,1,19,0,0,0,19,17,0,0,0,17,18,17,0,17,1,1,1,1,0
"08051318",ESC,Centre públic Dep. i CEB,Escola Sant Llorenç del Munt,Terrassa,VOC,VOC,1,18,1,0,1,19,0,0,0,19,17,0,0,0,17,18,12,0,12,1,1,1,1,0
"08051471",ESC,Centre públic Dep. i CEB,Escola Josep Maria Folch i Torres,L'Hospitalet de Llobregat,BCO,BCO,1,16,3,0,3,14,0,0,2,16,13,0,0,0,13,16,6,2,8,3,3,1,1,0
"08052165",ESC,Centre públic Dep. i CEB,Escola Octavio Paz,Barcelona,CEB,CEB,1,9,0,4,4,2,2,1,0,5,2,2,1,0,5,5,3,2,5,4,3,1,1,0
"08052207",INS,Centre públic Dep. i CEB,Institut de Puig-reig,Puig-reig,CCE,CCE,1,13,0,0,0,13,0,0,0,13,13,0,0,0,13,13,0,0,0,0,0,1,1,0
"08052581",INS,Centre públic Dep. i CEB,Institut Miquel Tarradell,Barcelona,CEB,CEB,1,16,0,0,0,16,0,0,0,16,16,0,0,0,16,16,0,0,0,0,0,1,1,0
"08052591",EE,EE Privats,Guimbarda,Barcelona,CEB,CEB,0,1,0,0,0,0,0,0,0,0,2,0,0,0,2,2,0,0,0,0,0,0,1,0
"08052608",INS,Centre públic Dep. i CEB,Institut Pau Claris,Barcelona,CEB,CEB,1,14,0,14,14,14,0,0,0,14,14,0,0,0,14,14,0,0,0,0,0,1,1,0
"08052621",ESC,Centre públic Dep. i CEB,Escola Pau Romeva,Barcelona,CEB,CEB,1,18,2,0,2,0,18,0,0,18,0,16,0,0,16,18,0,16,16,2,2,1,1,0
"08052657",ESC,Centre públic Dep. i CEB,Escola Fort Pienc,Barcelona,CEB,CEB,1,18,2,0,2,13,3,0,0,16,13,3,0,0,16,18,0,0,0,2,2,1,1,0
"08052669",ESC,Centre públic Dep. i CEB,Escola Ferran Sunyer,Barcelona,CEB,CEB,1,20,4,2,6,3,0,0,0,3,3,0,0,0,3,7,0,0,0,6,6,1,1,0
"08052670",ESC,Centre públic Dep. i CEB,Escola Auró,Barcelona,CEB,CEB,1,19,2,0,2,15,0,0,2,17,15,0,0,2,17,19,4,2,6,2,2,1,1,0
"08052700",INS,Centre públic Dep. i CEB,Institut Vall d'Hebron,Barcelona,CEB,CEB,1,45,0,0,0,41,0,0,0,41,41,0,0,0,41,41,0,0,0,0,0,1,1,0
"08052724",INS,Centre públic Dep. i CEB,Institut Francisco de Goya,Barcelona,CEB,CEB,1,16,0,0,0,16,0,0,0,16,16,0,0,0,16,16,0,0,0,0,0,1,1,0
"08052761",INS,Centre públic Dep. i CEB,Institut Josep Comas i Solà,Barcelona,CEB,CEB,1,3,0,0,0,0,0,0,0,0,0,0,0,0,0,0,0,0,0,0,0,1,1,3
"08052785",ESC,Centre públic Dep. i CEB,Escola Vila Olímpica,Barcelona,CEB,CEB,1,20,0,9,9,2,0,0,1,3,2,0,0,1,3,3,0,1,1,9,6,1,1,0
"08052797",INS,Centre públic Dep. i CEB,Institut Salvador Espriu,Barcelona,CEB,CEB,1,29,1,0,1,20,1,0,0,21,20,1,0,0,21,22,0,1,1,1,1,1,1,0
"08052827",INS,Centre públic Dep. i CEB,Institut Lluís Domènech i Montaner,Barcelona,CEB,CEB,1,20,0,0,0,14,2,0,0,16,14,2,0,0,16,16,14,2,16,0,0,1,1,0
"08052839",INS,Centre públic Dep. i CEB,Institut Consell de Cent,Barcelona,CEB,CEB,1,19,3,0,3,10,0,0,0,10,10,0,0,0,10,13,0,0,0,3,3,1,1,0
"08052876",INS,Centre públic Dep. i CEB,Institut d'Argentona,Argentona,MVO,MVO,1,32,0,0,0,27,0,0,0,27,27,0,0,0,27,27,0,0,0,0,0,1,1,0
"08052888",INS,Centre públic Dep. i CEB,Institut Júlia Minguell,Badalona,BCO,BCO,1,22,24,1,25,9,0,0,0,9,0,0,0,0,0,24,0,0,0,22,6,1,1,0
"08052891",INS,Centre públic Dep. i CEB,Institut L'Alt Berguedà,Bagà,CCE,CCE,1,18,0,0,0,23,0,0,0,23,18,0,0,0,18,18,0,0,0,0,0,1,1,0
"08052906",INS,Centre públic Dep. i CEB,Institut Lauro,Bellavista (Les Franqueses del Vallès),MVO,MVO,1,37,1,0,1,9,2,0,0,11,9,2,0,0,11,12,9,2,11,1,1,1,1,0
"08052918",INS,Centre públic Dep. i CEB,Institut Bisbe Berenguer,L'Hospitalet de Llobregat,BCO,BCO,1,21,0,0,0,16,1,0,0,17,16,1,0,0,17,17,16,1,17,0,0,1,1,0
"08052921",INS,Centre públic Dep. i CEB,Institut Eugeni d'Ors,L'Hospitalet de Llobregat,BCO,BCO,1,17,0,0,0,14,0,0,0,14,14,0,0,0,14,14,0,0,0,0,0,1,1,0
"08052931",EOI,Centre públic Dep. i CEB,EOI del Maresme,Mataró,MVO,MVO,1,36,0,0,0,4,11,0,1,16,4,11,0,1,16,16,0,0,0,0,0,1,1,0
"08052955",INS,Centre públic Dep. i CEB,Institut de Lliçà,Lliçà d'Amunt,MVO,MVO,1,34,0,0,0,23,0,4,0,27,23,0,4,0,27,27,27,0,27,0,0,1,1,0
"08052979",INS,Centre públic Dep. i CEB,Institut Josep Puig i Cadafalch,Mataró,MVO,MVO,1,22,0,0,0,25,2,0,0,27,22,0,0,0,22,22,22,0,22,0,0,1,1,0
"08052980",INS,Centre públic Dep. i CEB,Institut Montmeló,Montmeló,MVO,MVO,1,27,0,0,0,20,2,0,0,22,20,2,0,0,22,22,20,2,22,0,0,1,1,0
"08052992",INS,Centre públic Dep. i CEB,Institut Euclides,Pineda de Mar,MVO,MVO,1,24,0,0,0,19,0,0,0,19,19,0,0,0,19,19,19,0,19,0,0,1,1,0
"08053005",INS,Centre públic Dep. i CEB,Institut Castell de Quer,Prats de Lluçanès,CCE,CCE,1,16,2,0,2,0,11,0,0,11,0,11,0,0,11,13,0,11,11,2,2,1,1,0
"08053017",INS,Centre públic Dep. i CEB,Institut Valerià Pujol i Bosch,Premià de Dalt,MVO,MVO,1,18,1,13,14,12,0,0,0,12,12,0,0,0,12,13,12,0,12,6,5,1,1,0
"08053029",EOI,Centre públic Dep. i CEB,EOI Badalona,Badalona,BCO,BCO,1,32,0,0,0,16,1,3,0,20,16,1,3,0,20,20,2,0,2,0,0,1,1,0
"08053030",INS,Centre públic Dep. i CEB,Institut de la Roca del Vallès,La Roca del Vallès,MVO,MVO,1,21,0,1,1,0,19,0,0,19,0,19,0,0,19,19,0,0,0,1,1,1,1,0
"08053042",INS,Centre públic Dep. i CEB,Institut Miquel Martí i Pol,Roda de Ter,CCE,CCE,1,22,2,0,2,20,3,0,1,24,20,0,0,0,20,22,0,4,4,2,2,1,1,0
"08053054",INS,Centre públic Dep. i CEB,Institut Gerbert d'Aurillac,Sant Fruitós de Bages,CCE,CCE,1,22,1,0,1,2,0,0,0,2,2,0,0,0,2,3,2,0,2,1,1,1,1,0
"08053078",INS,Centre públic Dep. i CEB,Institut Numància,Santa Coloma de Gramenet,BCO,BCO,1,25,1,0,1,20,0,0,0,20,20,0,0,0,20,21,5,0,5,1,1,1,1,0
"08053091",INS,Centre públic Dep. i CEB,Institut El Foix,Els Monjos (Santa Margarida i els Monjos),BCO,PEN,1,27,2,0,2,21,0,0,0,21,21,0,0,0,21,23,21,0,21,2,2,1,1,0
"08053108",INS,Centre públic Dep. i CEB,Institut Reguissol,Santa Maria de Palautordera,MVO,MVO,1,23,0,0,0,8,0,3,0,11,8,0,3,0,11,11,0,0,0,0,0,1,1,0
"08053111",INS,Centre públic Dep. i CEB,Institut d'Auro,Santpedor,CCE,CCE,1,23,1,0,1,19,0,0,0,19,19,0,0,0,19,20,19,0,19,1,1,1,1,0
"08053121",INS,Centre públic Dep. i CEB,Institut Taradell,Taradell,CCE,CCE,1,20,0,1,1,1,0,0,0,1,1,0,0,0,1,1,1,0,1,1,1,1,1,0
"08053145",INS,Centre públic Dep. i CEB,Institut Castellbisbal,Castellbisbal,VOC,VOC,1,32,0,0,0,12,14,0,0,26,12,14,0,0,26,26,12,0,12,0,0,1,1,0
"08053157",INS,Centre públic Dep. i CEB,Institut Gorgs,Cerdanyola del Vallès,VOC,VOC,1,22,0,0,0,16,1,0,0,17,16,1,0,0,17,17,16,1,17,0,0,1,1,0
"08053169",INS,Centre públic Dep. i CEB,Institut Matadepera,Matadepera,VOC,VOC,1,27,0,0,0,1,2,15,16,34,1,2,15,9,27,27,16,11,27,0,0,1,1,0
"08053170",INS,Centre públic Dep. i CEB,Institut Polinyà,Polinyà,VOC,VOC,1,27,6,0,6,0,22,0,0,22,0,21,0,0,21,27,0,21,21,6,6,1,1,0
"08053182",INS,Centre públic Dep. i CEB,Institut La Serreta,Rubí,VOC,VOC,1,41,1,0,1,32,2,0,0,34,32,2,0,0,34,35,0,0,0,1,1,1,1,0
"08053194",EOI,Centre públic Dep. i CEB,EOI de Terrassa,Terrassa,VOC,VOC,1,74,0,0,0,0,20,0,0,20,0,20,0,0,20,20,0,20,20,0,0,1,1,0
"08053200",INS,Centre públic Dep. i CEB,Institut Miquel Crusafont i Pairó,Sabadell,VOC,VOC,1,22,1,2,3,15,0,0,0,15,15,0,0,0,15,16,0,0,0,3,3,1,1,0
"08053212",INS,Centre públic Dep. i CEB,Institut Jonqueres,Sabadell,VOC,VOC,1,21,1,2,3,15,0,3,0,18,15,0,3,0,18,19,0,0,0,3,3,1,1,0
"08053224",INS,Centre públic Dep. i CEB,Institut Les Termes,Sabadell,VOC,VOC,1,25,0,0,0,20,0,0,0,20,20,0,0,0,20,20,20,0,20,0,0,1,1,0
"08053236",INS,Centre públic Dep. i CEB,Institut Rovira-Forns,Santa Perpètua de Mogoda,VOC,VOC,1,25,1,0,1,11,2,2,0,15,11,2,2,0,15,16,0,2,2,1,1,1,1,0
"08053248",INS,Centre públic Dep. i CEB,Institut de Sentmenat,Sentmenat,VOC,VOC,1,22,2,0,2,0,16,0,0,16,0,16,0,0,16,18,0,2,2,2,2,1,1,0
"08053251",INS,Centre públic Dep. i CEB,Institut Cavall Bernat,Terrassa,VOC,VOC,1,22,0,0,0,21,5,4,0,30,21,1,0,0,22,22,0,5,5,0,0,1,1,0
"08053261",INS,Centre públic Dep. i CEB,Institut de Viladecavalls,Viladecavalls,VOC,VOC,1,26,1,0,1,0,1,6,5,12,0,1,6,5,12,13,6,6,12,1,1,1,1,0
"08053285",INS,Centre públic Dep. i CEB,Institut El Castell,Esparreguera,BLL,BLL,1,27,3,0,3,22,0,2,1,25,22,0,2,0,24,27,24,0,24,3,3,1,1,0
"08053297",INS,Centre públic Dep. i CEB,Institut de Pallejà,Pallejà,BLL,BLL,1,23,0,2,2,3,1,3,0,7,3,1,3,0,7,7,0,0,0,2,2,1,1,0
"08053315",INS,Centre públic Dep. i CEB,Institut Montserrat Roig,Sant Andreu de la Barca,BLL,BLL,1,31,1,0,1,32,4,0,0,36,30,0,0,0,30,31,0,0,0,1,1,1,1,0
"08053340",INS,Centre públic Dep. i CEB,Institut Gabriela Mistral,Sant Vicenç dels Horts,BLL,BLL,1,29,3,5,8,30,2,0,0,32,26,0,0,0,26,29,0,2,2,3,3,1,1,0
"08053352",INS,Centre públic Dep. i CEB,Institut Montbui,Santa Margarida de Montbui,CCE,PEN,1,26,7,1,8,22,2,0,0,24,19,0,0,0,19,26,0,2,2,7,7,1,1,0
"08053364",INS,Centre públic Dep. i CEB,Institut Josep Mestres i Busquets,Viladecans,BLL,BLL,1,24,1,34,35,6,0,0,0,6,6,0,0,0,6,7,0,0,0,18,7,1,1,0
"08053391",ESC,Centre públic Dep. i CEB,Escola Lledoner,Granollers,MVO,MVO,1,18,5,0,5,13,0,0,0,13,13,0,0,0,13,18,13,0,13,5,5,1,1,0
"08053406",ESC,Centre públic Dep. i CEB,Escola Can Besora,Mollet del Vallès,MVO,MVO,1,18,20,0,20,5,0,0,0,5,0,0,0,0,0,20,0,0,0,18,5,1,1,0
"08053421",ESC,Centre públic Dep. i CEB,Escola Aloc,Pineda de Mar,MVO,MVO,1,16,1,0,1,0,15,0,0,15,0,15,0,0,15,16,0,7,7,1,1,1,1,0
"08053431",ESC,Centre públic Dep. i CEB,Escola El Roure,Pontons,BCO,PEN,1,9,0,1,1,0,0,0,0,0,0,0,0,0,0,0,0,0,0,1,1,1,1,9
"08053443",EOI,Centre públic Dep. i CEB,EOI Santa Coloma,Santa Coloma de Gramenet,BCO,BCO,1,39,0,0,0,17,0,0,0,17,17,0,0,0,17,17,0,0,0,0,0,1,1,0
"08053455",ESC,Centre públic Dep. i CEB,Escola Les Aigües,Cardedeu,MVO,MVO,1,19,0,0,0,23,3,0,0,26,19,0,0,0,19,19,19,0,19,0,0,1,1,0
"08053467",ESC,Centre públic Dep. i CEB,Escola Palau,Palau-solità i Plegamans,VOC,VOC,1,19,1,0,1,16,2,0,0,18,16,2,0,0,18,19,16,2,18,1,1,1,1,0
"08053492",ESC,Centre públic Dep. i CEB,Escola Teresa Claramunt,Sabadell,VOC,VOC,1,18,1,0,1,17,0,0,0,17,17,0,0,0,17,18,17,0,17,1,1,1,1,0
"08053510",ESC,Centre públic Dep. i CEB,Escola Puig d'Agulles,Corbera de Llobregat,BLL,BLL,1,11,1,1,2,10,4,0,0,14,10,0,0,0,10,11,10,0,10,1,1,1,1,0
"08053522",ESC,Centre públic Dep. i CEB,Escola La Ginesta,Vallirana,BLL,BLL,1,9,1,0,1,12,2,0,0,14,8,0,0,0,8,9,5,2,7,1,1,1,1,0
"08053571",IE,Centre públic Dep. i CEB,Inst-Esc Art. Oriol Martorell,Barcelona,CEB,CEB,1,12,0,1,1,47,9,0,0,56,12,0,0,0,12,12,5,0,5,0,0,1,1,0
"08053583",ESC,Centre públic Dep. i CEB,Escola Maria Ossó,Sitges,BCO,PEN,1,23,1,2,3,0,19,0,0,19,0,19,0,0,19,20,0,10,10,3,3,1,1,0
"08053601",ESC,Centre públic Dep. i CEB,Escola Lola Anglada,Martorell,BLL,BLL,1,19,0,0,0,18,1,0,0,19,18,1,0,0,19,19,18,1,19,0,0,1,1,0
"08053625",EE,EE Privats,Delta - Espiga,Vilafranca del Penedès,BCO,PEN,0,1,0,0,0,0,0,0,0,0,2,0,0,0,2,2,0,0,0,0,0,0,1,0
"08053649",EE,EE Privats,L'Escorça,L'Hospitalet de Llobregat,BCO,BCO,0,1,0,0,0,0,0,0,0,0,1,0,0,0,1,1,0,0,0,0,0,0,1,0
"08053650",ESC,Centre públic Dep. i CEB,Escola Turó de Guiera,Cerdanyola del Vallès,VOC,VOC,1,18,0,0,0,18,0,0,0,18,18,0,0,0,18,18,18,0,18,0,0,1,1,0
"08053662",EE,EE Privats,El Brot,Sant Joan Despí,BLL,BLL,0,1,0,0,0,0,0,0,0,0,2,0,0,0,2,2,0,0,0,0,0,0,1,0
"08054022",ESC,Centre públic Dep. i CEB,Escola Marinada,Barcelona,CEB,CEB,1,9,1,3,4,5,0,0,0,5,5,0,0,0,5,6,5,0,5,4,3,1,1,0
"08054034",INS,Centre públic Dep. i CEB,Institut Gallecs,Mollet del Vallès,MVO,MVO,1,36,0,10,10,34,0,0,0,34,34,0,0,0,34,34,0,0,0,2,2,1,1,0
"08054058",ESC,Centre públic Dep. i CEB,Escola Torre de la Miranda,Cornellà de Llobregat,BLL,BLL,1,18,1,0,1,13,0,4,2,19,13,0,4,0,17,18,17,0,17,1,1,1,1,0
"08054061",ESC,Centre públic Dep. i CEB,Escola Montbaig,Sant Boi de Llobregat,BLL,BLL,1,9,1,0,1,6,1,2,0,9,6,1,1,0,8,9,2,0,2,1,1,1,1,0
"08054113",ESC,Centre públic Dep. i CEB,Escola Anxaneta,Mataró,MVO,MVO,1,18,0,2,2,0,21,0,0,21,0,18,0,0,18,18,0,0,0,0,0,1,1,0
"08054174",INS,Centre públic Dep. i CEB,Institut La Ribera,Montcada i Reixac,VOC,VOC,1,18,0,0,0,24,4,0,1,29,18,0,0,0,18,18,0,1,1,0,0,1,1,0
"08054186",INS,Centre públic Dep. i CEB,Institut Can Mas,Ripollet,VOC,VOC,1,19,7,0,7,19,0,0,0,19,12,0,0,0,12,19,0,0,0,7,5,1,1,0
"08054198",INS,Centre públic Dep. i CEB,Institut Estany de la Ricarda,El Prat de Llobregat,BLL,BLL,1,20,1,0,1,16,1,0,0,17,16,1,0,0,17,18,0,0,0,1,1,1,1,0
"08054228",INS,Centre públic Dep. i CEB,Institut Dolors Aleu,Barcelona,CEB,CEB,1,19,0,26,26,3,8,0,0,11,3,8,0,0,11,11,3,8,11,8,5,1,1,0
"08054241",INS,Centre públic Dep. i CEB,Institut Eugeni Xammar,L'Ametlla del Vallès,MVO,MVO,1,18,0,0,0,16,0,0,0,16,16,0,0,0,16,16,0,0,0,0,0,1,1,0
"08054277",INS,Centre públic Dep. i CEB,Institut de Tona,Tona,CCE,CCE,1,29,1,0,1,23,0,0,0,23,23,0,0,0,23,24,0,0,0,1,1,1,1,0
"08054344",EOI,Centre públic Dep. i CEB,EOI Esplugues,Esplugues de Llobregat,BLL,BLL,1,43,0,1,1,11,0,0,0,11,11,0,0,0,11,11,0,0,0,1,1,1,1,0
"08054368",EE,Centre públic Dep. i CEB,CEE Ca n'Oriol,Rubí,VOC,VOC,1,9,3,0,3,14,0,0,0,14,6,0,0,0,6,9,6,0,6,3,3,1,1,0
"08054401",INS,Centre públic Dep. i CEB,Institut El Sui,Cardedeu,MVO,MVO,1,26,1,0,1,3,20,0,0,23,3,20,0,0,23,24,0,0,0,1,1,1,1,0
"08054411",ESC,Centre públic Dep. i CEB,Escola Vallgorguina,Vallgorguina,MVO,MVO,1,9,1,5,6,3,2,0,0,5,3,2,0,0,5,6,3,2,5,4,3,1,1,0
"08054824",ESC,Centre públic Dep. i CEB,Escola Mestre Pla,Castellar del Vallès,VOC,VOC,1,9,1,0,1,9,1,0,0,10,8,0,0,0,8,9,8,0,8,1,1,1,1,0
"08054848",INS,Centre públic Dep. i CEB,Institut Bosc de Montjuïc,Barcelona,CEB,CEB,1,7,0,0,0,0,0,1,3,4,0,0,1,3,4,4,0,0,0,0,0,1,1,0
"08054873",INS,Centre públic Dep. i CEB,Institut Joaquima Pla i Farreras,Sant Cugat del Vallès,VOC,VOC,1,23,0,1,1,20,1,1,0,22,20,1,1,0,22,22,0,0,0,1,1,1,1,0
"08054903",ESC,Centre públic Dep. i CEB,Escola Mediterrània,Barcelona,CEB,CEB,1,9,1,0,1,7,0,0,2,9,7,0,0,1,8,9,5,0,5,1,1,1,1,0
"08055002",CFA,CFA Departament,CFA Barri Gòtic,Barcelona,CEB,CEB,1,2,2,0,2,4,1,0,0,5,0,0,0,0,0,2,0,0,0,2,0,1,1,0
"08055041",CFA,CFA Departament,CFA Canovelles,La Barriada Nova (Canovelles),MVO,MVO,1,5,0,0,0,0,0,1,0,1,1,0,0,0,1,1,0,0,0,0,0,1,1,0
"08055051",CFA,CFA Departament,CFA Castelldefels,Castelldefels,BLL,BLL,1,2,0,0,0,4,0,1,0,5,2,0,0,0,2,2,0,0,0,0,0,1,1,0
"08055063",CFA,CFA Departament,CFA Canyelles,Barcelona,CEB,CEB,1,2,0,0,0,6,0,0,0,6,2,0,0,0,2,2,0,0,0,0,0,1,1,0
"08055075",CFA,CFA Departament,CFA Torre Romeu,Sabadell,VOC,VOC,1,2,0,0,0,1,4,0,0,5,2,0,0,0,2,2,0,0,0,0,0,1,1,0
"08055087",CFA,CFA Municipals no CEB,CFA Baix Montseny,Sant Celoni,MVO,MVO,0,4,0,0,0,0,0,0,0,0,3,0,0,0,3,3,0,0,0,0,0,0,1,0
"08055099",CFA,CFA Municipals no CEB,CFA Tona,Tona,CCE,CCE,0,1,0,0,0,0,0,0,0,0,1,0,0,0,1,1,0,0,0,0,0,0,1,0
"08055105",ESC,Centre públic Dep. i CEB,Escola Arraona,Sabadell,VOC,VOC,1,15,1,0,1,13,0,0,0,13,13,0,0,0,13,14,0,0,0,1,1,1,1,0
"08055117",ESC,EPRI & ESO Municipals no CEB,Escola Sant Jordi,Pineda de Mar,MVO,MVO,0,9,0,0,0,0,0,0,0,0,9,0,0,0,9,9,0,0,0,0,0,0,1,0
"08055191",AH,Aules hospitalàries,A. Hospitalària Vall d'Hebron Barcelona Campus Hospitalari,Barcelona,CEB,CEB,0,1,0,0,0,0,0,0,0,0,0,0,0,0,0,0,0,0,0,0,0,1,0,1
"08055385",CFA,CFA Departament,CFA Mollet del Vallès,Mollet del Vallès,MVO,MVO,1,9,0,2,2,3,0,0,0,3,3,0,0,0,3,3,0,0,0,2,0,1,1,0
"08055397",CFA,CFA Departament,CFA Jaume Tuset,Ripollet,VOC,VOC,1,1,0,0,0,0,0,0,0,0,1,0,0,0,1,1,0,0,0,0,0,1,1,0
"08055403",CFA,CFA Departament,CFA Sant Roc,Badalona,BCO,BCO,1,3,3,3,6,1,1,0,0,2,0,0,0,0,0,3,0,0,0,3,0,1,1,0
"08055439",CFA,CFA Departament,CFA Mestre Esteve,Sant Feliu de Llobregat,BLL,BLL,1,5,0,1,1,7,2,0,0,9,3,0,0,0,3,3,0,0,0,0,0,1,1,0
"08055440",CFA,CFA Departament,CFA Garrosa,Sant Vicenç dels Horts,BLL,BLL,1,4,0,0,0,2,1,2,0,5,3,0,0,0,3,3,0,0,0,0,0,1,1,0
"08055464",CFA,CFA Municipals no CEB,CFA municipal de formació de persones adultes,Sant Joan de Vilatorrada,CCE,CCE,0,2,0,0,0,0,0,0,0,0,2,0,0,0,2,2,0,0,0,0,0,0,1,0
"08055683",CFA,CFA Departament,CFA Manuel Sacristán,Barcelona,CEB,CEB,1,2,0,0,0,7,0,1,0,8,2,0,0,0,2,2,0,0,0,0,0,1,1,0
"08055695",CFA,CFA Departament,CFA Rafael Farré,Molins de Rei,BLL,BLL,1,5,0,0,0,7,2,1,0,10,3,0,0,0,3,3,0,0,0,0,0,1,1,0
"08055713",CFA,CFA Departament,CFA Sant Cugat del Vallès,Sant Cugat del Vallès,VOC,VOC,1,6,0,0,0,4,0,0,1,5,3,0,0,0,3,3,0,0,0,0,0,1,1,0
"08055853",CFA,CFA Municipals no CEB,CFA Les Roquetes,Les Roquetes (Sant Pere de Ribes),BCO,PEN,0,3,0,0,0,0,0,0,0,0,3,0,0,0,3,3,0,0,0,0,0,0,1,0
"08055889",ESC,Centre públic Dep. i CEB,Escola Miquel Martí i Pol,Sabadell,VOC,VOC,1,19,1,0,1,19,0,0,0,19,18,0,0,0,18,19,18,0,18,1,1,1,1,0
"08055890",ESC,Centre públic Dep. i CEB,Escola Sobirans,Arenys de Munt,MVO,MVO,1,15,1,1,2,0,0,9,1,10,0,0,9,1,10,11,9,1,10,2,2,1,1,0
"08055932",ESC,Centre públic Dep. i CEB,Escola Torrent de Can Carabassa,Barcelona,CEB,CEB,1,18,1,14,15,3,0,8,0,11,3,0,8,0,11,12,6,0,6,7,5,1,1,0
"08055944",INS,Centre públic Dep. i CEB,Institut Rubió i Ors,L'Hospitalet de Llobregat,BCO,BCO,1,21,1,0,1,14,0,0,0,14,14,0,0,0,14,15,14,0,14,1,1,1,1,0
"08056006",CFA,CFA Municipals no CEB,CFA de Sitges,Sitges,BCO,PEN,0,2,0,0,0,0,0,0,0,0,2,0,0,0,2,2,0,0,0,0,0,0,1,0
"08056018",CFA,CFA Municipals no CEB,CFA Les Teixidores,Castellar del Vallès,VOC,VOC,0,2,0,0,0,0,0,0,0,0,2,0,0,0,2,2,0,0,0,0,0,0,1,0
"08056021",CFA,CFA Municipals sense estudis reglats,CFA de Montmeló,Montmeló,MVO,MVO,0,1,0,0,0,0,0,0,0,0,1,0,0,0,1,1,0,0,0,0,0,0,1,0
"08056109",INS,Centre públic Dep. i CEB,Institut Can Vilumara,L'Hospitalet de Llobregat,BCO,BCO,1,29,0,0,0,14,4,6,0,24,14,4,6,0,24,24,20,4,24,0,0,1,1,0
"08056560",CFA,CFA Departament,CFA Barberà,Barberà del Vallès,VOC,VOC,1,3,0,0,0,4,0,1,1,6,3,0,0,0,3,3,0,0,0,0,0,1,1,0
"08056572",CFA,CFA Departament,CFA Terra Baixa,El Prat de Llobregat,BLL,BLL,1,4,0,0,0,3,1,0,0,4,3,0,0,0,3,3,0,0,0,0,0,1,1,0
"08056584",CFA,CFA Departament,CFA L'Alzina de Cerdanyola,Cerdanyola del Vallès,VOC,VOC,1,3,0,0,0,0,0,0,0,0,3,0,0,0,3,3,0,0,0,0,0,1,1,0
"08056614",ESC,Centre públic Dep. i CEB,Escola Cirera,Mataró,MVO,MVO,1,12,1,0,1,5,11,0,0,16,5,6,0,0,11,12,5,6,11,1,1,1,1,0
"08056936",CFA,CFA Municipals no CEB,CFA de Vallirana,Vallirana,BLL,BLL,0,1,0,0,0,0,0,0,0,0,1,0,0,0,1,1,0,0,0,0,0,0,1,0
"08056985",INS,Centre públic Dep. i CEB,Institut Ramon Berenguer IV,Santa Coloma de Gramenet,BCO,BCO,1,25,0,0,0,5,1,0,0,6,5,1,0,0,6,6,0,0,0,0,0,1,1,0
"08056997",CFA,CFA Departament,CFA La Concòrdia,Sabadell,VOC,VOC,1,8,0,5,5,12,0,0,0,12,3,0,0,0,3,3,0,0,0,0,0,1,1,0
"08057001",CFA,CFA Departament,CFA La Creu de Barberà,Sabadell,VOC,VOC,1,2,0,0,0,0,0,0,3,3,2,0,0,0,2,2,0,0,0,0,0,1,1,0
"08057011",CFA,CFA Departament,CFA Can Rull,Sabadell,VOC,VOC,1,2,0,0,0,0,0,0,7,7,2,0,0,0,2,2,0,0,0,0,0,1,1,0
"08057047",CFA,CFA Municipals no CEB,CFA Natura,Pineda de Mar,MVO,MVO,0,4,0,0,0,0,0,0,0,0,3,0,0,0,3,3,0,0,0,0,0,0,1,0
"08057059",CFA,CFA Municipals no CEB,CFA Els Ametllers,Vilassar de Mar,MVO,MVO,0,3,0,0,0,0,0,0,0,0,3,0,0,0,3,3,0,0,0,0,0,0,1,0
"08057072",CFA,CFA Municipals no CEB,CFA Ferran Soldevila,Santa Maria de Palautordera,MVO,MVO,0,2,0,0,0,0,0,0,0,0,2,0,0,0,2,2,0,0,0,0,0,0,1,0
"08057096",ESC,Centre públic Dep. i CEB,Escola Guillem de Mont-rodon,Vic,CCE,CCE,1,17,0,0,0,19,0,0,0,19,17,0,0,0,17,17,17,0,17,0,0,1,1,0
"08057102",ESC,Centre públic Dep. i CEB,Escola Andersen,Vic,CCE,CCE,1,20,8,1,9,13,0,0,0,13,12,0,0,0,12,20,0,0,0,8,6,1,1,0
"08057163",CFA,CFA Departament,CFA Teresa Mañé,Vilanova i la Geltrú,BCO,PEN,1,3,0,0,0,1,0,6,0,7,3,0,0,0,3,3,0,0,0,0,0,1,1,0
"08057229",ESC,Centre públic Dep. i CEB,Escola Els Arenys,Castellbisbal,VOC,VOC,1,10,1,1,2,11,0,0,0,11,9,0,0,0,9,10,5,0,5,1,1,1,1,0
"08057230",INS,Centre públic Dep. i CEB,Institut Cubelles,Cubelles,BCO,PEN,1,24,0,7,7,0,19,0,0,19,0,19,0,0,19,19,0,0,0,5,5,1,1,0
"08057242",ESC,Centre públic Dep. i CEB,Escola Serena Vall,Sant Andreu de Llavaneres,MVO,MVO,1,18,0,0,0,18,0,0,0,18,18,0,0,0,18,18,10,0,10,0,0,1,1,0
"08057254",INS,Centre públic Dep. i CEB,Institut Pere Ribot,Vilassar de Mar,MVO,MVO,1,16,0,0,0,16,0,0,0,16,16,0,0,0,16,16,16,0,16,0,0,1,1,0
"08057266",ESC,Centre públic Dep. i CEB,Escola Els Cingles,L'Ametlla del Vallès,MVO,MVO,1,14,0,4,4,12,0,1,1,14,12,0,1,1,14,14,7,1,8,0,0,1,1,0
"08057540",INS,Centre públic Dep. i CEB,Institut Joan Brossa,Barcelona,CEB,CEB,1,29,0,0,0,4,4,0,0,8,4,4,0,0,8,8,0,1,1,0,0,1,1,0
"08057667",CFA,CFA Departament,CFA Trinitat Vella,Barcelona,CEB,CEB,1,5,2,0,2,4,0,0,1,5,3,0,0,0,3,5,0,0,0,2,0,1,1,0
"08057679",CFA,CFA Departament,CFA Bellvitge-Gornal,L'Hospitalet de Llobregat,BCO,BCO,1,4,0,0,0,9,1,0,0,10,3,0,0,0,3,3,0,0,0,0,0,1,1,0
"08057734",ESC,Centre públic Dep. i CEB,Escola Antoni Gaudí,Santa Margarida de Montbui,CCE,PEN,1,16,5,2,7,0,16,0,0,16,0,11,0,0,11,16,0,11,11,5,5,1,1,0
"08057874",CFA,CFA Departament,CFA Catalònia,L'Hospitalet de Llobregat,BCO,BCO,1,3,0,0,0,7,1,2,0,10,3,0,0,0,3,3,0,0,0,0,0,1,1,0
"08057965",CFA,CFA Departament,CFA Can Serra,L'Hospitalet de Llobregat,BCO,BCO,1,6,0,0,0,6,0,0,0,6,3,0,0,0,3,3,0,0,0,0,0,1,1,0
"08058106",AH,Aules hospitalàries,A. Hospitalària Hospital Clínic i Provincial de Barcelona,Barcelona,CEB,CEB,0,2,0,0,0,0,0,0,0,0,0,0,2,0,2,2,0,0,0,0,0,0,0,0
"08058118",AH,Aules hospitalàries,A. Hospitalària Hospital del Mar,Barcelona,CEB,CEB,0,1,0,0,0,0,0,0,0,0,0,0,0,0,0,0,0,0,0,0,0,1,0,1
"08058209",CFA,CFA Departament,CFA Sant Boi,Sant Boi de Llobregat,BLL,BLL,1,4,0,0,0,7,0,0,0,7,3,0,0,0,3,3,0,0,0,0,0,1,1,0
"08058210",CFA,CFA Departament,CFA Badia del Vallès,Badia del Vallès,VOC,VOC,1,1,0,0,0,2,1,0,0,3,1,0,0,0,1,1,0,0,0,0,0,1,1,0
"08058337",CFA,Casos especials,CFA La Llar,Terrassa,VOC,VOC,0,0,0,0,0,0,0,0,0,0,0,0,0,0,0,0,0,0,0,0,0,0,0,0
"08058362",ESC,Centre públic Dep. i CEB,Escola Riera de Ribes,Sant Pere de Ribes,BCO,PEN,1,51,0,0,0,0,0,9,9,18,0,0,9,9,18,18,9,9,18,0,0,1,1,0
"08058374",ESC,Centre públic Dep. i CEB,Escola Els Alocs,Vilassar de Mar,MVO,MVO,1,10,1,1,2,0,1,3,0,4,0,1,3,0,4,5,0,1,1,2,2,1,1,0
"08058404",INS,Centre públic Dep. i CEB,Institut Cirviànum de Torelló,Torelló,CCE,CCE,1,22,1,29,30,13,4,0,0,17,13,4,0,0,17,18,0,2,2,5,5,1,1,0
"08058416",ESC,Centre públic Dep. i CEB,Escola L'Arenal de Llevant,Barcelona,CEB,CEB,1,19,0,8,8,19,3,0,0,22,19,0,0,0,19,19,6,3,9,0,0,1,1,0
"08058428",INS,Centre públic Dep. i CEB,Institut Bisaura,Sant Quirze de Besora,CCE,CCE,1,7,1,0,1,8,0,0,0,8,6,0,0,0,6,7,0,0,0,1,1,1,1,0
"08058441",ESC,Centre públic Dep. i CEB,Escola Giroi,La Garriga,MVO,MVO,1,22,8,0,8,0,0,6,0,6,0,0,6,0,6,14,0,0,0,8,6,1,1,0
"08058465",ESC,Centre públic Dep. i CEB,Escola Enxaneta,Terrassa,VOC,VOC,1,27,0,0,0,27,0,0,0,27,27,0,0,0,27,27,27,0,27,0,0,1,1,0
"08058489",CFA,CFA Departament,CFA Can Batlló,Barcelona,CEB,CEB,1,1,0,0,0,3,0,4,0,7,1,0,0,0,1,1,0,0,0,0,0,1,1,0
"08058519",ESC,Centre públic Dep. i CEB,Escola Sinera,Arenys de Mar,MVO,MVO,1,18,0,15,15,0,1,7,0,8,0,1,7,0,8,8,2,0,2,10,5,1,1,0
"08058520",INS,Centre públic Dep. i CEB,Institut Puig de la Creu,Castellar del Vallès,VOC,VOC,1,24,1,0,1,16,0,0,0,16,16,0,0,0,16,17,0,0,0,1,1,1,1,0
"08058775",INS,Centre públic Dep. i CEB,Institut Front Marítim,Barcelona,CEB,CEB,1,23,0,0,0,14,1,0,0,15,14,1,0,0,15,15,0,1,1,0,0,1,1,0
"08058957",ESC,Centre públic Dep. i CEB,Escola Els Costerets,Sant Pere de Ribes,BCO,PEN,1,19,0,1,1,12,6,0,0,18,12,6,0,0,18,18,12,6,18,1,1,1,1,0
"08058969",INS,Centre públic Dep. i CEB,Institut El Vern,Lliçà de Vall,MVO,MVO,1,14,2,0,2,0,12,0,0,12,0,12,0,0,12,14,0,0,0,2,2,1,1,0
"08059044",CFA,CFA Departament,CFA La Llagosta,La Llagosta,MVO,MVO,1,4,0,2,2,2,3,0,1,6,3,0,0,0,3,3,0,0,0,0,0,1,1,0
"08059093",ESC,Centre públic Dep. i CEB,Escola d'Hortsavinyà,Tordera,MVO,MVO,1,9,1,0,1,0,1,0,1,2,0,1,0,1,2,3,0,0,0,1,1,1,1,0
"08059226",EE,EE Privats,Vida Montserrat,Barcelona,CEB,CEB,0,1,0,0,0,0,0,0,0,0,3,0,0,0,3,3,0,0,0,0,0,0,1,0
"08059329",INS,Centre públic Dep. i CEB,Institut Can Peixauet,Santa Coloma de Gramenet,BCO,BCO,1,26,0,6,6,9,0,0,0,9,9,0,0,0,9,9,9,0,9,6,6,1,1,0
"08059342",INS,Centre públic Dep. i CEB,IESA Institut del Teatre,Barcelona,CEB,CEB,0,6,0,0,0,0,0,0,0,0,0,0,0,0,0,0,0,0,0,0,0,1,1,6
"08059354",ESC,Centre públic Dep. i CEB,Escola Les Roques Blaves,Esparreguera,BLL,BLL,1,11,0,0,0,17,0,0,0,17,11,0,0,0,11,11,7,0,7,0,0,1,1,0
"08059524",INS,Centre públic Dep. i CEB,Institut de Navarcles,Navarcles,CCE,CCE,1,10,1,0,1,8,0,0,0,8,8,0,0,0,8,9,0,0,0,1,1,1,1,0
"08059551",EOI,Centre públic Dep. i CEB,EOI de Manresa,Manresa,CCE,CCE,1,33,0,0,0,13,1,0,0,14,13,1,0,0,14,14,0,1,1,0,0,1,1,0
"08059639",ESC,Centre públic Dep. i CEB,Escola Progrés,Badalona,BCO,BCO,1,19,3,0,3,16,0,0,0,16,16,0,0,0,16,19,0,2,2,3,3,1,1,0
"08059688",INS,Centre públic Dep. i CEB,Institut Maria Aurèlia Capmany,Cornellà de Llobregat,BLL,BLL,1,23,2,0,2,20,0,0,0,20,20,0,0,0,20,22,0,0,0,2,2,1,1,0
"08059691",CFA,CFA Departament,CFA Anna Murià,Terrassa,VOC,VOC,1,5,0,0,0,0,0,0,1,1,1,0,0,0,1,1,0,0,0,0,0,1,1,0
"08059706",CFA,CFA Departament,CFA Salvador Espriu,Terrassa,VOC,VOC,1,4,0,0,0,0,0,0,0,0,3,0,0,0,3,3,0,0,0,0,0,1,1,0
"08059721",ESC,Centre públic Dep. i CEB,Escola Marta Mata,Viladecans,BLL,BLL,1,19,0,0,0,20,0,0,0,20,19,0,0,0,19,19,19,0,19,0,0,1,1,0
"08059731",CFA,CFA Departament,CFA Arquitecte Jujol,Sant Joan Despí,BLL,BLL,1,1,0,0,0,5,1,4,0,10,1,0,0,0,1,1,0,0,0,0,0,1,1,0
"08059755",ESC,Centre públic Dep. i CEB,Escola La Font,Manresa,CCE,CCE,1,28,0,0,0,0,0,24,0,24,0,0,24,0,24,24,0,0,0,0,0,1,1,0
"08059767",ESC,Centre públic Dep. i CEB,Escola Tanit,Santa Coloma de Gramenet,BCO,BCO,1,9,1,0,1,0,9,0,0,9,0,8,0,0,8,9,0,8,8,1,1,1,1,0
"08059780",ESC,Centre públic Dep. i CEB,Escola Bellavista-Joan Camps i Giró,Bellavista (Les Franqueses del Vallès),MVO,MVO,1,37,2,5,7,10,0,0,2,12,10,0,0,2,12,14,10,2,12,7,7,1,1,0
"08059792",ESC,Centre públic Dep. i CEB,Escola Mogent,Montornès del Vallès,MVO,MVO,1,19,5,0,5,19,0,0,0,19,14,0,0,0,14,19,8,0,8,5,5,1,1,0
"08059809",ESC,Centre públic Dep. i CEB,Escola El Roure,Sant Fost de Campsentelles,MVO,MVO,1,9,1,12,13,0,0,2,0,2,0,0,2,0,2,3,2,0,2,7,3,1,1,0
"08059810",ESC,Centre públic Dep. i CEB,Escola Vinya del Sastret,Sant Esteve Sesrovires,BLL,BLL,1,10,0,0,0,10,0,0,0,10,10,0,0,0,10,10,6,0,6,0,0,1,1,0
"08059822",ESC,Centre públic Dep. i CEB,Escola Ernest Lluch,Abrera,BLL,BLL,1,18,0,0,0,18,0,0,0,18,18,0,0,0,18,18,8,0,8,0,0,1,1,0
"08059871",ESC,Centre públic Dep. i CEB,Escola Gerbert d'Orlhac,Sant Cugat del Vallès,VOC,VOC,1,19,1,0,1,0,18,0,0,18,0,18,0,0,18,19,0,18,18,1,1,1,1,0
"08059998",ESC,Centre públic Dep. i CEB,Escola La Pau,Sant Sadurní d'Anoia,BCO,PEN,1,18,0,0,0,19,1,0,0,20,18,0,0,0,18,18,6,0,6,0,0,1,1,0
"08060009",INS,Centre públic Dep. i CEB,Institut Manuel Carrasco i Formiguera,Sant Feliu de Codines,MVO,MVO,1,10,0,0,0,0,8,0,0,8,0,8,0,0,8,8,0,8,8,0,0,1,1,0
"08060095",CFA,CFA Departament,CFA Montseny,Vic,CCE,CCE,1,7,0,0,0,0,1,0,0,1,1,0,0,0,1,1,0,0,0,0,0,1,1,0
"08060113",CFA,CFA Departament,CFA Jacint Carrió i Vilaseca,Manresa,CCE,CCE,1,8,0,0,0,8,0,0,0,8,3,0,0,0,3,3,0,0,0,0,0,1,1,0
"08060137",CFA,CFA Departament,CFA Edèlia Hernández,Viladecans,BLL,BLL,1,3,0,0,0,3,2,1,2,8,3,0,0,0,3,3,0,0,0,0,0,1,1,0
"08060204",CFA,CFA Departament,CFA Gran Sol,Badalona,BCO,BCO,1,4,2,2,4,0,6,0,0,6,2,0,0,0,2,4,0,0,0,2,0,1,1,0
"08060216",CFA,CFA Departament,CFA Morera Pomar,Badalona,BCO,BCO,1,3,0,0,0,9,0,0,0,9,3,0,0,0,3,3,0,0,0,0,0,1,1,0
"08060228",CFA,CFA Departament,CFA El Clot,Barcelona,CEB,CEB,1,2,0,7,7,1,2,0,0,3,2,0,0,0,2,2,0,0,0,0,0,1,1,0
"08060231",CFA,CFA Departament,CFA Pegaso,Barcelona,CEB,CEB,1,4,0,0,0,2,2,2,2,8,3,0,0,0,3,3,0,0,0,0,0,1,1,0
"08060253",CFA,CFA Departament,CFA Can Marfà,Mataró,MVO,MVO,1,6,0,0,0,4,1,0,0,5,3,0,0,0,3,3,0,0,0,0,0,1,1,0
"08060265",CFA,CFA Departament,CFA Premià de Mar,Premià de Mar,MVO,MVO,1,4,0,0,0,0,1,0,3,4,3,0,0,0,3,3,0,0,0,0,0,1,1,0
"08060277",CFA,CFA Departament,CFA Pau Casals,Rubí,VOC,VOC,1,4,0,0,0,9,0,1,0,10,3,0,0,0,3,3,0,0,0,0,0,1,1,0
"08060289",CFA,CFA Departament,CFA Fondo,Santa Coloma de Gramenet,BCO,BCO,1,5,0,3,3,6,0,0,0,6,3,0,0,0,3,3,0,0,0,3,0,1,1,0
"08060290",CFA,CFA Departament,CFA Singuerlín,Santa Coloma de Gramenet,BCO,BCO,1,4,0,1,1,5,1,0,0,6,3,0,0,0,3,3,0,0,0,0,0,1,1,0
"08060319",ESC,Centre públic Dep. i CEB,Escola Les Fonts,Argentona,MVO,MVO,1,14,0,0,0,13,2,0,0,15,13,1,0,0,14,14,13,1,14,0,0,1,1,0
"08060411",CFA,CFA Departament,CFA Sants-Sant Raimon de Penyafort,Barcelona,CEB,CEB,1,2,0,0,0,6,0,0,1,7,2,0,0,0,2,2,0,0,0,0,0,1,1,0
"08060423",ESC,Centre públic Dep. i CEB,Escola Mas Prats,Palafolls,MVO,MVO,1,17,0,0,0,0,18,0,0,18,0,17,0,0,17,17,0,17,17,0,0,1,1,0
"08060484",ESC,Centre públic Dep. i CEB,Escola Taula Rodona,Sant Quirze del Vallès,VOC,VOC,1,18,1,0,1,18,0,0,0,18,17,0,0,0,17,18,17,0,17,1,1,1,1,0
"08060514",INS,Centre públic Dep. i CEB,Institut de Masquefa,Masquefa,CCE,PEN,1,23,28,2,30,0,10,0,0,10,0,0,0,0,0,28,0,0,0,23,6,1,1,0
"08060526",ESC,Centre públic Dep. i CEB,Escola Creixà,Piera,CCE,PEN,1,9,1,0,1,0,7,0,0,7,0,7,0,0,7,8,0,0,0,1,1,1,1,0
"08060538",EOI,Centre públic Dep. i CEB,EOI del Prat de Llobregat,El Prat de Llobregat,BLL,BLL,1,32,0,0,0,0,7,0,0,7,0,7,0,0,7,7,0,0,0,0,0,1,1,0
"08060599",ESC,Centre públic Dep. i CEB,Escola Garigot,Castelldefels,BLL,BLL,1,17,1,0,1,16,0,0,0,16,16,0,0,0,16,17,4,0,4,1,1,1,1,0
"08060605",ESC,Centre públic Dep. i CEB,Escola Font del Roure,Masquefa,CCE,PEN,1,18,0,12,12,18,0,0,0,18,18,0,0,0,18,18,8,0,8,0,0,1,1,0
"08060629",ESC,Centre públic Dep. i CEB,Escola El Corb,Corbera de Llobregat,BLL,BLL,1,9,1,0,1,8,0,0,0,8,8,0,0,0,8,9,0,0,0,1,1,1,1,0
"08060757",ESC,Centre públic Dep. i CEB,Escola Joan Torredemer Canela,Matadepera,VOC,VOC,1,18,1,2,3,0,0,3,15,18,0,0,3,14,17,18,3,14,17,1,1,1,1,0
"08060836",ESC,Centre públic Dep. i CEB,Escola Turó del Drac,Canet de Mar,MVO,MVO,1,18,0,1,1,0,2,0,2,4,0,2,0,2,4,4,0,4,4,1,1,1,1,0
"08060848",ESC,Centre públic Dep. i CEB,Escola de Sant Andreu de la Barca,Sant Andreu de la Barca,BLL,BLL,1,18,2,0,2,16,2,0,0,18,16,0,0,0,16,18,16,0,16,2,2,1,1,0
"08060851",ESC,Centre públic Dep. i CEB,Escola L'Olivera,Vallirana,BLL,BLL,1,17,1,0,1,16,0,0,0,16,16,0,0,0,16,17,0,16,16,1,1,1,1,0
"08060873",ESC,Centre públic Dep. i CEB,Escola Eulàlia Bota,Barcelona,CEB,CEB,1,18,0,1,1,18,0,0,0,18,18,0,0,0,18,18,6,0,6,0,0,1,1,0
"08060903",ESC,Centre públic Dep. i CEB,Escola El Colomer,El Rieral de Bigues (Bigues i Riells),MVO,MVO,1,18,0,0,0,17,1,0,0,18,17,1,0,0,18,18,17,1,18,0,0,1,1,0
"08060915",INS,Centre públic Dep. i CEB,Institut Maria de Bell-lloc,El Rieral de Bigues (Bigues i Riells),MVO,MVO,1,21,0,0,0,14,2,0,2,18,14,2,0,2,18,18,2,2,4,0,0,1,1,0
"08060927",ESC,Centre públic Dep. i CEB,Escola Vora del Mar,Cubelles,BCO,PEN,1,18,0,0,0,14,4,0,0,18,14,4,0,0,18,18,14,4,18,0,0,1,1,0
"08060939",ESC,Centre públic Dep. i CEB,Escola Guerau de Liost,Corró d'Avall (Les Franqueses del Vallès),MVO,MVO,1,19,0,0,0,0,6,13,0,19,0,6,13,0,19,19,4,6,10,0,0,1,1,0
"08060940",ESC,Centre públic Dep. i CEB,Escola Rosa Oriol Anguera,Lliçà d'Amunt,MVO,MVO,1,18,4,2,6,12,0,0,0,12,12,0,0,0,12,16,12,0,12,6,5,1,1,0
"08060952",ESC,Centre públic Dep. i CEB,Escola Els Vinyals,Lliçà de Vall,MVO,MVO,1,9,1,0,1,9,0,0,0,9,8,0,0,0,8,9,5,0,5,1,1,1,1,0
"08060964",ESC,Centre públic Dep. i CEB,Escola Quatre Vents,Manlleu,CCE,CCE,1,19,0,2,2,21,0,0,0,21,19,0,0,0,19,19,19,0,19,0,0,1,1,0
"08060976",INS,Centre públic Dep. i CEB,Institut del Voltreganès,La Gleva (Les Masies de Voltregà),CCE,CCE,1,16,0,17,17,3,0,0,0,3,3,0,0,0,3,3,0,0,0,13,5,1,1,0
"08060988",ESC,Centre públic Dep. i CEB,Escola Cal Músic,Mollet del Vallès,MVO,MVO,1,15,1,0,1,11,4,0,0,15,11,3,0,0,14,15,11,3,14,1,1,1,1,0
"08060991",ESC,Centre públic Dep. i CEB,Escola Mogent,La Roca del Vallès,MVO,MVO,1,17,0,1,1,15,0,0,2,17,15,0,0,2,17,17,0,2,2,0,0,1,1,0
"08061002",ESC,Centre públic Dep. i CEB,Escola Les Parellades,Sant Pere de Ribes,BCO,PEN,1,10,0,1,1,0,8,0,0,8,0,8,0,0,8,8,3,0,3,1,1,1,1,0
"08061014",INS,Centre públic Dep. i CEB,Institut Vinyet,Sitges,BCO,PEN,1,21,0,13,13,14,1,3,0,18,14,1,3,0,18,18,0,0,0,3,3,1,1,0
"08061026",ESC,Centre públic Dep. i CEB,Escola La Falguera,Vilanova del Vallès,MVO,MVO,1,11,1,1,2,9,3,0,0,12,9,1,0,0,10,11,9,1,10,1,1,1,1,0
"08061038",INS,Centre públic Dep. i CEB,Institut de Vilanova del Vallès,Vilanova del Vallès,MVO,MVO,1,23,0,0,0,19,0,0,0,19,19,0,0,0,19,19,19,0,19,0,0,1,1,0
"08061041",ESC,Centre públic Dep. i CEB,Escola Sant Jordi,Vilanova i la Geltrú,BCO,PEN,1,18,0,5,5,14,1,0,0,15,14,1,0,0,15,15,14,1,15,3,3,1,1,0
"08061051",ESC,Centre públic Dep. i CEB,Escola Ítaca,Vilanova i la Geltrú,BCO,PEN,1,18,1,0,1,15,0,0,0,15,15,0,0,0,15,16,0,0,0,1,1,1,1,0
"08061063",ESC,Centre públic Dep. i CEB,Escola La Serreta,Alella,MVO,MVO,1,18,1,3,4,0,9,0,0,9,0,9,0,0,9,10,0,9,9,4,4,1,1,0
"08061087",ESC,Centre públic Dep. i CEB,Escola Marina,Montgat,MVO,MVO,1,19,1,3,4,14,1,0,0,15,14,1,0,0,15,16,7,1,8,4,4,1,1,0
"08061099",INS,Centre públic Dep. i CEB,Institut Font del Ferro,Palafolls,MVO,MVO,1,25,2,0,2,22,0,0,0,22,22,0,0,0,22,24,0,0,0,2,2,1,1,0
"08061105",ESC,Centre públic Dep. i CEB,Escola Sot del Camp,Sant Vicenç de Montalt,MVO,MVO,1,15,0,0,0,0,4,0,0,4,0,4,0,0,4,4,0,4,4,0,0,1,1,0
"08061117",INS,Centre públic Dep. i CEB,Institut Turó d'en Baldiri,Teià,MVO,MVO,1,11,0,0,0,3,2,0,0,5,3,2,0,0,5,5,0,0,0,0,0,1,1,0
"08061129",INS,Centre públic Dep. i CEB,Institut Montserrat Colomer,Sant Esteve Sesrovires,BLL,BLL,1,22,0,0,0,16,4,0,0,20,16,4,0,0,20,20,16,4,20,0,0,1,1,0
"08061142",ESC,Centre públic Dep. i CEB,Escola Miquel Martí i Pol,Barberà del Vallès,VOC,VOC,1,18,0,0,0,1,0,14,3,18,1,0,14,3,18,18,15,3,18,0,0,1,1,0
"08061154",ESC,Centre públic Dep. i CEB,Escola Ca n'Alzamora,Rubí,VOC,VOC,1,18,1,0,1,18,1,0,0,19,17,0,0,0,17,18,17,0,17,1,1,1,1,0
"08061166",ESC,Centre públic Dep. i CEB,Escola de Can Llong,Sabadell,VOC,VOC,1,18,7,7,14,10,0,0,0,10,10,0,0,0,10,17,6,0,6,8,5,1,1,0
"08061178",ESC,Centre públic Dep. i CEB,Escola Turó de Can Mates,Sant Cugat del Vallès,VOC,VOC,1,19,1,0,1,19,0,0,0,19,18,0,0,0,18,19,18,0,18,1,1,1,1,0
"08061191",ESC,Centre públic Dep. i CEB,Escola Font de l'Orpina,Vacarisses,VOC,VOC,1,11,1,1,2,6,4,0,0,10,6,4,0,0,10,11,6,4,10,1,1,1,1,0
"08061208",INS,Centre públic Dep. i CEB,Institut Vacarisses,Vacarisses,VOC,VOC,1,19,0,0,0,0,18,0,0,18,0,18,0,0,18,18,0,3,3,0,0,1,1,0
"08061221",CFA,CFA Departament,CFA Vallès,Granollers,MVO,MVO,1,6,0,0,0,9,0,0,1,10,3,0,0,0,3,3,0,0,0,0,0,1,1,0
"08061348",ESC,Centre públic Dep. i CEB,Escola Bufalà,Badalona,BCO,BCO,1,20,1,1,2,18,1,0,0,19,18,1,0,0,19,20,10,1,11,1,1,1,1,0
"08061521",ESC-ZER,Centre públic Dep. i CEB,Escola Vall de Néspola - ZER El Moianès Ponent,Mura,CCE,CCE,1,4,2,0,2,0,0,1,1,2,0,0,1,1,2,4,1,1,2,2,2,1,0,0
"08061543",ESC,Centre públic Dep. i CEB,Escola Roser Capdevila,Polinyà,VOC,VOC,1,18,0,0,0,18,0,0,0,18,18,0,0,0,18,18,18,0,18,0,0,1,1,0
"08061555",CFA,CFA Departament,CFA Can Folguera,Santa Perpètua de Mogoda,VOC,VOC,1,2,0,0,0,3,0,0,0,3,2,0,0,0,2,2,0,0,0,0,0,1,1,0
"08061580",CFA,CFA Departament,CFA Lloreda-la Pau,Badalona,BCO,BCO,1,1,0,0,0,6,0,1,0,7,1,0,0,0,1,1,0,0,0,0,0,1,1,0
"08061609",ESC,Centre públic Dep. i CEB,Escola Mercè Rodoreda,Martorell,BLL,BLL,1,19,1,0,1,19,0,0,0,19,18,0,0,0,18,19,18,0,18,1,1,1,1,0
"08061610",ESC,Centre públic Dep. i CEB,Escola La Sínia,Molins de Rei,BLL,BLL,1,18,1,0,1,16,0,0,2,18,16,0,0,1,17,18,16,1,17,1,1,1,1,0
"08061658",CFA,CFA Municipals no CEB,CFA Can Noè,Mataró,MVO,MVO,0,5,0,0,0,0,0,0,0,0,3,0,0,0,3,3,0,0,0,0,0,0,1,0
"08061683",CFA,CFA Departament,CFA Palau de Mar,Barcelona,CEB,CEB,1,2,0,2,2,2,1,0,0,3,2,0,0,0,2,2,0,0,0,0,0,1,1,0
"08061701",CFA,CFA Departament,CFA Maria Rubies,Barcelona,CEB,CEB,1,4,0,0,0,2,1,0,0,3,3,0,0,0,3,3,0,0,0,0,0,1,1,0
"08061725",EOI,Centre públic Dep. i CEB,EOI Barcelona III,Barcelona,CEB,CEB,1,32,0,0,0,8,2,0,0,10,8,2,0,0,10,10,0,0,0,0,0,1,1,0
"08061762",ESC,Centre públic Dep. i CEB,Escola Mas Maria,Cabrils,MVO,MVO,1,14,0,4,4,14,0,0,0,14,14,0,0,0,14,14,14,0,14,0,0,1,1,0
"08061774",ESC,Centre públic Dep. i CEB,Escola Les Arenes,Terrassa,VOC,VOC,1,18,1,0,1,12,6,0,0,18,12,5,0,0,17,18,12,5,17,1,1,1,1,0
"08061907",CFA,CFA Departament,CFA Barceloneta,Barcelona,CEB,CEB,1,2,3,3,6,0,0,1,0,1,0,0,0,0,0,3,0,0,0,2,0,1,1,0
"08061919",CFA,CFA Departament,CFA Rius i Taulet,Barcelona,CEB,CEB,1,2,0,0,0,6,0,0,0,6,2,0,0,0,2,2,0,0,0,0,0,1,1,0
"08061932",CFA,CFA Departament,CFA Bon Pastor,Barcelona,CEB,CEB,1,5,0,2,2,2,0,0,0,2,2,0,0,0,2,2,0,0,0,2,0,1,1,0
"08061944",CFA,CFA Departament,CFA Madrid,Barcelona,CEB,CEB,1,1,0,0,0,0,2,0,3,5,1,0,0,0,1,1,0,0,0,0,0,1,1,0
"08061956",CFA,CFA Departament,CFA Prosperitat,Barcelona,CEB,CEB,1,2,3,0,3,0,0,0,0,0,0,0,0,0,0,3,0,0,0,2,0,1,1,0
"08061968",CFA,CFA Departament,CFA Les Corts,Barcelona,CEB,CEB,1,1,0,0,0,5,0,1,0,6,1,0,0,0,1,1,0,0,0,0,0,1,1,0
"08061971",CFA,CFA Departament,CFA Berguedà,Berga,CCE,CCE,1,2,0,0,0,1,0,0,0,1,1,0,0,0,1,1,0,0,0,0,0,1,1,0
"08061993",CFA,CFA Departament,CFA Eugeni d'Ors,Esplugues de Llobregat,BLL,BLL,1,4,1,3,4,6,0,0,0,6,3,0,0,0,3,4,0,0,0,1,0,1,1,0
"08062018",CFA,CFA Departament,CFA Anoia,Igualada,CCE,PEN,1,2,0,0,0,0,2,0,0,2,2,0,0,0,2,2,0,0,0,0,0,1,1,0
"08062021",CFA,CFA Departament,CFA Montcada i Reixac,Montcada i Reixac,VOC,VOC,1,5,0,2,2,2,0,0,0,2,2,0,0,0,2,2,0,0,0,2,0,1,1,0
"08062031",CFA,CFA Departament,CFA Mare de Déu de Montserrat,Olesa de Montserrat,BLL,BLL,1,3,1,1,2,4,0,0,0,4,2,0,0,0,2,3,0,0,0,1,0,1,1,0
"08062043",CFA,CFA Departament,CFA Parets del Vallès,Parets del Vallès,MVO,MVO,1,1,0,0,0,0,0,0,0,0,1,0,0,0,1,1,0,0,0,0,0,1,1,0
"08062055",CFA,CFA Departament,CFA Sant Just Desvern,Sant Just Desvern,BLL,BLL,1,1,0,2,2,4,0,0,0,4,1,0,0,0,1,1,0,0,0,0,0,1,1,0
"08062079",CFA,CFA Departament,CFA Ramon Llull,Terrassa,VOC,VOC,1,1,0,0,0,0,6,0,0,6,1,0,0,0,1,1,0,0,0,0,0,1,1,0
"08062080",CFA,CFA Departament,CFA Egara,Terrassa,VOC,VOC,1,6,8,8,16,0,0,2,0,2,0,0,0,0,0,8,0,0,0,6,0,1,1,0
"08062092",CFA,CFA Departament,CFA Vilafranca del Penedès,Vilafranca del Penedès,BCO,PEN,1,4,0,0,0,9,2,0,0,11,3,0,0,0,3,3,0,0,0,0,0,1,1,0
"08062109",CFA,CFA Departament,AFA Ciutat Meridiana,Barcelona,CEB,CEB,1,4,1,0,1,0,1,0,0,1,1,0,0,0,1,2,0,0,0,1,0,1,1,0
"08062110",CFA,CFA Departament,CFA Sanfeliu,L'Hospitalet de Llobregat,BCO,BCO,1,4,0,0,0,7,0,0,1,8,3,0,0,0,3,3,0,0,0,0,0,1,1,0
"08062122",CFA,CFA Departament,CFA Martorell,Martorell,BLL,BLL,1,4,0,0,0,3,0,0,5,8,3,0,0,0,3,3,0,0,0,0,0,1,1,0
"08062146",CFA,CFA Departament,CFA La Verneda,Barcelona,CEB,CEB,1,3,0,0,0,2,0,0,0,2,2,0,0,0,2,2,0,0,0,0,0,1,1,0
"08062158",EOI,Centre públic Dep. i CEB,EOI de Martorell,Martorell,BLL,BLL,1,23,0,0,0,9,2,0,0,11,9,2,0,0,11,11,9,2,11,0,0,1,1,0
"08062161",EOI,Centre públic Dep. i CEB,EOI de Sant Cugat del Vallès,Sant Cugat del Vallès,VOC,VOC,1,17,0,0,0,0,7,0,0,7,0,7,0,0,7,7,0,0,0,0,0,1,1,0
"08062171",EOI,Centre públic Dep. i CEB,EOI d'Igualada,Igualada,CCE,PEN,1,21,0,0,0,1,0,0,0,1,1,0,0,0,1,1,1,0,1,0,0,1,1,0
"08062183",EOI,Centre públic Dep. i CEB,EOI Osona,Vic,CCE,CCE,1,82,0,0,0,3,1,1,0,5,3,1,1,0,5,5,4,1,5,0,0,1,1,0
"08062195",EOI,Centre públic Dep. i CEB,EOI Barcelona IV,Barcelona,CEB,CEB,1,36,0,0,0,14,0,0,1,15,14,0,0,1,15,15,0,0,0,0,0,1,1,0
"08062201",EOI,Centre públic Dep. i CEB,EOI Barcelona V,Barcelona,CEB,CEB,1,21,0,0,0,0,0,6,1,7,0,0,6,1,7,7,6,1,7,0,0,1,1,0
"08062213",EOI,Centre públic Dep. i CEB,EOI Vallès Oriental,Granollers,MVO,MVO,1,20,0,4,4,5,0,0,0,5,5,0,0,0,5,5,5,0,5,4,4,1,1,0
"08062225",EOI,Centre públic Dep. i CEB,EOI Garraf,Vilanova i la Geltrú,BCO,PEN,1,24,0,0,0,0,8,0,0,8,0,8,0,0,8,8,0,8,8,0,0,1,1,0
"08062249",CFA,CFA Departament,CFA El Carmel,Barcelona,CEB,CEB,1,4,1,1,2,2,0,0,1,3,3,0,0,0,3,4,0,0,0,2,0,1,1,0
"08062250",CFA,CFA Departament,CFA Guinardó,Barcelona,CEB,CEB,1,1,1,1,2,5,0,0,0,5,0,0,0,0,0,1,0,0,0,0,0,1,1,0
"08062262",CFA,CFA Departament,CFA Montserrat Roig,Barcelona,CEB,CEB,1,2,4,5,9,0,1,0,0,1,0,0,0,0,0,4,0,0,0,2,0,1,1,0
"08062331",CFA,CFA Departament,CFA Pere Calders,Barcelona,CEB,CEB,1,3,0,0,0,4,0,0,1,5,3,0,0,0,3,3,0,0,0,0,0,1,1,0
"08062389",AH,Aules hospitalàries,A. Hospitalària Hospital de Dia(FHS Pere Claver),Barcelona,CEB,CEB,0,1,0,0,0,0,0,0,0,0,0,0,1,0,1,1,0,0,0,0,0,1,0,0
"08062407",AH,Aules hospitalàries,A. Hospitalària Hospital de Dia Infanto-Juvenil,Mataró,MVO,MVO,0,1,0,0,0,0,0,0,0,0,0,0,1,0,1,1,0,0,0,0,0,0,0,0
"08062419",AH,Aules hospitalàries,A. Hospitalària Hospital de Dia,Terrassa,VOC,VOC,0,1,1,0,1,0,0,0,0,0,0,0,1,0,1,2,0,0,0,0,0,0,0,0
"08062420",AH,Aules hospitalàries,A. Hospitalària Hospital de Dia,Santa Coloma de Gramenet,BCO,BCO,0,1,0,0,0,0,0,0,0,0,0,0,1,0,1,1,0,0,0,0,0,0,0,0
"08062468",CFA,CFA Departament,CFA Bellavista,Bellavista (Les Franqueses del Vallès),MVO,MVO,1,2,0,1,1,0,3,0,0,3,2,0,0,0,2,2,0,0,0,0,0,1,1,0
"08062471",CFA,CFA Departament,CFA Gavà,Gavà,BLL,BLL,1,2,0,1,1,0,4,0,0,4,2,0,0,0,2,2,0,0,0,0,0,1,1,0
"08062481",CFA,CFA Departament,CFA Sant Josep,L'Hospitalet de Llobregat,BCO,BCO,1,3,0,0,0,0,4,0,0,4,3,0,0,0,3,3,0,0,0,0,0,1,1,0
"08062493",CFA,CFA Departament,CFA Sant Ramon,L'Hospitalet de Llobregat,BCO,BCO,1,4,0,0,0,1,1,0,0,2,2,0,0,0,2,2,0,0,0,0,0,1,1,0
"08062511",CFA,CFA Departament,CFA Alarona,Mataró,MVO,MVO,1,3,0,0,0,0,1,0,0,1,1,0,0,0,1,1,0,0,0,0,0,1,1,0
"08062523",CFA,CFA Departament,CFA Marinada,Montornès del Vallès,MVO,MVO,1,1,0,0,0,2,1,0,0,3,1,0,0,0,1,1,0,0,0,0,0,1,1,0
"08062614",ESC,Centre públic Dep. i CEB,Escola Joan Blanquer,Castellar del Vallès,VOC,VOC,1,9,2,1,3,0,9,0,0,9,0,7,0,0,7,9,0,7,7,2,2,1,1,0
"08062626",ESC,Centre públic Dep. i CEB,Escola Collserola,Cerdanyola del Vallès,VOC,VOC,1,9,0,0,0,0,8,0,1,9,0,8,0,1,9,9,0,9,9,0,0,1,1,0
"08062638",ESC,Centre públic Dep. i CEB,Escola La Trama,Sabadell,VOC,VOC,1,14,1,0,1,9,4,0,0,13,9,4,0,0,13,14,9,4,13,1,1,1,1,0
"08062641",ESC,Centre públic Dep. i CEB,Escola L'Olivera,Sant Cugat del Vallès,VOC,VOC,1,19,1,0,1,28,2,0,0,30,18,0,0,0,18,19,0,0,0,1,1,1,1,0
"08062675",ESC,Centre públic Dep. i CEB,Escola Pere IV,Barcelona,CEB,CEB,1,19,0,0,0,19,0,0,0,19,19,0,0,0,19,19,19,0,19,0,0,1,1,0
"08062687",ESC,Centre públic Dep. i CEB,Escola Ponent,Terrassa,VOC,VOC,1,18,13,2,15,0,10,1,0,11,0,5,0,0,5,18,1,4,5,13,5,1,1,0
"08062705",ESC,Centre públic Dep. i CEB,Escola La Cabana,Les Cabanyes,BCO,PEN,1,9,2,1,3,0,2,0,0,2,0,2,0,0,2,4,0,2,2,3,3,1,1,0
"08062717",INS,Centre públic Dep. i CEB,Institut Cabrils,Cabrils,MVO,MVO,1,13,0,0,0,1,5,0,0,6,1,5,0,0,6,6,1,5,6,0,0,1,1,0
"08062729",INS,Centre públic Dep. i CEB,Institut Pla Marcell,Cardedeu,MVO,MVO,1,17,0,0,0,0,20,0,0,20,0,17,0,0,17,17,0,17,17,0,0,1,1,0
"08062730",INS,Centre públic Dep. i CEB,Institut Els Roures,Dosrius,MVO,MVO,1,10,0,0,0,14,0,0,0,14,10,0,0,0,10,10,0,0,0,0,0,1,1,0
"08062742",ESC,Centre públic Dep. i CEB,Escola Benviure,Castellbisbal,VOC,VOC,1,9,0,0,0,0,9,0,0,9,0,9,0,0,9,9,0,9,9,0,0,1,1,0
"08062754",ESC,Centre públic Dep. i CEB,Escola Les Fonts,Gelida,BCO,PEN,1,17,0,0,0,18,2,0,0,20,17,0,0,0,17,17,17,0,17,0,0,1,1,0
"08062778",ESC,Centre públic Dep. i CEB,Escola Ametllers,Sant Joan de Vilatorrada,CCE,CCE,1,17,0,0,0,14,1,0,1,16,14,1,0,1,16,16,6,0,6,0,0,1,1,0
"08062781",ESC,Centre públic Dep. i CEB,Escola Mediterrània,Les Roquetes (Sant Pere de Ribes),BCO,PEN,1,16,0,2,2,14,2,0,0,16,14,2,0,0,16,16,14,2,16,0,0,1,1,0
"08062791",INS,Centre públic Dep. i CEB,Institut Vilamajor,Sant Pere de Vilamajor,MVO,MVO,1,26,2,0,2,0,9,0,9,18,0,9,0,9,18,20,0,18,18,2,2,1,1,0
"08062808",INS,Centre públic Dep. i CEB,Institut Esteve Albert,Sant Vicenç de Montalt,MVO,MVO,1,22,0,0,0,0,1,16,0,17,0,1,16,0,17,17,0,0,0,0,0,1,1,0
"08062811",ESC,Centre públic Dep. i CEB,Escola Matagalls,Santa Maria de Palautordera,MVO,MVO,1,9,2,0,2,0,9,0,0,9,0,7,0,0,7,9,7,0,7,2,2,1,1,0
"08062833",ESC,Centre públic Dep. i CEB,Escola Agnès de Sitges,Sitges,BCO,PEN,1,10,1,5,6,0,7,0,0,7,0,7,0,0,7,8,0,7,7,3,3,1,1,0
"08062857",INS,Centre públic Dep. i CEB,Institut Tiana,Tiana,MVO,MVO,1,19,3,7,10,20,0,0,0,20,16,0,0,0,16,19,16,0,16,3,3,1,1,0
"08062869",ESC,Centre públic Dep. i CEB,Escola Serra de Miralles,Tordera,MVO,MVO,1,10,0,0,0,9,1,0,0,10,9,1,0,0,10,10,9,1,10,0,0,1,1,0
"08062870",INS,Centre públic Dep. i CEB,Institut La Plana,Vic,CCE,CCE,1,26,4,1,5,0,14,0,0,14,0,14,0,0,14,18,0,14,14,5,5,1,1,0
"08062924",ESC,Centre públic Dep. i CEB,Escola Josep Guinovart,Castelldefels,BLL,BLL,1,9,0,2,2,9,0,0,0,9,9,0,0,0,9,9,5,0,5,0,0,1,1,0
"08062948",ESC,Centre públic Dep. i CEB,Escola Miquel Martí i Pol,Viladecans,BLL,BLL,1,22,0,3,3,0,20,0,0,20,0,20,0,0,20,20,0,20,20,2,2,1,1,0
"08062997",AH,Aules hospitalàries,A. Hospitalària Hospital de Dia,Sabadell,VOC,VOC,0,1,0,0,0,0,0,0,0,0,0,0,1,0,1,1,0,0,0,0,0,0,0,0
"08063001",AH,Aules hospitalàries,A. Hospitalària Hospital de Dia,Manresa,CCE,CCE,0,1,0,0,0,0,0,0,0,0,0,0,1,0,1,1,0,0,0,0,0,0,0,0
"08063011",AH,Aules hospitalàries,A. Hospitalària Hospital de Dia Clínic,Barcelona,CEB,CEB,0,3,0,0,0,0,0,0,0,0,0,0,3,0,3,3,0,0,0,0,0,1,0,0
"08063059",AH,Aules hospitalàries,A. Hospitalària Hospital de Dia de Vilanova i la Geltrú,Vilanova i la Geltrú,BCO,PEN,0,1,0,0,0,0,0,0,0,0,0,0,1,0,1,1,0,0,0,0,0,0,0,0
"08063072",ESC,Centre públic Dep. i CEB,Escola Fructuós Gelabert,Barcelona,CEB,CEB,1,19,0,0,0,0,19,0,0,19,0,19,0,0,19,19,0,19,19,0,0,1,1,0
"08063229",INS,Centre públic Dep. i CEB,Institut Montpedrós,Santa Coloma de Cervelló,BLL,BLL,1,27,1,0,1,36,1,0,0,37,26,0,0,0,26,27,0,1,1,1,1,1,1,0
"08063394",ESC,Centre públic Dep. i CEB,Escola Miquel Martí i Pol,Sant Feliu de Llobregat,BLL,BLL,1,18,0,0,0,0,2,16,0,18,0,2,16,0,18,18,16,2,18,0,0,1,1,0
"08063618",CFA,CFA Departament,CFA Esparreguera,Esparreguera,BLL,BLL,1,1,0,0,0,0,1,0,1,2,1,0,0,0,1,1,0,0,0,0,0,1,1,0
"08063621",CFA,CFA Departament,CFA Martí i Pol,Manlleu,CCE,CCE,1,4,0,1,1,3,0,0,0,3,3,0,0,0,3,3,0,0,0,1,0,1,1,0
"08063643",CFA,CFA Departament,CFA La Cooperativa,Torelló,CCE,CCE,1,1,0,1,1,2,0,0,0,2,1,0,0,0,1,1,0,0,0,0,0,1,1,0
"08063710",ESC,Centre públic Dep. i CEB,Escola Escola Nova,Cervelló,BLL,BLL,1,10,0,1,1,0,9,0,0,9,0,9,0,0,9,9,0,9,9,1,1,1,1,0
"08063734",ESC,Centre públic Dep. i CEB,Escola Puigventós,Olesa de Montserrat,BLL,BLL,1,17,0,0,0,6,12,0,0,18,6,11,0,0,17,17,6,11,17,0,0,1,1,0
"08063758",ESC,Centre públic Dep. i CEB,Escola Can Salvi,Sant Andreu de la Barca,BLL,BLL,1,18,1,2,3,20,1,0,0,21,17,0,0,0,17,18,17,0,17,1,1,1,1,0
"08063761",ESC,Centre públic Dep. i CEB,Escola Vicente Ferrer,Sant Boi de Llobregat,BLL,BLL,1,9,3,2,5,7,0,0,0,7,6,0,0,0,6,9,5,0,5,3,3,1,1,0
"08063771",ESC,Centre públic Dep. i CEB,Escola Pla de les Vinyes,Santa Coloma de Cervelló,BLL,BLL,1,14,2,2,4,10,0,0,2,12,10,0,0,2,12,14,4,2,6,2,2,1,1,0
"08063783",ESC,Centre públic Dep. i CEB,Escola Mediterrània,Viladecans,BLL,BLL,1,9,1,1,2,0,8,0,0,8,0,8,0,0,8,9,0,8,8,1,1,1,1,0
"08063795",ESC,Centre públic Dep. i CEB,Escola Marta Mata,Vilanova del Camí,CCE,PEN,1,9,0,0,0,9,0,0,0,9,9,0,0,0,9,9,9,0,9,0,0,1,1,0
"08063801",INS,Centre públic Dep. i CEB,Institut de Collbató,Collbató,BLL,BLL,1,13,1,15,16,2,0,2,0,4,2,0,2,0,4,5,0,0,0,9,4,1,1,0
"08063813",INS,Centre públic Dep. i CEB,Institut Creu de Saba,Olesa de Montserrat,BLL,BLL,1,20,0,0,0,16,0,0,0,16,16,0,0,0,16,16,16,0,16,0,0,1,1,0
"08063837",INS,Centre públic Dep. i CEB,Institut Les Margues,Calldetenes,CCE,CCE,1,15,0,0,0,11,1,0,0,12,11,1,0,0,12,12,0,0,0,0,0,1,1,0
"08063862",ESC,Centre públic Dep. i CEB,Escola L'Olivar,Castellnou de Bages,CCE,CCE,1,11,1,1,2,12,0,1,0,13,10,0,0,0,10,11,10,0,10,1,1,1,1,0
"08063874",ESC,Centre públic Dep. i CEB,Escola Antonio Machado,Mataró,MVO,MVO,1,18,0,0,0,0,18,0,0,18,0,18,0,0,18,18,0,18,18,0,0,1,1,0
"08063886",ESC,Centre públic Dep. i CEB,Escola Arrels,Els Monjos (Santa Margarida i els Monjos),BCO,PEN,1,9,1,0,1,8,3,1,0,12,8,0,0,0,8,9,8,0,8,1,1,1,1,0
"08063898",ESC,Centre públic Dep. i CEB,Escola La Sèquia,Manresa,CCE,CCE,1,19,1,0,1,15,1,2,1,19,15,1,2,0,18,19,6,1,7,1,1,1,1,0
"08063904",INS,Centre públic Dep. i CEB,Institut Montgròs,Sant Pere de Ribes,BCO,PEN,1,16,0,0,0,5,5,0,0,10,5,5,0,0,10,10,5,5,10,0,0,1,1,0
"08063916",ESC,Centre públic Dep. i CEB,Escola Vila Parietes,Parets del Vallès,MVO,MVO,1,9,0,0,0,0,9,0,0,9,0,9,0,0,9,9,0,9,9,0,0,1,1,0
"08063928",ESC,Centre públic Dep. i CEB,Escola Muntanyola,Muntanyola,CCE,CCE,1,9,1,0,1,0,0,0,3,3,0,0,0,3,3,4,0,0,0,1,1,1,1,0
"08063931",ESC,Centre públic Dep. i CEB,Escola Les Falgueres,Fogars de la Selva,MVO,MVO,1,9,1,0,1,9,1,0,0,10,8,0,0,0,8,9,8,0,8,1,1,1,1,0
"08063965",ESC,Centre públic Dep. i CEB,Escola Cau de la Guineu,Corbera de Llobregat,BLL,BLL,1,9,0,0,0,9,0,0,0,9,9,0,0,0,9,9,3,0,3,0,0,1,1,0
"08064003",INS,Centre públic Dep. i CEB,Institut Can Margarit,Corbera de Llobregat,BLL,BLL,1,17,0,3,3,14,0,0,0,14,14,0,0,0,14,14,0,0,0,3,3,1,1,0
"08064027",ESC,Centre públic Dep. i CEB,Escola El Sol i La Lluna,Castellar del Vallès,VOC,VOC,1,13,1,0,1,0,12,0,0,12,0,12,0,0,12,13,0,4,4,1,1,1,1,0
"08064076",ESC,Centre públic Dep. i CEB,Escola Rivo Rubeo,Rubí,VOC,VOC,1,18,1,0,1,15,3,0,0,18,15,2,0,0,17,18,9,3,12,1,1,1,1,0
"08064088",ESC,Centre públic Dep. i CEB,Escola Mas Boadella,Sabadell,VOC,VOC,1,18,1,0,1,20,0,0,0,20,17,0,0,0,17,18,17,0,17,1,1,1,1,0
"08064118",ESC,Centre públic Dep. i CEB,Escola Ciutat d'Alba,Sant Cugat del Vallès,VOC,VOC,1,19,0,0,0,13,6,0,0,19,13,6,0,0,19,19,13,6,19,0,0,1,1,0
"08064131",ESC,Centre públic Dep. i CEB,Escola Els Aigüerols,Santa Perpètua de Mogoda,VOC,VOC,0,9,0,0,0,0,0,0,0,0,0,0,0,0,0,0,0,0,0,0,0,1,1,9
"08064143",ESC,Centre públic Dep. i CEB,Escola La Nova Electra,Terrassa,VOC,VOC,1,22,1,0,1,19,2,0,0,21,19,2,0,0,21,22,19,2,21,1,1,1,1,0
"08064155",INS,Centre públic Dep. i CEB,Institut Quatre Cantons,Barcelona,CEB,CEB,1,29,0,0,0,17,0,0,0,17,17,0,0,0,17,17,17,0,17,0,0,1,1,0
"08064167",ESC,Centre públic Dep. i CEB,Escola Sant Martí,Barcelona,CEB,CEB,1,18,1,1,2,0,0,0,2,2,0,0,0,2,2,3,0,2,2,2,2,1,1,0
"08064179",ESC,Centre públic Dep. i CEB,Escola La Llacuna del Poblenou,Barcelona,CEB,CEB,1,18,0,0,0,18,0,0,0,18,18,0,0,0,18,18,18,0,18,0,0,1,1,0
"08064192",INS,Centre públic Dep. i CEB,Institut Angeleta Ferrer,Barcelona,CEB,CEB,1,2,5,0,5,8,0,0,0,8,0,0,0,0,0,5,0,0,0,2,1,1,1,0
"08064222",ESC,Centre públic Dep. i CEB,Escola La Roureda,Tordera,MVO,MVO,1,18,2,2,4,17,0,0,0,17,16,0,0,0,16,18,16,0,16,2,2,1,1,0
"08064623",CFA,CFA Departament,CFA Concepció Arenal,Barcelona,CEB,CEB,1,1,0,0,0,1,0,1,0,2,1,0,0,0,1,1,0,0,0,0,0,1,1,0
"08064635",CFA,CFA Departament,CFA Santiago Rusiñol,La Roca del Vallès,MVO,MVO,1,4,0,0,0,3,0,0,0,3,3,0,0,0,3,3,0,0,0,0,0,1,1,0
"08064647",CFA,CFA Departament,CFA Artur Martorell,Sant Esteve Sesrovires,BLL,BLL,1,5,0,0,0,0,3,0,0,3,3,0,0,0,3,3,0,0,0,0,0,1,1,0
"08064659",CFA,CFA Departament,CFA Salvador Dalí,La Roca del Vallès,MVO,MVO,1,7,1,1,2,4,0,0,0,4,3,0,0,0,3,4,0,0,0,2,0,1,1,0
"08064672",CFA,CFA Municipals no CEB,CFA Timó,Montgat,MVO,MVO,0,1,0,0,0,0,0,0,0,0,1,0,0,0,1,1,0,0,0,0,0,0,1,0
"08064738",ESC,Centre públic Dep. i CEB,Escola Dolors Piera,Vilafranca del Penedès,BCO,PEN,1,20,1,19,20,13,6,0,0,19,13,6,0,0,19,20,6,0,6,1,1,1,1,0
"08064741",ESC,Centre públic Dep. i CEB,Escola Ítaca,Manresa,CCE,CCE,1,21,0,0,0,4,2,1,0,7,4,2,1,0,7,7,2,2,4,0,0,1,1,0
"08064751",ESC,Centre públic Dep. i CEB,Escola Mar i Cel,Cubelles,BCO,PEN,1,10,1,0,1,0,2,0,12,14,0,2,0,7,9,10,0,9,9,1,1,1,1,0
"08064787",ESC,Centre públic Dep. i CEB,Escola Emili Teixidor,Roda de Ter,CCE,CCE,1,10,3,0,3,10,0,0,0,10,7,0,0,0,7,10,7,0,7,3,3,1,1,0
"08064805",ESC,Centre públic Dep. i CEB,Escola Els Quatre Vents,La Serra (Canovelles),MVO,MVO,1,18,2,0,2,0,0,18,0,18,0,0,16,0,16,18,16,0,16,2,2,1,1,0
"08064817",ESC,Centre públic Dep. i CEB,Escola Camins,Corró d'Avall (Les Franqueses del Vallès),MVO,MVO,1,18,0,5,5,11,0,5,2,18,11,0,5,2,18,18,0,2,2,0,0,1,1,0
"08064829",ESC,Centre públic Dep. i CEB,Escola Valldeneu,Sant Martí de Centelles,CCE,CCE,1,9,0,0,0,1,0,1,0,2,1,0,1,0,2,2,2,0,2,0,0,1,1,0
"08064830",INS,Centre públic Dep. i CEB,Institut Serra de Noet,Berga,CCE,CCE,1,12,3,1,4,6,0,0,0,6,6,0,0,0,6,9,0,0,0,4,4,1,1,0
"08064854",ESC,Centre públic Dep. i CEB,Escola Martinet,Cornellà de Llobregat,BLL,BLL,1,18,0,2,2,21,0,0,2,23,18,0,0,0,18,18,10,2,12,0,0,1,1,0
"08064866",ESC,Centre públic Dep. i CEB,Escola Dolors Martí i Badia,Igualada,CCE,PEN,1,17,1,4,5,17,0,0,0,17,16,0,0,0,16,17,16,0,16,1,1,1,1,0
"08064881",ESC,Centre públic Dep. i CEB,Escola Campderrós,Vallirana,BLL,BLL,1,13,0,0,0,5,8,0,0,13,5,8,0,0,13,13,5,8,13,0,0,1,1,0
"08064908",INS,Centre públic Dep. i CEB,Institut Begues,Begues,BLL,BLL,1,10,1,0,1,0,10,0,0,10,0,9,0,0,9,10,0,0,0,1,1,1,1,0
"08064911",INS,Centre públic Dep. i CEB,Institut Valèria Haliné,Castelldefels,BLL,BLL,1,14,2,0,2,11,0,0,0,11,11,0,0,0,11,13,0,1,1,2,2,1,1,0
"08064921",INS,Centre públic Dep. i CEB,Institut de Sant Andreu,Sant Andreu de la Barca,BLL,BLL,1,15,0,0,0,13,0,0,0,13,13,0,0,0,13,13,0,0,0,0,0,1,1,0
"08064945",ESC,Centre públic Dep. i CEB,Escola Mansuet,Collbató,BLL,BLL,1,10,0,0,0,10,1,0,0,11,10,0,0,0,10,10,10,0,10,0,0,1,1,0
"08064970",INS,Centre públic Dep. i CEB,Institut Nou de Vilafranca del Penedès,Vilafranca del Penedès,BCO,PEN,1,22,2,0,2,10,6,0,0,16,10,6,0,0,16,18,0,0,0,2,2,1,1,0
"08064982",ESC-ZER,Centre públic Dep. i CEB,Escola de Sant Quirze Safaja - ZER El Moianès Llevant,Sant Quirze Safaja,CCE,CCE,1,3,1,0,1,0,4,0,0,4,0,2,0,0,2,3,0,2,2,1,1,1,0,0
"08064994",ESC,Centre públic Dep. i CEB,Escola Maria-Mercè Marçal,Mataró,MVO,MVO,1,19,0,0,0,18,0,0,0,18,18,0,0,0,18,18,18,0,18,0,0,1,1,0
"08065007",ESC,Centre públic Dep. i CEB,Escola Poblenou,Pineda de Mar,MVO,MVO,1,9,1,8,9,3,1,0,0,4,3,1,0,0,4,5,0,0,0,5,3,1,1,0
"08065019",INS,Centre públic Dep. i CEB,Institut de Vallbona d'Anoia,Vallbona d'Anoia,CCE,PEN,1,8,0,0,0,0,8,0,0,8,0,8,0,0,8,8,0,8,8,0,0,1,1,0
"08065196",CFA,CFA Departament,CFA La Pau,Barcelona,CEB,CEB,1,1,0,2,2,2,4,0,0,6,1,0,0,0,1,1,0,0,0,0,0,1,1,0
"08065202",CFA,CFA Departament,CFA Francesc Layret,Barcelona,CEB,CEB,1,3,0,1,1,2,2,0,0,4,3,0,0,0,3,3,0,0,0,0,0,1,1,0
"08065238",ESC,Centre públic Dep. i CEB,Escola La Sagrera,El Rieral (Santa Eulàlia de Ronçana),MVO,MVO,1,19,1,5,6,12,0,0,0,12,12,0,0,0,12,13,12,0,12,6,5,1,1,0
"08065251",ESC,Centre públic Dep. i CEB,Escola Pla del Puig,Sant Fruitós de Bages,CCE,CCE,1,9,1,0,1,9,0,0,0,9,8,0,0,0,8,9,5,0,5,1,1,1,1,0
"08065263",ESC,Centre públic Dep. i CEB,Escola Puigsoler,Sant Vicenç de Castellet,CCE,CCE,1,13,2,2,4,10,0,0,1,11,10,0,0,1,11,13,3,0,3,2,2,1,1,0
"08065275",ESC,Centre públic Dep. i CEB,Escola Volerany,Vilanova i la Geltrú,BCO,PEN,1,18,0,1,1,12,4,1,1,18,12,4,1,1,18,18,5,5,10,0,0,1,1,0
"08065287",ESC,Centre públic Dep. i CEB,Escola Marta Mata,Mataró,MVO,MVO,1,18,0,0,0,0,19,0,0,19,0,18,0,0,18,18,0,18,18,0,0,1,1,0
"08065299",ESC,Centre públic Dep. i CEB,Escola El Calderí,Caldes de Montbui,MVO,MVO,1,9,1,4,5,0,9,0,0,9,0,8,0,0,8,9,0,3,3,1,1,1,1,0
"08065305",ESC,Centre públic Dep. i CEB,Escola Soler de Vilardell,Sant Celoni,MVO,MVO,1,10,2,0,2,0,0,0,5,5,0,0,0,5,5,7,0,5,5,2,2,1,1,0
"08065329",INS,Centre públic Dep. i CEB,Institut de l'Alt Foix,Sant Martí Sarroca,BCO,PEN,1,19,0,5,5,1,1,12,0,14,1,1,12,0,14,14,0,1,1,5,5,1,1,0
"08065330",INS,Centre públic Dep. i CEB,Institut Cal Gravat,Manresa,CCE,CCE,1,25,12,2,14,15,1,2,0,18,13,0,0,0,13,25,13,0,13,12,7,1,1,0
"08065342",INS,Centre públic Dep. i CEB,Institut Xaloc,Les Roquetes (Sant Pere de Ribes),BCO,PEN,1,10,0,0,0,0,8,0,0,8,0,8,0,0,8,8,0,8,8,0,0,1,1,0
"08065354",INS,Centre públic Dep. i CEB,Institut Baix a mar,Vilanova i la Geltrú,BCO,PEN,1,10,0,0,0,19,1,0,0,20,10,0,0,0,10,10,0,1,1,0,0,1,1,0
"08065366",INS,Centre públic Dep. i CEB,Institut de Pineda de Mar,Pineda de Mar,MVO,MVO,1,23,22,3,25,4,1,4,0,9,1,0,0,0,1,23,1,0,1,22,6,1,1,0
"08065391",INS,Centre públic Dep. i CEB,Institut El Til·ler,Corró d'Avall (Les Franqueses del Vallès),MVO,MVO,1,24,3,2,5,20,8,0,0,28,20,1,0,0,21,24,0,0,0,3,3,1,1,0
"08065408",INS,TANCA el curs 2023-24,Institut Hipàtia d'Alexandria,Lliçà d'Amunt,MVO,MVO,1,0,0,0,0,6,0,0,0,6,0,0,0,0,0,0,0,0,0,0,0,1,0,0
"08065411",INS,Centre públic Dep. i CEB,Institut Aiguaviva,Mollet del Vallès,MVO,MVO,1,18,0,0,0,9,7,0,0,16,9,7,0,0,16,16,9,7,16,0,0,1,1,0
"08065421",INS,Centre públic Dep. i CEB,Institut Marta Mata,Montornès del Vallès,MVO,MVO,1,19,0,0,0,14,3,0,0,17,14,3,0,0,17,17,0,0,0,0,0,1,1,0
"08065433",INS,Centre públic Dep. i CEB,Institut La Sínia,Parets del Vallès,MVO,MVO,1,12,0,0,0,0,15,0,0,15,0,12,0,0,12,12,0,2,2,0,0,1,1,0
"08065469",INS,Centre públic Dep. i CEB,Institut Can Record,Sant Esteve de Palautordera,MVO,MVO,1,12,0,0,0,12,5,0,0,17,12,0,0,0,12,12,12,0,12,0,0,1,1,0
"08065482",ESC-ZER,Centre públic Dep. i CEB,Escola Els Ventets - ZER El Moianès Llevant,Collsuspina,CCE,CCE,1,3,1,0,1,0,0,2,0,2,0,0,2,0,2,3,2,0,2,1,1,1,0,0
"08065512",ESC,Centre públic Dep. i CEB,Escola Serra de l'Obac,Terrassa,VOC,VOC,1,19,1,0,1,13,6,0,0,19,13,5,0,0,18,19,13,5,18,1,1,1,1,0
"08065561",CJJ,Justícia juvenil,C.Educ.Justícia Oriol Badia,Guardiola de Font-Rubí (Font-rubí),BCO,PEN,0,1,0,0,0,0,0,0,0,0,0,0,1,0,1,1,0,0,0,0,0,0,1,0
"08065573",CJJ,Justícia juvenil,C.Educ.Justícia L'Alzina,Palau-solità i Plegamans,VOC,VOC,0,4,2,0,2,0,0,0,0,0,0,0,4,0,4,6,0,0,0,0,0,0,1,0
"08065585",CJJ,Justícia juvenil,C.Educ.Justícia Els Til·lers,Mollet del Vallès,MVO,MVO,0,3,0,0,0,0,0,0,0,0,0,0,3,0,3,3,0,0,0,0,0,0,1,0
"08065652",EOI,Centre públic Dep. i CEB,EOI de l'Alt Penedès,Vilafranca del Penedès,BCO,PEN,1,20,0,0,0,2,1,0,0,3,2,1,0,0,3,3,0,1,1,0,0,1,1,0
"08065664",EOI,Centre públic Dep. i CEB,EOI del Berguedà,Berga,CCE,CCE,1,13,0,0,0,1,0,0,0,1,1,0,0,0,1,1,1,0,1,0,0,1,1,0
"08065925",CFA,CFA Municipals no CEB,CFA Municipal L'Olivera,Sant Quirze del Vallès,VOC,VOC,0,1,0,0,0,0,0,0,0,0,1,0,0,0,1,1,0,0,0,0,0,0,1,0
"08066048",ESC,Centre públic Dep. i CEB,Escola Roser Capdevila,Terrassa,VOC,VOC,1,18,1,0,1,18,18,0,0,36,17,0,0,0,17,18,0,0,0,1,1,1,1,0
"08066322",INS,Centre públic Dep. i CEB,Institut Cardener,Sant Joan de Vilatorrada,CCE,CCE,1,8,0,0,0,8,0,0,0,8,8,0,0,0,8,8,0,0,0,0,0,1,1,0
"08066334",ESC,Centre públic Dep. i CEB,Escola La Serreta,Santpedor,CCE,CCE,1,9,0,0,0,8,1,0,0,9,8,1,0,0,9,9,8,1,9,0,0,1,1,0
"08066413",ESC,Centre públic Dep. i CEB,Escola Colors,Bellavista (Les Franqueses del Vallès),MVO,MVO,1,9,1,0,1,0,7,0,2,9,0,7,0,1,8,9,0,5,5,1,1,1,1,0
"08066437",INS,Centre públic Dep. i CEB,Institut Mont Perdut,Terrassa,VOC,VOC,1,28,1,0,1,0,30,0,0,30,0,27,0,0,27,28,0,27,27,1,1,1,1,0
"08066462",ESC,Centre públic Dep. i CEB,Escola dels Encants,Barcelona,CEB,CEB,1,9,0,0,0,14,0,0,0,14,9,0,0,0,9,9,0,0,0,0,0,1,1,0
"08066504",ESC,Centre públic Dep. i CEB,Escola l'Univers,Barcelona,CEB,CEB,1,18,2,0,2,2,0,0,1,3,2,0,0,1,3,5,2,1,3,2,2,1,1,0
"08066516",ESC,Centre públic Dep. i CEB,Escola Congrés-Indians,Barcelona,CEB,CEB,1,19,0,0,0,3,3,0,0,6,3,3,0,0,6,6,3,3,6,0,0,1,1,0
"08066528",INS,Centre públic Dep. i CEB,Institut Martí Pous,Barcelona,CEB,CEB,1,17,5,0,5,15,0,1,0,16,12,0,0,0,12,17,0,0,0,5,5,1,1,0
"08066531",ESC,Centre públic Dep. i CEB,Escola Fluvià,Barcelona,CEB,CEB,1,19,1,0,1,17,2,0,0,19,17,1,0,0,18,19,17,1,18,1,1,1,1,0
"08066541",INS,Centre públic Dep. i CEB,Institut Maria Espinalt,Barcelona,CEB,CEB,1,22,1,0,1,0,2,0,0,2,0,2,0,0,2,3,0,2,2,1,1,1,1,0
"08066565",INS,Centre públic Dep. i CEB,Institut Joncar,Barcelona,CEB,CEB,1,16,16,2,18,5,3,0,0,8,0,0,0,0,0,16,0,0,0,16,5,1,1,0
"08066681",FP,Casos especials,EFTE Catalana de Montjuïc,Barcelona,CEB,CEB,0,0,0,0,0,0,0,0,0,0,0,0,0,0,0,0,0,0,0,0,0,1,0,0
"08066851",EOI,Centre públic Dep. i CEB,EOI de Mollet del Vallès,Mollet del Vallès,MVO,MVO,1,22,0,0,0,8,0,0,0,8,8,0,0,0,8,8,0,0,0,0,0,1,1,0
"08066887",EOI,Centre públic Dep. i CEB,EOI de Viladecans,Viladecans,BLL,BLL,1,23,0,0,0,10,2,0,0,12,10,2,0,0,12,12,0,2,2,0,0,1,1,0
"08066905",INS,Centre públic Dep. i CEB,Institut Viladomat,Barcelona,CEB,CEB,1,22,21,4,25,5,0,0,0,5,1,0,0,0,1,22,0,0,0,21,6,1,1,0
"08067016",ESC,Centre públic Dep. i CEB,Escola Ernest Lluch,L'Hospitalet de Llobregat,BCO,BCO,1,12,1,0,1,8,0,0,1,9,8,0,0,1,9,10,6,0,6,1,1,1,1,0
"08067041",ESC,Centre públic Dep. i CEB,Escola Xoriguer,Centelles,CCE,CCE,1,9,1,1,2,3,6,0,0,9,3,5,0,0,8,9,0,0,0,1,1,1,1,0
"08067090",ESC,Centre públic Dep. i CEB,Escola Can Manent,Cardedeu,MVO,MVO,1,32,0,0,0,0,0,2,1,3,0,0,2,1,3,3,2,1,3,0,0,1,1,0
"08067120",ESC,Centre públic Dep. i CEB,Escola Santa Agnès de Malanyanes,Santa Agnès de Malanyanes (La Roca del Vallès),MVO,MVO,1,9,0,1,1,3,0,0,0,3,3,0,0,0,3,3,0,3,3,1,1,1,1,0
"08067132",ESC,Centre públic Dep. i CEB,Escola Josefina Ibáñez,Abrera,BLL,BLL,1,9,2,0,2,0,0,0,9,9,0,0,0,7,7,9,0,7,7,2,2,1,1,0
"08067144",INS,Centre públic Dep. i CEB,Institut de Cervelló,Cervelló,BLL,BLL,1,15,1,4,5,0,7,0,7,14,0,7,0,7,14,15,0,0,0,1,1,1,1,0
"08067181",ESC,Centre públic Dep. i CEB,Escola de Rellinars,Rellinars,VOC,VOC,1,14,1,0,1,6,0,0,0,6,6,0,0,0,6,7,6,0,6,1,1,1,1,0
"08067193",ESC,Centre públic Dep. i CEB,Escola del Bosc,Rubí,VOC,VOC,1,10,1,0,1,0,10,0,0,10,0,9,0,0,9,10,0,9,9,1,1,1,1,0
"08067201",ESC,Centre públic Dep. i CEB,Escola Lola Anglada,Sant Quirze del Vallès,VOC,VOC,1,16,0,0,0,15,2,0,0,17,15,1,0,0,16,16,5,2,7,0,0,1,1,0
"08067211",INS,Centre públic Dep. i CEB,Institut Salas i Xandri,Sant Quirze del Vallès,VOC,VOC,1,10,0,0,0,4,2,1,1,8,4,2,1,1,8,8,5,3,8,0,0,1,1,0
"08067235",ESC,Centre públic Dep. i CEB,Escola Roc Alabern,Terrassa,VOC,VOC,1,20,1,3,4,18,1,0,0,19,18,1,0,0,19,20,6,1,7,1,1,1,1,0
"08067247",ESC,Centre públic Dep. i CEB,Escola El Vapor,Terrassa,VOC,VOC,1,20,1,0,1,19,0,0,0,19,19,0,0,0,19,20,11,0,11,1,1,1,1,0
"08067430",ESC,Centre públic Dep. i CEB,Escola Montserrat Solà,Mataró,MVO,MVO,1,38,1,5,6,0,16,0,0,16,0,16,0,0,16,17,0,0,0,6,6,1,1,0
"08067582",ESC,Centre públic Dep. i CEB,Escola Marta Mata,Barberà del Vallès,VOC,VOC,1,10,0,0,0,8,2,0,0,10,8,2,0,0,10,10,4,1,5,0,0,1,1,0
"08067594",IE,Centre públic Dep. i CEB,Institut Escola Les Vinyes,Castellbisbal,VOC,VOC,1,20,0,4,4,17,5,2,0,24,17,3,0,0,20,20,4,3,7,0,0,1,1,0
"08067600",ESC,Centre públic Dep. i CEB,Escola Valldaura,Manresa,CCE,CCE,1,15,0,1,1,6,0,0,0,6,6,0,0,0,6,6,3,0,3,1,1,1,1,0
"08067636",INS,Centre públic Dep. i CEB,Institut Manresa Sis,Manresa,CCE,CCE,1,13,4,0,4,0,2,0,8,10,0,2,0,7,9,13,0,0,0,4,4,1,1,0
"08067648",INS,Centre públic Dep. i CEB,Institut Les Vinyes,Cubelles,BCO,PEN,1,8,0,0,0,17,0,0,0,17,8,0,0,0,8,8,0,0,0,0,0,1,1,0
"08067661",ESC,Centre públic Dep. i CEB,Escola Joan Coromines,Mataró,MVO,MVO,1,19,0,1,1,12,0,0,1,13,12,0,0,1,13,13,0,0,0,1,1,1,1,0
"08067740",INS,Obre el curs 2023-24,Institut Vallcarca,Barcelona,CEB,CEB,0,2,0,0,0,0,0,0,0,0,2,0,0,0,2,2,0,0,0,0,0,1,1,0
"08067752",INS,Centre públic Dep. i CEB,Institut Sagrera Sant Andreu,Barcelona,CEB,CEB,1,13,13,0,13,0,1,0,5,6,0,0,0,0,0,13,0,0,0,13,4,1,1,0
"08067764",ESC,Centre públic Dep. i CEB,Escola La Maquinista,Barcelona,CEB,CEB,1,19,0,0,0,0,0,0,6,6,0,0,0,6,6,6,0,0,0,0,0,1,1,0
"08067818",ESC,Centre públic Dep. i CEB,Escola La Sínia,Vic,CCE,CCE,1,18,0,0,0,0,18,0,0,18,0,18,0,0,18,18,0,18,18,0,0,1,1,0
"08068057",AH,Aules hospitalàries,A. Hospitalària Hospital de Dia per adolescents de Nou Barris,Barcelona,CEB,CEB,0,1,0,0,0,0,0,0,0,0,0,0,0,0,0,0,0,0,0,0,0,1,0,1
"08068136",CFA,CFA Departament,CFA Víctor Català,Sant Esteve Sesrovires,BLL,BLL,1,9,0,0,0,0,4,0,0,4,3,0,0,0,3,3,0,0,0,0,0,1,1,0
"08068151",CJJ,Justícia juvenil,C.Educ.Justícia Can Llupià,Barcelona,CEB,CEB,0,7,3,0,3,0,0,0,0,0,0,0,7,0,7,10,0,0,0,0,0,1,1,0
"08068331",ESC,Centre públic Dep. i CEB,Escola Badalona Port,Badalona,BCO,BCO,1,9,0,0,0,0,9,0,0,9,0,9,0,0,9,9,0,9,9,0,0,1,1,0
"08068343",ESC,Centre públic Dep. i CEB,Escola Les Ciències,Badalona,BCO,BCO,1,9,1,0,1,8,1,0,0,9,8,0,0,0,8,9,3,1,4,1,1,1,1,0
"08068379",ESC,Centre públic Dep. i CEB,Escola Mar Nova,Premià de Mar,MVO,MVO,1,8,1,0,1,0,0,0,0,0,0,0,0,0,0,1,0,0,0,1,1,1,1,7
"08068380",INS,Centre públic Dep. i CEB,Institut Gurb,Gurb,CCE,CCE,1,17,0,0,0,0,12,0,0,12,0,12,0,0,12,12,0,4,4,0,0,1,1,0
"08068410",ESC,Centre públic Dep. i CEB,Escola Palau d'Ametlla,Montornès del Vallès,MVO,MVO,1,9,2,0,2,9,0,0,0,9,7,0,0,0,7,9,5,0,5,2,2,1,1,0
"08068495",INS,Centre públic Dep. i CEB,Institut Josefina Castellví i Piulachs,Viladecans,BLL,BLL,1,21,1,0,1,15,2,0,0,17,15,2,0,0,17,18,15,2,17,1,1,1,1,0
"08068537",INS,Centre públic Dep. i CEB,Institut Les Aimerigues,Terrassa,VOC,VOC,1,23,2,1,3,22,0,0,0,22,21,0,0,0,21,23,6,0,6,2,2,1,1,0
"08068616",INS,Centre públic Dep. i CEB,Institut Bages Sud,El Borràs (Castellbell i el Vilar),CCE,CCE,1,9,1,6,7,0,0,8,0,8,0,0,8,0,8,9,6,2,8,1,1,1,1,0
"08069499",ESC,Centre públic Dep. i CEB,Escola Vic-centre,Vic,CCE,CCE,1,9,0,0,0,5,4,0,0,9,5,4,0,0,9,9,2,4,6,0,0,1,1,0
"08069554",AH,Aules hospitalàries,A. Hospitalària Hospital de Dia per a Adolescents,Martorell,BLL,BLL,0,1,0,0,0,0,0,0,0,0,0,0,1,0,1,1,0,0,0,0,0,0,0,0
"08069581",CFA,CFA Departament,CFA Carme Karr,Sant Joan de Vilatorrada,CCE,CCE,1,4,0,0,0,2,0,4,0,6,3,0,0,0,3,3,0,0,0,0,0,1,1,0
"08069645",EE,EE municipals,CEE Montserrat Montero,Granollers,MVO,MVO,0,1,0,0,0,0,0,0,0,0,5,0,0,0,5,5,0,0,0,0,0,0,1,0
"08069736",ESC,Centre públic Dep. i CEB,Escola Paco Candel,L'Hospitalet de Llobregat,BCO,BCO,1,18,0,0,0,18,0,0,0,18,18,0,0,0,18,18,18,0,18,0,0,1,1,0
"08069748",ESC,Centre públic Dep. i CEB,Escola Montigalà,Badalona,BCO,BCO,1,9,0,6,6,0,0,9,0,9,0,0,9,0,9,9,9,0,9,0,0,1,1,0
"08069751",ESC,Centre públic Dep. i CEB,Escola Santa Coloma,Santa Coloma de Gramenet,BCO,BCO,1,9,1,10,11,0,9,0,0,9,0,8,0,0,8,9,0,8,8,1,1,1,1,0
"08070143",ESC,Centre públic Dep. i CEB,Escola Riera Alta,Santa Coloma de Gramenet,BCO,BCO,1,18,3,0,3,18,0,0,0,18,15,0,0,0,15,18,14,0,14,3,3,1,1,0
"08070234",ESC,Centre públic Dep. i CEB,Escola Can Fabra,Barcelona,CEB,CEB,1,18,0,0,0,18,0,0,0,18,18,0,0,0,18,18,6,0,6,0,0,1,1,0
"08070261",AH,Aules hospitalàries,A. Hospitalària Hospital de Dia de Badalona,Badalona,BCO,BCO,0,1,0,0,0,0,0,0,0,0,0,0,1,0,1,1,0,0,0,0,0,0,0,0
"08070672",AH,Aules hospitalàries,A. Hospitalària Hospital de Dia de Salut Mental per Adolescents,Barcelona,CEB,CEB,0,1,0,0,0,0,0,0,0,0,0,0,0,0,0,0,0,0,0,0,0,1,0,1
"08070799",ESC,Centre públic Dep. i CEB,Escola Tiziana,Tiana,MVO,MVO,1,9,1,0,1,8,1,1,0,10,8,0,0,0,8,9,3,1,4,1,1,1,1,0
"08070908",IE,Centre públic Dep. i CEB,Institut Escola La Tordera,Santa Maria de Palautordera,MVO,MVO,1,27,1,0,1,19,0,0,0,19,19,0,0,0,19,20,6,0,6,1,1,1,1,0
"08071020",ESC,Centre públic Dep. i CEB,Escola Enxaneta,Viladecans,BLL,BLL,1,10,1,0,1,0,11,0,0,11,0,9,0,0,9,10,0,9,9,1,1,1,1,0
"08071101",CFA,CFA Municipals no CEB,CFA El Masnou,El Masnou,MVO,MVO,0,2,0,0,0,0,0,0,0,0,2,0,0,0,2,2,0,0,0,0,0,0,1,0
"08071147",ESC,Centre públic Dep. i CEB,Escola Roser Capdevila,Sant Joan Despí,BLL,BLL,1,12,5,1,6,10,0,0,0,10,7,0,0,0,7,12,6,0,6,5,4,1,1,0
"08071196",INS,Centre públic Dep. i CEB,Institut Can Roca,Terrassa,VOC,VOC,1,31,3,0,3,18,0,3,0,21,18,0,3,0,21,24,21,0,21,3,3,1,1,0
"08071214",IE,Centre públic Dep. i CEB,Institut Escola Castellterçol,Castellterçol,CCE,CCE,1,18,1,0,1,14,0,0,0,14,14,0,0,0,14,15,0,0,0,1,1,1,1,0
"08071226",IE,Centre públic Dep. i CEB,Institut Escola Costa i Llobera,Barcelona,CEB,CEB,1,34,0,0,0,24,1,5,0,30,24,1,5,0,30,30,17,1,18,0,0,1,1,0
"08071238",IE,Centre públic Dep. i CEB,Institut Escola Jacint Verdaguer,Sant Sadurní d'Anoia,BCO,PEN,1,31,3,0,3,30,0,0,0,30,28,0,0,0,28,31,6,0,6,3,3,1,1,0
"08071391",CFA,CFA Municipals no CEB,CFA Centelles,Centelles,CCE,CCE,0,2,0,0,0,0,0,0,0,0,2,0,0,0,2,2,0,0,0,0,0,0,1,0
"08071691",IE,Centre públic Dep. i CEB,Institut Escola del Prat,El Prat de Llobregat,BLL,BLL,1,13,1,5,6,12,1,0,0,13,12,0,0,0,12,13,12,0,12,1,1,1,1,0
"08072176",INS,Centre públic Dep. i CEB,Institut del Ter,Manlleu,CCE,CCE,1,12,2,16,18,0,13,0,0,13,0,10,0,0,10,12,0,10,10,2,2,1,1,0
"08072188",IE,Centre públic Dep. i CEB,Institut Escola Sant Jordi,Navàs,CCE,CCE,1,26,0,8,8,6,0,0,17,23,6,0,0,17,23,23,6,17,23,3,3,1,1,0
"08072255",INS,Centre públic Dep. i CEB,Institut Premià de Mar,Premià de Mar,MVO,MVO,1,37,0,2,2,4,2,0,0,6,4,2,0,0,6,6,4,2,6,2,2,1,1,0
"08072292",IE,Centre públic Dep. i CEB,Institut Escola Turó de Roquetes,Barcelona,CEB,CEB,1,33,2,0,2,0,30,0,0,30,0,30,0,0,30,32,0,0,0,2,2,1,1,0
"08072310",IE,Centre públic Dep. i CEB,Institut Escola Rec Comtal,Barcelona,CEB,CEB,1,26,11,2,13,0,21,0,0,21,0,15,0,0,15,26,0,13,13,11,7,1,1,0
"08072383",INS,Centre públic Dep. i CEB,Institut Domus d'Olivet,La Serra (Canovelles),MVO,MVO,1,13,0,0,0,0,0,0,8,8,0,0,0,8,8,8,0,8,8,0,0,1,1,0
"08072401",INS,Centre públic Dep. i CEB,Institut Torrent dels Alous,Rubí,VOC,VOC,1,28,3,0,3,21,0,0,0,21,21,0,0,0,21,24,21,0,21,3,3,1,1,0
"08072589",EOI,Centre públic Dep. i CEB,EOI Barcelona-Guinardó,Barcelona,CEB,CEB,1,30,0,12,12,0,0,0,0,0,0,0,0,0,0,0,0,0,0,12,8,1,1,30
"08072590",EOI,Centre públic Dep. i CEB,EOI de Rubí,Rubí,VOC,VOC,1,18,0,0,0,0,0,1,0,1,0,0,1,0,1,1,0,0,0,0,0,1,1,0
"08072607",EOI,Centre públic Dep. i CEB,EOI de Cornellà de Llobregat,Cornellà de Llobregat,BLL,BLL,1,24,0,3,3,10,0,0,0,10,10,0,0,0,10,10,0,0,0,3,3,1,1,0
"08072978",INS,Centre públic Dep. i CEB,Institut Sunsi Móra,Canet de Mar,MVO,MVO,1,15,0,0,0,11,0,0,0,11,11,0,0,0,11,11,11,0,11,0,0,1,1,0
"08073028",INS,Centre públic Dep. i CEB,Institut de Sant Pol de Mar,Sant Pol de Mar,MVO,MVO,1,16,0,0,0,19,0,7,0,26,16,0,0,0,16,16,0,0,0,0,0,1,1,0
"08073031",INS,Centre públic Dep. i CEB,Institut Neus Català,Cornellà de Llobregat,BLL,BLL,1,11,0,0,0,6,0,0,2,8,6,0,0,2,8,8,0,2,2,0,0,1,1,0
"08073077",INS,Centre públic Dep. i CEB,Institut Maria Canela,Martorell,BLL,BLL,1,9,0,0,0,5,3,1,0,9,5,3,1,0,9,9,0,0,0,0,0,1,1,0
"08073119",INS,Centre públic Dep. i CEB,Institut Can Periquet,Palau-solità i Plegamans,VOC,VOC,1,12,2,0,2,7,1,0,0,8,7,1,0,0,8,10,0,0,0,2,2,1,1,0
"08073171",INS,Centre públic Dep. i CEB,Institut La Riera,Badalona,BCO,BCO,1,12,2,0,2,3,3,0,0,6,3,3,0,0,6,8,3,0,3,2,2,1,1,0
"08073193",INS,Centre públic Dep. i CEB,Institut Badia i Margarit,Igualada,CCE,PEN,1,19,1,6,7,10,2,0,0,12,10,2,0,0,12,13,8,0,8,7,5,1,1,0
"08073651",INS,Centre públic Dep. i CEB,Institut Pic del Vent,Caldes de Montbui,MVO,MVO,1,9,0,0,0,2,0,2,0,4,2,0,2,0,4,4,0,0,0,0,0,1,1,0
"08073843",INS,Centre públic Dep. i CEB,Institut Tordària,Tordera,MVO,MVO,1,9,0,0,0,11,3,0,0,14,9,0,0,0,9,9,9,0,9,0,0,1,1,0
"08073958",ESC,Centre públic Dep. i CEB,Escola Nova d'Argentona,Argentona,MVO,MVO,1,13,0,5,5,0,0,16,1,17,0,0,13,0,13,13,13,0,13,0,0,1,1,0
"08073961",INS,Centre públic Dep. i CEB,Institut Pla del Bosc,Canyelles,BCO,PEN,1,11,0,4,4,0,0,13,0,13,0,0,11,0,11,11,11,0,11,0,0,1,1,0
"08074045",CFA,CFA Municipals no CEB,CFA El Roure Gros,Caldes de Montbui,MVO,MVO,0,2,0,0,0,0,0,0,0,0,2,0,0,0,2,2,0,0,0,0,0,0,1,0
"08074070",EOI,Centre públic Dep. i CEB,EOI de Calella,Calella,MVO,MVO,1,15,0,0,0,2,4,0,0,6,2,4,0,0,6,6,0,0,0,0,0,1,1,0
"08074215",CFA,CFA Municipals sense estudis reglats,CFA de Cardedeu,Cardedeu,MVO,MVO,0,1,0,0,0,0,0,0,0,0,1,0,0,0,1,1,0,0,0,0,0,0,1,0
"08074380",ESC,Centre públic Dep. i CEB,Escola Castell de Dosrius,Dosrius,MVO,MVO,1,19,0,19,19,9,1,4,0,14,9,1,4,0,14,14,13,1,14,5,5,1,1,0
"08074410",INS,Centre públic Dep. i CEB,Institut La Serra,Sabadell,VOC,VOC,1,8,0,0,0,0,0,0,5,5,0,0,0,5,5,5,0,5,5,0,0,1,1,0
"08074628",INS,Centre públic Dep. i CEB,Institut El Prat de Llobregat,El Prat de Llobregat,BLL,BLL,1,12,12,0,12,0,0,3,1,4,0,0,0,0,0,12,0,0,0,12,4,1,1,0
"08074631",FP,Centre públic Dep. i CEB,Institut Les Salines,El Prat de Llobregat,BLL,BLL,1,28,0,0,0,37,3,0,0,40,28,0,0,0,28,28,28,0,28,0,0,1,1,0
"08074641",ESC,Centre públic Dep. i CEB,Escola Els 30 Passos,Barcelona,CEB,CEB,1,16,2,0,2,0,5,0,0,5,0,5,0,0,5,7,0,5,5,2,2,1,1,0
"08074801",INS,Centre públic Dep. i CEB,Institut Marta Estrada,Granollers,MVO,MVO,1,9,0,0,0,8,0,0,0,8,8,0,0,0,8,8,8,0,8,0,0,1,1,0
"08074811",ESC,Centre públic Dep. i CEB,Escola Turó de Can Gili,Granollers,MVO,MVO,1,10,1,0,1,7,4,0,0,11,7,2,0,0,9,10,7,2,9,1,1,1,1,0
"08074823",ESC,Centre públic Dep. i CEB,Escola Els Picots,Lliçà d'Amunt,MVO,MVO,1,19,1,0,1,6,11,0,0,17,6,11,0,0,17,18,6,11,17,1,1,1,1,0
"08074835",ESC,Centre públic Dep. i CEB,Escola Jaume Llull,Sant Andreu de Llavaneres,MVO,MVO,1,17,0,0,0,17,0,0,0,17,17,0,0,0,17,17,17,0,17,0,0,1,1,0
"08074847",FP,Centre públic Dep. i CEB,Institut de Nàutica de Barcelona,Barcelona,CEB,CEB,1,11,0,1,1,0,5,0,0,5,0,5,0,0,5,5,0,5,5,1,1,1,1,0
"08074860",CFA,CFA Municipals no CEB,CFA Enric Camón,Arenys de Munt,MVO,MVO,0,4,0,0,0,0,0,0,0,0,3,0,0,0,3,3,0,0,0,0,0,0,1,0
"08074926",AH,Aules hospitalàries,A. Hospitalària Aula Hospitalària Àrea d'Adolescents Benito Menni,Sant Boi de Llobregat,BLL,BLL,0,1,0,0,0,0,0,0,0,0,0,0,1,0,1,1,0,0,0,0,0,0,0,0
"08074938",CFA,CFA Municipals sense estudis reglats,CFA d'Alella,Alella,MVO,MVO,0,1,0,0,0,0,0,0,0,0,1,0,0,0,1,1,0,0,0,0,0,0,1,0
"08075074",INS,Centre públic Dep. i CEB,Institut de Santa Coloma de Gramenet,Santa Coloma de Gramenet,BCO,BCO,1,14,11,0,11,0,4,0,2,6,0,3,0,0,3,14,0,0,0,11,4,1,1,0
"08075207",ESC,Centre públic Dep. i CEB,Escola Entença,Barcelona,CEB,CEB,1,15,0,0,0,0,0,0,0,0,0,0,0,0,0,0,0,0,0,0,0,1,1,15
"08075244",ESC,Centre públic Dep. i CEB,Escola Les Bases,Manresa,CCE,CCE,1,9,1,0,1,0,0,0,2,2,0,0,0,2,2,3,0,0,0,1,1,1,1,0
"08075256",IE,Centre públic Dep. i CEB,Institut Escola Marta Mata,Torelló,CCE,CCE,1,28,1,0,1,0,17,0,10,27,0,17,0,10,27,28,0,10,10,1,1,1,1,0
"08075268",ESC,Centre públic Dep. i CEB,Escola La Mirada,Sant Cugat del Vallès,VOC,VOC,1,17,11,0,11,0,17,0,0,17,0,6,0,0,6,17,0,6,6,11,5,1,1,0
"08075281",INS,Centre públic Dep. i CEB,Institut Bitàcola,Barberà del Vallès,VOC,VOC,1,13,1,3,4,10,1,0,0,11,10,1,0,0,11,12,4,1,5,2,2,1,1,0
"08075293",IE,Centre públic Dep. i CEB,Institut Escola Gavà Mar,Gavà,BLL,BLL,1,29,5,16,21,0,0,23,2,25,0,0,23,1,24,29,0,0,0,5,5,1,1,0
"08075384",IE,Centre públic Dep. i CEB,Institut Escola La Mina,Sant Adrià de Besòs,BCO,BCO,1,32,1,5,6,24,6,0,0,30,24,6,0,0,30,31,0,0,0,2,2,1,1,0
"08075451",FP,APD & FP Municipals no CEB,Institut de Formació Professional d'Enoturisme de Catalunya,Vilafranca del Penedès,BCO,PEN,0,0,0,0,0,0,0,0,0,0,0,0,0,0,0,0,0,0,0,0,0,0,0,0
"08075608",ESC,Centre públic Dep. i CEB,Escola 9 Graons,Barcelona,CEB,CEB,1,12,7,0,7,0,1,2,7,10,0,1,2,2,5,12,0,0,0,7,4,1,1,0
"08075611",ESC,Centre públic Dep. i CEB,Escola Gaia,Barcelona,CEB,CEB,1,15,1,0,1,0,1,0,0,1,0,1,0,0,1,2,0,0,0,1,1,1,1,0
"08075621",ESC,Centre públic Dep. i CEB,Escola Teixidores de Gràcia,Barcelona,CEB,CEB,1,13,1,0,1,0,0,0,0,0,0,0,0,0,0,1,0,0,0,1,1,1,1,12
"08075633",ESC,Centre públic Dep. i CEB,Escola Anglesola,Barcelona,CEB,CEB,1,15,6,0,6,0,0,0,0,0,0,0,0,0,0,6,0,0,0,6,4,1,1,9
"08075645",ESC,Centre públic Dep. i CEB,Escola La Flor de Maig,Barcelona,CEB,CEB,1,15,4,0,4,4,6,0,0,10,4,6,0,0,10,14,4,6,10,4,4,1,1,0
"08075657",IE,Centre públic Dep. i CEB,Institut Escola Antaviana,Barcelona,CEB,CEB,1,29,7,4,11,4,1,12,3,20,4,1,12,3,20,27,0,0,0,9,8,1,1,0
"08075669",IE,Centre públic Dep. i CEB,Institut Escola El Til·ler,Barcelona,CEB,CEB,1,13,4,0,4,9,7,0,0,16,9,0,0,0,9,13,0,0,0,4,4,1,1,0
"08075670",IE,Centre públic Dep. i CEB,Institut Escola Trinitat Nova,Barcelona,CEB,CEB,1,26,6,0,6,0,0,12,0,12,0,0,12,0,12,18,0,0,0,6,6,1,1,0
"08075682",INS,Centre públic Dep. i CEB,Institut Olímpia,Viladecans,BLL,BLL,1,15,6,0,6,0,12,0,0,12,0,9,0,0,9,15,0,9,9,6,4,1,1,0
"08075700",ESC,Centre públic Dep. i CEB,Escola Xirinacs,Barcelona,CEB,CEB,1,12,0,0,0,0,0,0,3,3,0,0,0,3,3,3,0,3,3,0,0,1,1,0
"08075712",INS,Centre públic Dep. i CEB,Institut Les Cinc Sénies,Mataró,MVO,MVO,1,22,9,0,9,0,0,0,11,11,0,0,0,11,11,20,0,0,0,9,6,1,1,0
"08075724",ESC,Centre públic Dep. i CEB,Escola Norai,Montgat,MVO,MVO,1,6,3,0,3,1,0,0,0,1,1,0,0,0,1,4,0,0,0,3,2,1,1,0
"08076078",ESC,Centre públic Dep. i CEB,Escola Auditori,Barcelona,CEB,CEB,1,10,1,0,1,6,0,0,0,6,6,0,0,0,6,7,2,0,2,1,1,1,1,0
"08076091",INS,Centre públic Dep. i CEB,Institut Ca n'Oriac,Sabadell,VOC,VOC,1,12,17,8,25,0,0,0,0,0,0,0,0,0,0,17,0,0,0,12,4,1,1,0
"08076108",INS,TANCA el curs 2023-24,Institut Jaume Cabré,Terrassa,VOC,VOC,1,0,8,0,8,2,0,0,0,2,0,0,0,0,0,8,0,0,0,8,0,1,0,0
"08076111",INS,Centre públic Dep. i CEB,Institut Jaume Botey,L'Hospitalet de Llobregat,BCO,BCO,1,17,3,0,3,3,4,0,4,11,3,4,0,4,11,14,0,0,0,3,3,1,1,0
"08076145",IE,Centre públic Dep. i CEB,Institut Escola Mar Mediterrània,Mataró,MVO,MVO,1,22,5,2,7,10,0,0,0,10,10,0,0,0,10,15,10,0,10,7,6,1,1,0
"08076157",IE,Centre públic Dep. i CEB,Institut Escola Àngela Bransuela,Mataró,MVO,MVO,1,18,5,4,9,12,3,0,0,15,12,1,0,0,13,18,4,2,6,5,5,1,1,0
"08076169",IE,Centre públic Dep. i CEB,Institut Escola Gornal,L'Hospitalet de Llobregat,BCO,BCO,1,13,8,4,12,5,0,0,0,5,5,0,0,0,5,13,4,0,4,8,4,1,1,0
"08076194",INS,Centre públic Dep. i CEB,Institut Tecnològic de Barcelona,Barcelona,CEB,CEB,1,17,0,0,0,0,12,0,0,12,0,12,0,0,12,12,0,12,12,0,0,1,1,0
"08076391",INS,Centre públic Dep. i CEB,Institut Pedralbes,Barcelona,CEB,CEB,1,54,0,0,0,30,16,0,0,46,30,16,0,0,46,46,12,0,12,0,0,1,1,0
"08076406",INS,Centre públic Dep. i CEB,Institut Narcisa Freixas i Cruells,Sabadell,VOC,VOC,1,12,8,0,8,0,6,0,0,6,0,4,0,0,4,12,0,4,4,8,4,1,1,0
"08076421",IE,Centre públic Dep. i CEB,Institut Escola Pepa Colomer,El Prat de Llobregat,BLL,BLL,1,27,10,6,16,15,0,0,2,17,15,0,0,2,17,27,0,0,0,10,7,1,1,0
"08076431",IE,Centre públic Dep. i CEB,Institut Escola Baldomer Solà,Badalona,BCO,BCO,1,18,7,16,23,10,0,0,0,10,10,0,0,0,10,17,10,0,10,8,5,1,1,0
"08076443",IE,Centre públic Dep. i CEB,Institut Escola Rafael Alberti,Badalona,BCO,BCO,1,18,8,0,8,0,19,0,0,19,0,10,0,0,10,18,4,0,4,8,5,1,1,0
"08076455",IE,Centre públic Dep. i CEB,Institut Escola Sant Jordi,Badalona,BCO,BCO,1,13,6,0,6,0,8,0,0,8,0,7,0,0,7,13,0,7,7,6,4,1,1,0
"08076467",IE,Centre públic Dep. i CEB,Institut Escola Pere Lliscart,L'Hospitalet de Llobregat,BCO,BCO,1,26,10,2,12,0,17,0,0,17,0,16,0,0,16,26,0,16,16,10,7,1,1,0
"08076479",IE,Centre públic Dep. i CEB,Institut Escola Sant Quintí de Mediona,Sant Quintí de Mediona,BCO,PEN,1,22,1,0,1,3,3,0,0,6,3,3,0,0,6,7,0,0,0,1,1,1,1,0
"08076480",IE,Centre públic Dep. i CEB,Institut Escola Pallaresa,Santa Coloma de Gramenet,BCO,BCO,1,24,8,0,8,17,0,0,0,17,16,0,0,0,16,24,6,0,6,8,7,1,1,0
"08076492",IE,Centre públic Dep. i CEB,Institut Escola Pompeu Fabra,El Pont de Vilomara i Rocafort,CCE,CCE,1,26,8,0,8,18,2,0,0,20,18,0,0,0,18,26,18,0,18,8,7,1,1,0
"08076509",IE,Centre públic Dep. i CEB,Institut Escola Arts,Barcelona,CEB,CEB,1,25,7,0,7,0,5,1,9,15,0,5,1,9,15,22,1,14,15,7,7,1,1,0
"08076510",IE,Centre públic Dep. i CEB,Institut Escola Pla de l'Avellà,Cabrera de Mar,MVO,MVO,1,26,9,0,9,0,23,0,0,23,0,17,0,0,17,26,0,17,17,9,7,1,1,0
"08076522",IE,Centre públic Dep. i CEB,Institut Escola Pallerola,Sant Celoni,MVO,MVO,1,29,5,0,5,14,6,1,0,21,14,6,1,0,21,26,6,5,11,5,5,1,1,0
"08076534",IE,Centre públic Dep. i CEB,Institut Escola Montagut,Santa Susanna,MVO,MVO,1,22,9,2,11,10,2,0,0,12,10,2,0,0,12,21,5,0,5,10,6,1,1,0
"08076546",IE,Centre públic Dep. i CEB,Institut Escola Can Llobet,Barberà del Vallès,VOC,VOC,1,28,7,0,7,6,17,0,0,23,6,15,0,0,21,28,6,15,21,7,7,1,1,0
"08076558",IE,Centre públic Dep. i CEB,Institut Escola Sant Esteve,Castellar del Vallès,VOC,VOC,1,26,10,0,10,13,2,0,0,15,13,2,0,0,15,25,13,2,15,10,7,1,1,0
"08076561",IE,Centre públic Dep. i CEB,Institut Escola El Viver,Montcada i Reixac,VOC,VOC,1,26,12,0,12,23,1,0,0,24,14,0,0,0,14,26,1,0,1,12,7,1,1,0
"08076571",IE,Centre públic Dep. i CEB,Institut Escola El Martinet,Ripollet,VOC,VOC,1,27,4,0,4,0,4,0,0,4,0,4,0,0,4,8,0,4,4,4,4,1,1,0
"08076583",IE,Centre públic Dep. i CEB,Institut Escola Els Pinetons,Ripollet,VOC,VOC,1,34,12,0,12,2,3,0,0,5,2,3,0,0,5,17,0,0,0,12,9,1,1,0
"08076595",IE,Centre públic Dep. i CEB,Institut Escola Teresa Altet,Rubí,VOC,VOC,1,19,6,0,6,0,17,0,0,17,0,13,0,0,13,19,0,0,0,6,5,1,1,0
"08076601",IE,Centre públic Dep. i CEB,Institut Escola Pere Viver,Terrassa,VOC,VOC,1,30,7,0,7,20,4,0,0,24,20,3,0,0,23,30,6,0,6,7,7,1,1,0
"08076613",IE,Centre públic Dep. i CEB,Institut Escola Barnola,Avinyó,CCE,CCE,1,13,5,0,5,0,0,0,10,10,0,0,0,8,8,13,0,8,8,5,4,1,1,0
"08076637",FP,Centre públic Dep. i CEB,Institut FP Sant Cugat del Vallès,Sant Cugat del Vallès,VOC,VOC,1,17,0,6,6,1,11,9,0,21,1,11,5,0,17,17,0,0,0,0,0,1,1,0
"08076649",FP,Centre públic Dep. i CEB,Institut de Jardineria i Agricultura Les Garberes,Castellar del Vallès,VOC,VOC,1,7,0,0,0,1,0,0,1,2,1,0,0,1,2,2,1,1,2,0,0,1,1,0
"08076650",CFA,CFA Departament,CFA Sant Adrià de Besòs,Sant Adrià de Besòs,BCO,BCO,1,5,0,0,0,0,0,0,0,0,3,0,0,0,3,3,0,0,0,0,0,1,1,0
"08076820",IE,Centre públic Dep. i CEB,Institut Escola Sala i Badrinas,Terrassa,VOC,VOC,1,25,9,3,12,22,1,0,0,23,16,0,0,0,16,25,16,0,16,9,7,1,1,0
"08076893",INS,Centre públic Dep. i CEB,Institut Vilafranca 2,Vilafranca del Penedès,BCO,PEN,1,6,6,0,6,0,5,0,2,7,0,0,0,0,0,6,0,0,0,6,2,1,1,0
"08076901",IE,Centre públic Dep. i CEB,Institut Escola Turó d'en Caritg,Badalona,BCO,BCO,1,27,8,6,14,0,26,0,0,26,0,19,0,0,19,27,0,19,19,8,7,1,1,0
"08076923",IE,Centre públic Dep. i CEB,Institut Escola Llibertat,Badalona,BCO,BCO,1,13,4,0,4,0,0,18,0,18,0,0,9,0,9,13,9,0,9,4,4,1,1,0
"08076935",IE,Centre públic Dep. i CEB,Institut Escola Puig i Gairalt,L'Hospitalet de Llobregat,BCO,BCO,1,25,6,0,6,21,0,0,0,21,19,0,0,0,19,25,19,0,19,6,6,1,1,0
"08076947",IE,Centre públic Dep. i CEB,Institut Escola Lluís Millet,Santa Coloma de Gramenet,BCO,BCO,1,12,4,1,5,6,0,1,1,8,6,0,1,1,8,12,5,0,5,4,4,1,1,0
"08076959",IE,Centre públic Dep. i CEB,Institut Escola Carles Capdevila,Els Hostalets de Balenyà (Balenyà),CCE,CCE,1,26,4,17,21,0,0,0,15,15,0,0,0,15,15,19,0,0,0,11,7,1,1,0
"08076960",IE,Centre públic Dep. i CEB,Institut Escola Renaixença,Els Hostalets de Pierola,CCE,PEN,1,21,6,0,6,0,12,0,5,17,0,12,0,3,15,21,0,15,15,6,6,1,1,0
"08076972",IE,Centre públic Dep. i CEB,Institut Escola Piera,Piera,CCE,PEN,1,27,0,0,0,27,0,0,0,27,27,0,0,0,27,27,27,0,27,0,0,1,1,0
"08076984",IE,Centre públic Dep. i CEB,Institut Escola Josep Maria Xandri,Sant Pere de Torelló,CCE,CCE,1,12,2,0,2,0,1,0,3,4,0,1,0,3,4,6,0,4,4,2,2,1,1,0
"08076996",IE,Centre públic Dep. i CEB,Institut Escola Mossen Cinto,Folgueroles,CCE,CCE,1,19,5,0,5,4,0,0,0,4,4,0,0,0,4,9,1,0,1,5,5,1,1,0
"08077009",IE,Centre públic Dep. i CEB,Institut Escola Castell d'Òdena,Òdena,CCE,PEN,1,20,6,1,7,6,0,0,0,6,6,0,0,0,6,12,6,0,6,7,6,1,1,0
"08077010",IE,Centre públic Dep. i CEB,Institut Escola Coves d'en Cimany,Barcelona,CEB,CEB,1,13,5,0,5,0,0,3,1,4,0,0,3,1,4,9,0,0,0,5,4,1,1,0
"08077022",IE,Centre públic Dep. i CEB,Institut Escola Els Tres Pins,Vallromanes,MVO,MVO,1,15,3,0,3,15,0,0,0,15,12,0,0,0,12,15,3,0,3,3,3,1,1,0
"08077034",IE,Centre públic Dep. i CEB,Institut Escola El Pi Gros,Sant Cebrià de Vallalta,MVO,MVO,1,19,5,0,5,17,0,0,0,17,14,0,0,0,14,19,14,0,14,5,5,1,1,0
"08077046",IE,Centre públic Dep. i CEB,Institut Escola Joan Sallarès i Pla,Sabadell,VOC,VOC,1,19,6,0,6,0,0,0,13,13,0,0,0,13,13,19,0,7,7,6,5,1,1,0
"08077058",IE,Centre públic Dep. i CEB,Institut Escola Catalunya,Sant Cugat del Vallès,VOC,VOC,1,26,6,2,8,25,1,2,0,28,20,0,0,0,20,26,8,0,8,6,6,1,1,0
"08077061",IE,Centre públic Dep. i CEB,Institut Escola Onze de Setembre,Sant Quirze del Vallès,VOC,VOC,1,16,5,5,10,7,0,0,0,7,7,0,0,0,7,12,7,0,7,9,5,1,1,0
"08077071",IE,Centre públic Dep. i CEB,Institut Escola Mas Rampinyo,Montcada i Reixac,VOC,VOC,1,22,9,0,9,2,2,0,0,4,2,2,0,0,4,13,2,2,4,9,6,1,1,0
"08077083",INS,Centre públic Dep. i CEB,Institut Vapor del Fil,Barcelona,CEB,CEB,1,6,7,1,8,0,0,0,4,4,0,0,0,0,0,7,0,0,0,6,2,1,1,0
"08077095",IE,Centre públic Dep. i CEB,Institut Escola Mirades,Barcelona,CEB,CEB,1,22,6,12,18,19,5,0,2,26,16,0,0,0,16,22,16,0,16,6,6,1,1,0
"08077101",IE,Centre públic Dep. i CEB,Institut Escola Tres Fonts de les Corts,Barcelona,CEB,CEB,1,27,7,0,7,0,9,0,9,18,0,9,0,9,18,25,0,18,18,7,7,1,1,0
"08077113",ESC,Centre públic Dep. i CEB,Escola Voltregà,Sant Hipòlit de Voltregà,CCE,CCE,1,17,0,2,2,4,11,0,0,15,4,11,0,0,15,15,0,0,0,2,2,1,1,0
"08077125",IE,Centre públic Dep. i CEB,Institut Escola Antoni Ubach i Soler,Terrassa,VOC,VOC,1,27,5,0,5,0,14,0,0,14,0,14,0,0,14,19,0,6,6,5,5,1,1,0
"08077137",INS,Centre públic Dep. i CEB,Institut de l'Esport de Barcelona,Barcelona,CEB,CEB,1,14,1,0,1,25,0,5,0,30,13,0,0,0,13,14,0,0,0,1,1,1,1,0
"08077149",IE,Centre públic Dep. i CEB,Institut Escola Eixample,Barcelona,CEB,CEB,1,20,12,0,12,0,1,4,2,7,0,1,4,2,7,19,0,0,0,12,6,1,1,0
"08077162",ESC,Centre públic Dep. i CEB,Escola Ateneu Igualadí,Igualada,CCE,PEN,1,27,2,0,2,8,4,0,0,12,8,4,0,0,12,14,8,4,12,2,2,1,1,0
"08077174",INS,Centre públic Dep. i CEB,Institut La Vall de Tenes,"Sagrera, la (Santa Eulàlia de Ronçana)",MVO,MVO,1,32,7,0,7,29,0,2,0,31,25,0,0,0,25,32,0,0,0,7,7,1,1,0
"08077204",EE,EE Privats,Les Girafes Blaves,Barcelona,CEB,CEB,0,1,0,0,0,0,0,0,0,0,1,0,0,0,1,1,0,0,0,0,0,0,1,0
"08077228",FP,Centre públic Dep. i CEB,Institut Professional de Turisme Eqüestre del Maresme,Santa Susanna,MVO,MVO,1,5,1,0,1,0,0,0,3,3,0,0,0,3,3,4,0,3,3,1,1,1,1,0
"08077231",AH,Aules hospitalàries,A. Hospitalària La Llacuna,Barcelona,CEB,CEB,0,1,0,0,0,0,0,0,0,0,0,0,0,0,0,0,0,0,0,0,0,1,0,1
"08077356",ESC,Centre públic Dep. i CEB,Escola Les Filadores,Sentmenat,VOC,VOC,1,2,0,0,0,0,0,1,0,1,0,0,1,0,1,1,1,0,1,0,0,1,1,0
"08077371",IE,Centre públic Dep. i CEB,Institut Escola El Morsell,Olivella,BCO,PEN,1,17,2,0,2,1,1,0,0,2,1,1,0,0,2,4,1,1,2,2,2,1,1,0
"08077381",IE,Centre públic Dep. i CEB,Institut Escola Virolet,Sabadell,VOC,VOC,1,24,8,0,8,22,0,0,0,22,16,0,0,0,16,24,0,0,0,8,7,1,1,0
"08077393",IE,Centre públic Dep. i CEB,Institut Escola Lluís Millet,El Masnou,MVO,MVO,1,19,5,1,6,18,0,0,0,18,14,0,0,0,14,19,0,0,0,5,5,1,1,0
"08077401",IE,Centre públic Dep. i CEB,Institut Escola Guillem de Balsareny,Balsareny,CCE,CCE,1,11,2,0,2,9,0,0,1,10,9,0,0,0,9,11,9,0,9,2,2,1,1,0
"08077435",FP,Centre públic Dep. i CEB,Institut dels Aliments de Barcelona,Barcelona,CEB,CEB,1,13,0,3,3,0,11,0,0,11,0,11,0,0,11,11,0,11,11,2,2,1,1,0
"08077447",ESC,Centre públic Dep. i CEB,Institut de formació professional Antoni Algueró,Sant Just Desvern,BLL,BLL,1,6,0,0,0,0,12,0,0,12,0,6,0,0,6,6,0,6,6,0,0,1,1,0
"08077459",IE,Centre públic Dep. i CEB,Institut Escola Santiga,Santa Perpètua de Mogoda,VOC,VOC,1,22,4,5,9,14,0,0,0,14,14,0,0,0,14,18,14,0,14,8,6,1,1,0
"08077460",IE,Centre públic Dep. i CEB,Institut Escola Santa Anna,Premià de Dalt,MVO,MVO,1,22,17,0,17,11,1,1,0,13,5,0,0,0,5,22,5,0,5,17,6,1,1,0
"08077472",INS,Centre públic Dep. i CEB,Institut Escola Intermunicipal del Penedès,Sant Sadurní d'Anoia,BCO,PEN,1,35,0,4,4,33,0,0,0,33,33,0,0,0,33,33,0,0,0,2,2,1,1,0
"08077484",IE,Centre públic Dep. i CEB,Institut Escola Elisabets,Barcelona,CEB,CEB,1,14,2,0,2,0,1,0,0,1,0,1,0,0,1,3,0,1,1,2,2,1,1,0
"08077496",IE,Centre públic Dep. i CEB,Institut Escola Sicília,Barcelona,CEB,CEB,1,13,7,0,7,6,0,0,0,6,6,0,0,0,6,13,2,0,2,7,4,1,1,0
"08077502",IE,Centre públic Dep. i CEB,Institut Escola Londres,Barcelona,CEB,CEB,1,26,0,0,0,0,0,0,0,0,0,0,0,0,0,0,0,0,0,0,0,1,1,26
"08077514",ESC,Centre públic Dep. i CEB,Escola Aldana,Barcelona,CEB,CEB,1,10,0,0,0,1,0,3,5,9,1,0,3,5,9,9,4,5,9,0,0,1,1,0
"08077782",IE,Centre públic Dep. i CEB,Institut Escola Miquel Martí i Pol,Lliçà d'Amunt,MVO,MVO,0,20,0,0,0,0,0,0,0,0,20,0,0,0,20,20,6,0,6,0,0,1,1,0
"08077851",IE,Centre públic Dep. i CEB,Institut Escola de Torrelles,Torrelles de Llobregat,BLL,BLL,0,32,0,0,0,0,0,0,0,0,0,0,0,0,0,0,0,0,0,0,0,1,1,32
"08077939",ESC,Centre públic Dep. i CEB,Escola de la Vila,Polinyà,VOC,VOC,1,22,0,0,0,18,2,0,0,20,18,2,0,0,20,20,18,2,20,0,0,1,1,0
"08077940",IE,Centre públic Dep. i CEB,Institut Escola Maria Miret,L'Hospitalet de Llobregat,BCO,BCO,0,14,10,0,10,0,0,0,0,0,0,0,0,0,0,10,0,0,0,0,0,1,1,4
"08077952",IE,Centre públic Dep. i CEB,Institut Escola Projecte,Barcelona,CEB,CEB,0,13,5,0,5,0,0,0,0,0,0,0,0,0,0,5,0,0,0,0,0,1,1,8
"08077964",IE,Centre públic Dep. i CEB,Institut Escola El Molí,Barcelona,CEB,CEB,0,27,0,0,0,0,0,0,0,0,0,0,0,0,0,0,0,0,0,0,0,1,1,27
"08077976",INS,Centre públic Dep. i CEB,Institut Miquel Biada,Mataró,MVO,MVO,1,51,8,0,8,12,40,0,0,52,25,0,0,0,25,33,0,0,0,8,0,1,1,0
"08077988",ESC-ZER,Centre públic Dep. i CEB,Escola Castellfollit del Boix-ZER Tres Branques,Castellfollit del Boix,CCE,CCE,0,3,0,0,0,0,0,0,0,0,0,0,0,0,0,0,0,0,0,0,0,1,0,3
"08077991",FP,Centre públic Dep. i CEB,Institut de Logística de Barcelona,Barcelona,CEB,CEB,0,9,9,0,9,0,0,0,0,0,9,0,0,0,9,18,0,0,0,0,0,1,1,0
"08078294",IE,Obre el curs 2023-24,Institut Escola de Badia,Badia del Vallès,VOC,VOC,0,19,0,0,0,0,0,0,0,0,18,0,0,0,18,18,10,0,10,0,1,1,1,0
"08078312",IE,Obre el curs 2023-24,Institut Escola Feixes,Terrassa,VOC,VOC,0,27,0,0,0,0,0,0,0,0,18,0,0,0,18,18,16,0,16,0,3,1,1,0
"08078324",IE,Obre el curs 2023-24,Institut Escola Manresa,Manresa,CCE,CCE,0,37,0,0,0,0,0,0,0,0,37,0,0,0,37,37,0,0,0,0,0,1,1,0
"08078336",ESC,Obre el curs 2023-24,Escola nova de Badia,Badia del Vallès,VOC,VOC,0,27,3,0,3,0,0,0,0,0,24,0,0,0,24,27,7,22,29,0,1,1,1,0
"08078361",IE,Concertada que passa a pública,Institut Escola Sant Felip Neri,Barcelona,CEB,CEB,0,13,0,0,0,0,0,0,0,0,13,0,0,0,13,13,0,0,0,0,0,1,1,0
"08078373",ESC,Concertada que passa a pública,Escola Segre,Barcelona,CEB,CEB,0,9,0,0,0,0,0,0,0,0,9,0,0,0,9,9,0,0,0,0,0,1,1,0
"08078385",FP,Obre el curs 2023-24,Institut Digital de Barcelona,Barcelona,CEB,CEB,0,19,0,0,0,0,0,0,0,0,19,0,0,0,19,19,0,0,0,0,0,1,1,0
"08078397",FP,Obre el curs 2023-24,Institut de Sostenibilitat i Medi Ambient de Barcelona,Barcelona,CEB,CEB,0,17,0,0,0,0,0,0,0,0,17,0,0,0,17,17,0,0,0,0,0,1,1,0
"08078403",INS,Obre el curs 2023-24,Institut d'arts escèniques i audiovisuals de Barcelona,Barcelona,CEB,CEB,0,9,0,0,0,0,0,0,0,0,9,0,0,0,9,9,0,0,0,0,0,1,1,0
"08078439",IE,Obre el curs 2023-24,Institut Escola El Cabrerès,L'Esquirol,CCE,CCE,0,10,0,0,0,0,0,0,0,0,10,0,0,0,10,10,10,0,10,0,0,1,1,0
"17000019",ESC,Centre públic Dep. i CEB,Escola Lluís Marià Vidal,Agullana,GIR,GIR,1,6,1,0,1,0,0,3,2,5,0,0,3,2,5,6,3,2,5,1,1,1,1,0
"17000032",ESC,Centre públic Dep. i CEB,Escola Vilademany,Aiguaviva,GIR,GIR,1,9,1,0,1,4,3,0,0,7,4,3,0,0,7,8,4,3,7,1,1,1,1,0
"17000056",ESC-ZER,Centre públic Dep. i CEB,Escola la Branca - ZER Montgrí,Albons,GIR,GIR,1,4,1,4,5,0,0,0,1,1,0,0,0,1,1,2,0,1,1,3,2,1,0,0
"17000068",ESC,Centre públic Dep. i CEB,Escola del Far d'Empordà,El Far d'Empordà,GIR,GIR,1,9,2,1,3,0,3,0,0,3,0,3,0,0,3,5,0,0,0,3,3,1,1,0
"17000071",ESC,Centre públic Dep. i CEB,Escola Bac de Cerdanya,Alp,GIR,APA,1,9,1,0,1,7,0,0,0,7,7,0,0,0,7,8,7,0,7,1,1,1,1,0
"17000093",ESC,Centre públic Dep. i CEB,Escola Gaspar de Queralt,Amer,GIR,GIR,1,11,0,0,0,9,1,0,0,10,9,1,0,0,10,10,4,1,5,0,0,1,1,0
"17000123",ESC,Centre públic Dep. i CEB,Escola Sant Jordi,Bonmatí (Sant Julià del Llor i Bonmatí),GIR,GIR,1,9,1,0,1,1,0,1,0,2,1,0,1,0,2,3,2,0,2,1,1,1,1,0
"17000135",ESC,Centre públic Dep. i CEB,Escola Pompeu Fabra,Anglès,GIR,GIR,1,17,0,0,0,6,18,0,0,24,6,11,0,0,17,17,0,6,6,0,0,1,1,0
"17000160",ESC,Centre públic Dep. i CEB,Escola Doctor Carulla,Arbúcies,GIR,GIR,1,19,0,3,3,19,0,2,2,23,19,0,0,0,19,19,19,0,19,0,0,1,1,0
"17000241",ESC,Centre públic Dep. i CEB,Escola Fluvianets,L'Armentera,GIR,GIR,1,9,2,1,3,0,0,0,2,2,0,0,0,2,2,4,0,2,2,3,3,1,1,0
"17000251",ESC,Centre públic Dep. i CEB,Escola Gonçal Comellas,Avinyonet de Puigventós,GIR,GIR,1,9,2,3,5,6,0,0,0,6,6,0,0,0,6,8,3,0,3,3,3,1,1,0
"17000263",ESC,Centre públic Dep. i CEB,Escola Doctor Arruga,Begur,GIR,GIR,1,9,0,0,0,9,0,0,0,9,9,0,0,0,9,9,5,0,5,0,0,1,1,0
"17000305",INS,Centre públic Dep. i CEB,Institut Pere Alsius i Torrent,Banyoles,GIR,GIR,1,37,1,0,1,20,0,0,0,20,20,0,0,0,20,21,0,0,0,1,1,1,1,0
"17000329",ESC,Centre públic Dep. i CEB,Escola Pla de l'Ametller,Banyoles,GIR,GIR,1,24,0,0,0,18,0,0,0,18,18,0,0,0,18,18,18,0,18,0,0,1,1,0
"17000330",INS,Centre públic Dep. i CEB,Institut Josep Brugulat,Banyoles,GIR,GIR,1,35,2,0,2,15,14,0,0,29,15,14,0,0,29,31,15,14,29,2,2,1,1,0
"17000342",ESC,Centre públic Dep. i CEB,Escola de la Vila Baldiri Reixac,Banyoles,GIR,GIR,1,19,0,0,0,21,0,0,0,21,19,0,0,0,19,19,19,0,19,0,0,1,1,0
"17000354",ESC,Centre públic Dep. i CEB,Escola Joan Reglà,Bàscara,GIR,GIR,1,9,1,1,2,7,0,0,0,7,7,0,0,0,7,8,0,0,0,2,2,1,1,0
"17000381",ESC-ZER,Centre públic Dep. i CEB,Escola El Rajaret - ZER Montgrí,Bellcaire d'Empordà,GIR,GIR,1,4,1,3,4,0,0,0,0,0,0,0,0,0,0,1,0,0,0,4,2,1,0,3
"17000408",ESC,Centre públic Dep. i CEB,Escola Doctor Sobrequés,Bescanó,GIR,GIR,1,23,1,0,1,22,1,0,0,23,22,0,0,0,22,23,5,1,6,1,1,1,1,0
"17000411",ESC,Centre públic Dep. i CEB,Escola Joan de Margarit,La Bisbal d'Empordà,GIR,GIR,1,16,0,1,1,11,1,0,0,12,11,1,0,0,12,12,4,0,4,1,1,1,1,0
"17000469",ESC,Centre públic Dep. i CEB,Escola Joaquim Ruyra,Blanes,GIR,GIR,1,9,0,0,0,9,0,0,0,9,9,0,0,0,9,9,4,0,4,0,0,1,1,0
"17000470",ESC,Centre públic Dep. i CEB,Escola Carles Faust,Blanes,GIR,GIR,1,9,1,2,3,8,0,0,0,8,8,0,0,0,8,9,8,0,8,1,1,1,1,0
"17000548",ESC,TANCA el curs 2023-24,Escola Mossèn Joan Batlle,Blanes,GIR,GIR,1,0,0,0,0,13,0,0,0,13,0,0,0,0,0,0,0,0,0,0,0,1,0,0
"17000551",INS,Centre públic Dep. i CEB,Institut Sa Palomera,Blanes,GIR,GIR,1,35,1,0,1,5,1,0,0,6,5,1,0,0,6,7,5,1,6,1,1,1,1,0
"17000561",ESC,Centre públic Dep. i CEB,Escola de Bordils,Bordils,GIR,GIR,1,11,0,0,0,0,5,0,5,10,0,5,0,5,10,10,0,0,0,0,0,1,1,0
"17000573",ESC,Centre públic Dep. i CEB,Escola Sant Andreu de Borrassà,Borrassà,GIR,GIR,1,9,2,2,4,0,2,0,0,2,0,2,0,0,2,4,0,2,2,4,3,1,1,0
"17000603",ESC-ZER,Centre públic Dep. i CEB,Escola Santa Cecília - ZER Les Salines,Boadella i les Escaules,GIR,GIR,1,1,1,0,1,0,0,1,1,2,0,0,0,0,0,1,0,0,0,1,1,1,0,0
"17000676",ESC,Centre públic Dep. i CEB,Escola Sant Esteve,Caldes de Malavella,GIR,GIR,1,19,0,4,4,15,0,0,0,15,15,0,0,0,15,15,2,0,2,4,4,1,1,0
"17000688",ESC,Centre públic Dep. i CEB,Escola Pere Rosselló,Calonge (Calonge i Sant Antoni),GIR,GIR,1,18,8,0,8,6,1,7,1,15,6,1,3,0,10,18,10,0,10,8,5,1,1,0
"17000706",INS,Centre públic Dep. i CEB,Institut Puig Cargol,Calonge (Calonge i Sant Antoni),GIR,GIR,1,24,2,0,2,0,0,19,0,19,0,0,19,0,19,21,19,0,19,2,2,1,1,0
"17000718",ESC,Centre públic Dep. i CEB,Escola Llevantí de Mar,Sant Antoni de Calonge (Calonge i Sant Antoni),GIR,GIR,1,9,0,1,1,9,0,0,0,9,9,0,0,0,9,9,9,0,9,0,0,1,1,0
"17000731",ESC,Centre públic Dep. i CEB,Escola Pirineu,Campdevànol,GIR,GIR,1,11,0,12,12,7,0,0,0,7,7,0,0,0,7,7,5,2,7,4,3,1,1,0
"17000779",ESC,Centre públic Dep. i CEB,Escola Doctor Robert,Camprodon,GIR,GIR,1,10,0,0,0,8,2,1,0,11,8,2,0,0,10,10,0,2,2,0,0,1,1,0
"17000822",ESC-ZER,Centre públic Dep. i CEB,Escola Els Dòlmens - ZER Requesens,Capmany,GIR,GIR,1,3,1,1,2,3,0,0,0,3,2,0,0,0,2,3,2,0,2,1,1,1,0,0
"17000846",ESC,Centre públic Dep. i CEB,Escola Puig d'Arques,Cassà de la Selva,GIR,GIR,1,19,1,0,1,18,1,0,0,19,18,0,0,0,18,19,10,0,10,1,1,1,1,0
"17000861",ESC,Centre públic Dep. i CEB,Escola Castellroc,Castellfollit de la Roca,GIR,GIR,1,10,1,1,2,3,0,0,0,3,3,0,0,0,3,4,2,0,2,2,2,1,1,0
"17000871",ESC,Centre públic Dep. i CEB,Escola Ruiz Amado,Castelló d'Empúries,GIR,GIR,1,18,0,0,0,18,0,0,0,18,18,0,0,0,18,18,10,0,10,0,0,1,1,0
"17000883",ESC,Centre públic Dep. i CEB,Escola Vall d'Aro,Castell d'Aro (Castell-Platja d'Aro),GIR,GIR,1,9,0,0,0,0,9,0,0,9,0,9,0,0,9,9,0,9,9,0,0,1,1,0
"17000895",ESC,Centre públic Dep. i CEB,Escola Els Estanys,Platja d'Aro (Castell-Platja d'Aro),GIR,GIR,1,18,8,8,16,16,1,0,0,17,10,0,0,0,10,18,10,0,10,8,5,1,1,0
"17000913",ESC,Centre públic Dep. i CEB,Escola L'Aulet,Celrà,GIR,GIR,1,13,0,0,0,0,14,0,0,14,0,13,0,0,13,13,0,5,5,0,0,1,1,0
"17000925",ESC,Centre públic Dep. i CEB,Escola L'Aixart,Cervià de Ter,GIR,GIR,1,9,1,0,1,1,2,3,0,6,1,2,3,0,6,7,3,0,3,1,1,1,1,0
"17000937",ESC-ZER,Centre públic Dep. i CEB,Escola Mossèn Josep Maria Albert - ZER Empordà,Cistella,GIR,GIR,1,2,1,0,1,0,0,0,1,1,0,0,0,1,1,2,0,0,0,1,1,1,0,0
"17000950",ESC-ZER,Centre públic Dep. i CEB,Escola Puig d'Esquers - ZER Cap de Creus,Colera,GIR,GIR,1,1,1,0,1,0,0,0,2,2,0,0,0,0,0,1,0,0,0,1,1,1,0,0
"17000986",ESC,Centre públic Dep. i CEB,Escola La Vall del Terri,Cornellà del Terri,GIR,GIR,1,13,1,0,1,13,1,0,0,14,12,0,0,0,12,13,12,0,12,1,1,1,1,0
"17000998",ESC,Centre públic Dep. i CEB,Escola El Rodonell,Corçà,GIR,GIR,1,9,1,0,1,5,0,0,0,5,5,0,0,0,5,6,0,0,0,1,1,1,1,0
"17001024",ESC-ZER,Centre públic Dep. i CEB,Escola Les Gavarres - ZER Empordanet-Gavarres,"Cruïlles (Cruïlles, Monells i Sant Sadurní l'Heura)",GIR,GIR,1,4,1,1,2,0,0,0,0,0,0,0,0,0,0,1,0,0,0,2,2,1,0,3
"17001036",ESC-ZER,Centre públic Dep. i CEB,Escola Mont-roig - ZER Requesens,Darnius,GIR,GIR,1,3,2,0,2,1,0,0,0,1,1,0,0,0,1,3,0,0,0,2,1,1,0,0
"17001048",ESC,Centre públic Dep. i CEB,Escola Empúries,L'Escala,GIR,GIR,1,23,0,0,0,0,3,23,0,26,0,3,20,0,23,23,23,0,23,0,0,1,1,0
"17001085",ESC-ZER,Centre públic Dep. i CEB,Escola Antoni Balmanya - ZER Requesens,Espolla,GIR,GIR,1,1,1,0,1,0,0,0,0,0,0,0,0,0,0,1,0,0,0,1,1,1,0,0
"17001097",ESC,Centre públic Dep. i CEB,Escola Carles de Fortuny,Esponellà,GIR,GIR,1,9,1,0,1,1,0,4,0,5,1,0,4,0,5,6,0,0,0,1,1,1,1,0
"17001103",ESC,Centre públic Dep. i CEB,Escola Salvador Dalí,Figueres,GIR,GIR,1,18,0,0,0,18,0,0,2,20,18,0,0,0,18,18,8,2,10,0,0,1,1,0
"17001115",ESC,TANCA el curs 2023-24,Escola Josep Pous i Pagès,Figueres,GIR,GIR,1,0,1,2,3,3,8,0,0,11,0,0,0,0,0,1,0,0,0,1,0,1,0,0
"17001164",ESC,Concertada 30% NESE,Cor de Maria,Figueres,GIR,GIR,0,9,0,0,0,0,0,0,0,0,9,0,0,0,9,9,0,0,0,0,0,0,1,0
"17001218",INS,Centre públic Dep. i CEB,Institut Ramon Muntaner,Figueres,GIR,GIR,1,28,0,2,2,0,5,0,0,5,0,5,0,0,5,5,0,5,5,2,2,1,1,0
"17001221",INS,Centre públic Dep. i CEB,Institut Narcís Monturiol,Figueres,GIR,GIR,1,35,0,0,0,37,0,0,0,37,35,0,0,0,35,35,0,0,0,0,0,1,1,0
"17001279",ESC,Centre públic Dep. i CEB,Escola Sant Pau,Figueres,GIR,GIR,1,18,0,0,0,13,1,3,1,18,13,1,3,1,18,18,16,2,18,0,0,1,1,0
"17001280",ESC,Centre públic Dep. i CEB,Escola Joaquim Cusí i Furtunet,Figueres,GIR,GIR,1,18,1,8,9,5,1,7,2,15,5,1,7,2,15,16,6,3,9,3,3,1,1,0
"17001292",ESC,Centre públic Dep. i CEB,Escola Les Moreres,Flaçà,GIR,GIR,1,9,1,0,1,6,0,0,2,8,6,0,0,2,8,9,6,2,8,1,1,1,1,0
"17001346",ESC,Centre públic Dep. i CEB,Escola Forn d'Anells,Fornells de la Selva,GIR,GIR,1,16,0,0,0,10,6,0,0,16,10,6,0,0,16,16,10,6,16,0,0,1,1,0
"17001361",ESC,Centre públic Dep. i CEB,Escola Teresa de Pallejà,Fortià,GIR,GIR,1,9,1,0,1,5,0,0,0,5,5,0,0,0,5,6,2,0,2,1,1,1,1,0
"17001371",ESC-ZER,Centre públic Dep. i CEB,Escola de Garrigàs - ZER Empordà,Garrigàs,GIR,GIR,1,2,2,1,3,1,0,0,0,1,0,0,0,0,0,2,0,0,0,2,1,1,0,0
"17001383",ESC,Centre públic Dep. i CEB,Escola Joaquim Gifre,Garriguella,GIR,GIR,1,9,2,4,6,3,1,0,0,4,3,1,0,0,4,6,3,0,3,5,3,1,1,0
"17001395",ESC-ZER,Centre públic Dep. i CEB,Escola Santa Coloma - ZER Cerdanya,Ger,GIR,APA,1,7,1,0,1,0,2,0,1,3,0,2,0,1,3,4,0,3,3,1,1,1,0,0
"17001425",ESC,Centre públic Dep. i CEB,Escola Eiximenis,Girona,GIR,GIR,1,9,0,0,0,0,9,0,0,9,0,9,0,0,9,9,0,9,9,0,0,1,1,0
"17001449",ESC,Centre públic Dep. i CEB,Escola Annexa - Joan Puigbert,Girona,GIR,GIR,1,34,0,0,0,14,2,1,0,17,14,2,1,0,17,17,15,2,17,0,0,1,1,0
"17001450",ESC,Centre públic Dep. i CEB,Escola Joan Bruguera,Girona,GIR,GIR,1,9,0,0,0,8,1,0,0,9,8,1,0,0,9,9,8,1,9,0,0,1,1,0
"17001462",ESC,Centre públic Dep. i CEB,Escola Verd,Girona,GIR,GIR,1,9,0,0,0,5,4,0,0,9,5,4,0,0,9,9,5,4,9,0,0,1,1,0
"17001486",ESC,Centre públic Dep. i CEB,Escola Montjuïc,Girona,GIR,GIR,1,9,0,0,0,9,0,0,0,9,9,0,0,0,9,9,9,0,9,0,0,1,1,0
"17001516",ESC,Centre públic Dep. i CEB,Escola Pla de Girona,Girona,GIR,GIR,1,39,1,1,2,15,0,0,1,16,15,0,0,1,16,17,15,1,16,2,2,1,1,0
"17001693",EE,Centre públic Dep. i CEB,CEE Font de l'Abella,Girona,GIR,GIR,1,15,11,0,11,1,0,15,0,16,1,0,3,0,4,15,0,0,0,11,4,1,1,0
"17001723",INS,Centre públic Dep. i CEB,Institut Jaume Vicens Vives,Girona,GIR,GIR,1,33,0,0,0,16,0,0,1,17,16,0,0,1,17,17,0,0,0,0,0,1,1,0
"17001735",INS,Centre públic Dep. i CEB,Institut Montilivi,Girona,GIR,GIR,1,55,1,0,1,1,0,0,0,1,1,0,0,0,1,2,0,0,0,1,1,1,1,0
"17001759",FP,Centre públic Dep. i CEB,Institut Escola d'Hostaleria i Turisme de Girona,Girona,GIR,GIR,1,19,0,0,0,8,4,4,0,16,8,4,4,0,16,16,12,4,16,0,0,1,1,0
"17001838",ESC,Centre públic Dep. i CEB,Escola Àgora,Girona,GIR,GIR,1,9,0,0,0,4,9,0,0,13,4,5,0,0,9,9,4,5,9,0,0,1,1,0
"17001887",ESC,Centre públic Dep. i CEB,Escola Carme Auguet,Girona,GIR,GIR,1,9,2,0,2,8,0,0,0,8,7,0,0,0,7,9,4,0,4,2,2,1,1,0
"17001905",ESC,Concertada 30% NESE,FEDAC - Pont Major,El Pont Major (Girona),GIR,GIR,0,9,0,0,0,0,0,0,0,0,9,0,0,0,9,9,0,0,0,0,0,0,1,0
"17001930",ESC,Centre públic Dep. i CEB,Escola Josep Dalmau i Carles,Girona,GIR,GIR,1,17,1,0,1,18,0,0,0,18,16,0,0,0,16,17,10,0,10,1,1,1,1,0
"17001942",ESC,Concertada 30% NESE,Sagrada Família,Vila-roja (Girona),GIR,GIR,0,9,0,0,0,0,0,0,0,0,9,0,0,0,9,9,0,0,0,0,0,0,1,0
"17001954",ESC,Centre públic Dep. i CEB,Escola de Vila-roja,Vila-roja (Girona),GIR,GIR,1,6,3,0,3,6,1,0,0,7,3,0,0,0,3,6,3,0,3,3,2,1,1,0
"17001981",ESC,Centre públic Dep. i CEB,Escola Mare de Déu dels Socors,Hostalric,GIR,GIR,1,21,1,0,1,28,0,0,0,28,20,0,0,0,20,21,20,0,20,1,1,1,1,0
"17002004",ESC,Centre públic Dep. i CEB,Escola Josep Peñuelas del Rio,La Jonquera,GIR,GIR,1,18,0,0,0,12,6,0,0,18,12,6,0,0,18,18,12,6,18,0,0,1,1,0
"17002028",ESC,Centre públic Dep. i CEB,Escola Montserrat Vayreda i Trullol,Lladó,GIR,GIR,1,9,2,0,2,0,0,3,1,4,0,0,3,1,4,6,3,1,4,2,2,1,1,0
"17002031",ESC,Centre públic Dep. i CEB,Escola Lacustària,Llagostera,GIR,GIR,1,19,4,0,4,14,0,0,0,14,14,0,0,0,14,18,0,0,0,4,4,1,1,0
"17002065",ESC-ZER,Centre públic Dep. i CEB,Escola Les Moreres - ZER Vall de Ter,Llanars,GIR,GIR,1,2,1,0,1,1,0,0,0,1,1,0,0,0,1,2,1,0,1,1,1,1,0,0
"17002077",ESC,Centre públic Dep. i CEB,Escola Pompeu Fabra,Llançà,GIR,GIR,1,18,1,1,2,18,1,1,0,20,17,0,0,0,17,18,17,0,17,1,1,1,1,0
"17002089",ESC,Centre públic Dep. i CEB,Escola de Llers,Llers,GIR,GIR,1,9,1,0,1,0,0,9,0,9,0,0,8,0,8,9,5,0,5,1,1,1,1,0
"17002090",ESC-ZER,Centre públic Dep. i CEB,Escola Jaume I - ZER Cerdanya,Llívia,GIR,APA,1,7,2,3,5,2,0,0,1,3,2,0,0,1,3,5,2,0,2,4,2,1,0,0
"17002107",ESC,Centre públic Dep. i CEB,Escola Pere Torrent,Lloret de Mar,GIR,GIR,1,25,1,10,11,0,4,7,6,17,0,4,7,6,17,18,7,10,17,8,7,1,1,0
"17002168",ESC-ZER,Centre públic Dep. i CEB,Escola Les Salines - ZER Les Salines,Maçanet de Cabrenys,GIR,GIR,1,3,1,0,1,1,0,2,1,4,1,0,1,0,2,3,2,0,2,1,1,1,0,0
"17002181",ESC,Centre públic Dep. i CEB,Escola Sant Jordi,Maçanet de la Selva,GIR,GIR,1,18,9,0,9,0,0,0,0,0,0,0,0,0,0,9,0,0,0,9,5,1,1,9
"17002193",ESC,Centre públic Dep. i CEB,Escola Santa Fe,Sant Julià de Ramis,GIR,GIR,1,9,1,0,1,6,0,1,0,7,6,0,1,0,7,8,7,0,7,1,1,1,1,0
"17002201",ESC,Centre públic Dep. i CEB,Escola Finestres,Mieres,GIR,GIR,1,9,1,0,1,1,0,0,0,1,1,0,0,0,1,2,0,0,0,1,1,1,1,0
"17002247",ESC-ZER,Centre públic Dep. i CEB,Escola Mont Cós - ZER El Llierca,Montagut (Montagut i Oix),GIR,GIR,1,4,1,2,3,0,1,2,0,3,0,1,2,0,3,4,0,0,0,1,1,1,0,0
"17002259",ESC,Centre públic Dep. i CEB,Escola Torres Jonama,Mont-ras,GIR,GIR,1,9,0,3,3,8,1,0,0,9,8,1,0,0,9,9,3,1,4,0,0,1,1,0
"17002260",ESC,Centre públic Dep. i CEB,Escola Joaquim Vallmajó,Navata,GIR,GIR,1,9,1,0,1,0,0,0,1,1,0,0,0,1,1,2,0,0,0,1,1,1,1,0
"17002296",ESC,Centre públic Dep. i CEB,Escola Malagrida,Olot,GIR,GIR,1,19,0,0,0,18,0,0,0,18,18,0,0,0,18,18,10,0,10,0,0,1,1,0
"17002314",ESC,Centre públic Dep. i CEB,Escola Pla de Dalt,Olot,GIR,GIR,1,18,0,0,0,4,2,0,0,6,4,2,0,0,6,6,4,2,6,0,0,1,1,0
"17002326",ESC,Centre públic Dep. i CEB,Escola Volcà Bisaroques,Olot,GIR,GIR,1,18,0,0,0,16,2,0,0,18,16,2,0,0,18,18,16,2,18,0,0,1,1,0
"17002387",INS,Centre públic Dep. i CEB,Institut Montsacopa,Olot,GIR,GIR,1,34,0,0,0,22,3,0,0,25,22,3,0,0,25,25,0,0,0,0,0,1,1,0
"17002399",INS,Centre públic Dep. i CEB,Institut La Garrotxa,Olot,GIR,GIR,1,46,0,0,0,40,3,0,0,43,40,3,0,0,43,43,12,0,12,0,0,1,1,0
"17002429",ESC,Centre públic Dep. i CEB,Escola Sant Roc,Olot,GIR,GIR,1,19,0,1,1,20,0,0,0,20,19,0,0,0,19,19,19,0,19,0,0,1,1,0
"17002430",ESC,Centre públic Dep. i CEB,Escola Maria Pagès i Trayter,Ordis,GIR,GIR,1,9,1,0,1,2,0,1,0,3,2,0,1,0,3,4,3,0,3,1,1,1,1,0
"17002442",ESC,Centre públic Dep. i CEB,Escola La Vall,Osor,GIR,GIR,1,9,2,1,3,0,0,0,0,0,0,0,0,0,0,2,0,0,0,3,3,1,1,7
"17002481",ESC,Centre públic Dep. i CEB,Escola Torres Jonama,Palafrugell,GIR,GIR,1,18,15,1,16,0,1,3,0,4,0,1,2,0,3,18,3,0,3,15,5,1,1,0
"17002491",ESC,Centre públic Dep. i CEB,Escola Josep Barceló i Matas,Palafrugell,GIR,GIR,1,16,1,6,7,15,2,0,0,17,15,0,0,0,15,16,15,0,15,1,1,1,1,0
"17002545",INS,Centre públic Dep. i CEB,Institut Frederic Martí i Carreras,Palafrugell,GIR,GIR,1,27,0,0,0,24,0,0,0,24,24,0,0,0,24,24,0,0,0,0,0,1,1,0
"17002557",INS,Centre públic Dep. i CEB,Institut Baix Empordà,Palafrugell,GIR,GIR,1,51,1,1,2,15,6,12,0,33,15,6,12,0,33,34,0,0,0,2,2,1,1,0
"17002569",ESC,Centre públic Dep. i CEB,Escola La Vila,Palamós,GIR,GIR,1,17,0,0,0,25,3,0,0,28,17,0,0,0,17,17,17,0,17,0,0,1,1,0
"17002624",ESC,Centre públic Dep. i CEB,Escola Martí Inglès,Palau-saverdera,GIR,GIR,1,9,1,3,4,3,2,0,0,5,3,2,0,0,5,6,2,2,4,4,3,1,1,0
"17002651",ESC,Centre públic Dep. i CEB,Escola Quermany,Pals,GIR,GIR,1,9,0,0,0,7,2,0,0,9,7,2,0,0,9,9,7,2,9,0,0,1,1,0
"17002703",ESC,Centre públic Dep. i CEB,Escola Pau,Pau,GIR,GIR,1,9,1,3,4,1,0,0,0,1,1,0,0,0,1,2,0,0,0,4,3,1,1,0
"17002715",ESC-ZER,Centre públic Dep. i CEB,Escola Pedra Blanca - ZER Empordanet-Gavarres,La Pera,GIR,GIR,1,3,1,0,1,2,0,0,0,2,2,0,0,0,2,3,2,0,2,1,1,1,0,0
"17002740",ESC,Centre públic Dep. i CEB,Escola Ramon Muntaner,Peralada,GIR,GIR,1,10,2,0,2,9,0,0,0,9,8,0,0,0,8,10,8,0,8,2,2,1,1,0
"17002752",ESC,Centre públic Dep. i CEB,Escola Sant Cristòfol,Les Planes d'Hostoles,GIR,GIR,1,10,1,0,1,8,2,0,0,10,8,1,0,0,9,10,8,1,9,1,1,1,1,0
"17002764",ESC-ZER,Centre públic Dep. i CEB,Escola Núria Morer i Pi - ZER Comte Arnau,Planoles,GIR,GIR,1,2,1,0,1,3,0,0,0,3,1,0,0,0,1,2,0,0,0,1,1,1,0,0
"17002776",ESC-ZER,Centre públic Dep. i CEB,Escola Tramuntana - ZER Empordà,Pont de Molins,GIR,GIR,1,2,1,0,1,1,0,2,0,3,1,0,0,0,1,2,1,0,1,1,1,1,0,0
"17002791",ESC,Centre públic Dep. i CEB,Escola L'Entorn,Porqueres,GIR,GIR,1,18,0,0,0,18,0,0,0,18,18,0,0,0,18,18,18,0,18,0,0,1,1,0
"17002818",ESC,Centre públic Dep. i CEB,Escola Frigolet,Porqueres,GIR,GIR,1,9,1,0,1,0,0,0,0,0,0,0,0,0,0,1,0,0,0,1,1,1,1,8
"17002831",ESC,Centre públic Dep. i CEB,Escola Sant Jaume,Portbou,GIR,GIR,1,9,1,0,1,0,0,3,0,3,0,0,3,0,3,4,0,0,0,1,1,1,1,0
"17002879",ESC-ZER,Centre públic Dep. i CEB,Escola Les Clisques - ZER Cap de Creus,El Port de la Selva,GIR,GIR,1,5,1,0,1,2,2,2,2,8,2,2,0,0,4,5,0,2,2,1,1,1,0,0
"17002880",ESC,Centre públic Dep. i CEB,Escola Alfons I,Puigcerdà,GIR,APA,1,18,0,1,1,16,0,0,0,16,16,0,0,0,16,16,16,0,16,1,1,1,1,0
"17002922",ESC,Centre públic Dep. i CEB,Escola Santa Margarida,Quart,GIR,GIR,1,11,0,0,0,11,0,0,0,11,11,0,0,0,11,11,11,0,11,0,0,1,1,0
"17002983",ESC,Centre públic Dep. i CEB,Escola El Bruc,Riells i Viabrea,GIR,GIR,1,9,0,0,0,0,9,0,0,9,0,9,0,0,9,9,0,5,5,0,0,1,1,0
"17002995",ESC,Centre públic Dep. i CEB,Escola Joan Maragall,Ripoll,GIR,GIR,1,13,0,0,0,12,0,0,0,12,12,0,0,0,12,12,12,0,12,0,0,1,1,0
"17003070",ESC,Centre públic Dep. i CEB,Escola Josep Boada,Riudarenes,GIR,GIR,1,10,1,0,1,0,0,0,0,0,0,0,0,0,0,1,0,0,0,1,1,1,1,9
"17003082",ESC,Centre públic Dep. i CEB,Escola Lluís Castells,Riudaura,GIR,GIR,1,9,1,0,1,1,7,0,0,8,1,7,0,0,8,9,1,7,8,1,1,1,1,0
"17003094",ESC,Centre públic Dep. i CEB,Escola de Riudellots de la Selva,Riudellots de la Selva,GIR,GIR,1,10,0,1,1,5,0,0,0,5,5,0,0,0,5,5,5,0,5,1,1,1,1,0
"17003136",ESC,Centre públic Dep. i CEB,Escola Narcís Monturiol,Roses,GIR,GIR,1,10,0,0,0,9,1,0,0,10,9,1,0,0,10,10,9,1,10,0,0,1,1,0
"17003151",ESC,Centre públic Dep. i CEB,Escola Silvestre Santaló,Salt,GIR,GIR,1,12,1,0,1,9,0,0,0,9,9,0,0,0,9,10,9,0,9,1,1,1,1,0
"17003203",INS,Centre públic Dep. i CEB,Institut Salvador Espriu,Salt,GIR,GIR,1,34,1,0,1,31,0,0,0,31,31,0,0,0,31,32,0,0,0,1,1,1,1,0
"17003215",ESC,Centre públic Dep. i CEB,Escola La Farga,Salt,GIR,GIR,1,19,1,0,1,16,2,0,0,18,16,2,0,0,18,19,16,2,18,1,1,1,1,0
"17003227",ESC-ZER,Centre públic Dep. i CEB,Escola Sant Sebastià - ZER Requesens,Sant Climent Sescebes,GIR,GIR,1,3,1,3,4,3,0,0,0,3,2,0,0,0,2,3,2,0,2,1,1,1,0,0
"17003264",ESC,Centre públic Dep. i CEB,Escola Gaziel,Sant Feliu de Guíxols,GIR,GIR,1,16,0,10,10,0,0,10,0,10,0,0,10,0,10,10,0,0,0,6,5,1,1,0
"17003306",INS,Centre públic Dep. i CEB,Institut Sant Elm,Sant Feliu de Guíxols,GIR,GIR,1,19,0,0,0,18,0,0,0,18,18,0,0,0,18,18,0,0,0,0,0,1,1,0
"17003318",INS,Centre públic Dep. i CEB,Institut de Sant Feliu de Guíxols,Sant Feliu de Guíxols,GIR,GIR,1,51,1,0,1,37,0,0,0,37,37,0,0,0,37,38,0,0,0,1,1,1,1,0
"17003321",ESC,Centre públic Dep. i CEB,Escola Mossèn Baldiri Reixach,Sant Feliu de Guíxols,GIR,GIR,1,18,4,0,4,0,12,2,3,17,0,12,2,0,14,18,0,0,0,4,4,1,1,0
"17003343",ESC,Centre públic Dep. i CEB,Escola Rocalba,Sant Feliu de Pallerols,GIR,GIR,1,9,1,1,2,3,0,4,1,8,3,0,4,1,8,9,7,1,8,1,1,1,1,0
"17003392",ESC,Centre públic Dep. i CEB,Escola Agustí Gifre,Sant Gregori,GIR,GIR,1,34,0,0,0,23,23,0,0,46,23,11,0,0,34,34,0,0,0,0,0,1,1,0
"17003422",ESC,Centre públic Dep. i CEB,Escola Taialà,Domeny (Girona),GIR,GIR,1,19,0,0,0,19,2,0,0,21,19,0,0,0,19,19,19,0,19,0,0,1,1,0
"17003434",ESC,Centre públic Dep. i CEB,Escola Guilleries,Sant Hilari Sacalm,GIR,GIR,1,17,0,0,0,13,4,0,0,17,13,4,0,0,17,17,13,4,17,0,0,1,1,0
"17003446",IE,Concertada que passa a pública,Sant Josep,Sant Hilari Sacalm,GIR,GIR,0,9,0,0,0,0,0,0,0,0,0,0,0,0,0,0,0,0,0,0,0,0,0,9
"17003461",ESC,Centre públic Dep. i CEB,Escola Les Escomes,Sant Jaume de Llierca,GIR,GIR,1,9,3,2,5,5,0,0,0,5,5,0,0,0,5,8,5,0,5,4,3,1,1,0
"17003471",ESC,Centre públic Dep. i CEB,Escola Sant Jordi,Sant Jordi Desvalls,GIR,GIR,1,9,2,0,2,4,0,1,0,5,4,0,1,0,5,7,2,0,2,2,2,1,1,0
"17003537",ESC-ZER,Centre públic Dep. i CEB,Escola de Vallfogona de Ripollès - ZER Comte Arnau,Vallfogona de Ripollès,GIR,GIR,1,1,1,0,1,0,0,0,0,0,0,0,1,0,1,2,0,0,0,0,0,1,1,0
"17003598",ESC,Centre públic Dep. i CEB,Escola Vallgarriga,Sant Miquel de Fluvià,GIR,GIR,1,9,1,0,1,0,4,0,0,4,0,4,0,0,4,5,0,4,4,1,1,1,1,0
"17003616",ESC-ZER,Centre públic Dep. i CEB,Escola Els Pinets - ZER Vall de Ter,Sant Pau de Segúries,GIR,GIR,1,4,1,0,1,0,0,3,0,3,0,0,3,0,3,4,3,0,3,1,1,1,0,0
"17003628",ESC,Centre públic Dep. i CEB,Escola Llagut,Sant Pere Pescador,GIR,GIR,1,13,2,0,2,8,0,0,0,8,8,0,0,0,8,10,8,0,8,2,2,1,1,0
"17003631",ESC-ZER,Centre públic Dep. i CEB,Escola La Pedra Dreta - ZER Empordanet-Gavarres,"Sant Sadurní de l'Heura (Cruïlles, Monells i Sant Sadurní l'Heura)",GIR,GIR,1,3,1,0,1,1,0,0,0,1,1,0,0,0,1,2,1,0,1,1,1,1,0,0
"17003641",ESC,Centre públic Dep. i CEB,Escola Sant Salvador d'Horta,Santa Coloma de Farners,GIR,GIR,1,20,2,0,2,20,0,0,0,20,18,0,0,0,18,20,0,0,0,2,2,1,1,0
"17003689",ESC,Centre públic Dep. i CEB,Escola Pedralta,Santa Cristina d'Aro,GIR,GIR,1,18,0,5,5,0,0,5,0,5,0,0,5,0,5,5,0,0,0,5,5,1,1,0
"17003719",ESC,Centre públic Dep. i CEB,Escola Joan Maragall,Santa Pau,GIR,GIR,1,10,1,2,3,2,0,0,2,4,2,0,0,2,4,5,1,0,1,3,3,1,1,0
"17003732",ESC,Centre públic Dep. i CEB,Escola Castanyer,Sant Joan les Fonts,GIR,GIR,1,13,1,2,3,8,0,0,0,8,8,0,0,0,8,9,8,0,8,3,3,1,1,0
"17003756",ESC,Centre públic Dep. i CEB,Escola Montserrat,Sarrià de Ter,GIR,GIR,1,19,1,1,2,0,2,0,0,2,0,2,0,0,2,3,0,0,0,2,2,1,1,0
"17003768",ESC,Centre públic Dep. i CEB,Escola Els Terraprims,"Camallera (Saus, Camallera i Llampaies)",GIR,GIR,1,9,1,0,1,6,0,0,0,6,6,0,0,0,6,7,6,0,6,1,1,1,1,0
"17003781",ESC,Centre públic Dep. i CEB,Escola Juncadella,La Cellera de Ter,GIR,GIR,1,10,0,0,0,8,3,0,0,11,8,2,0,0,10,10,2,1,3,0,0,1,1,0
"17003801",ESC,Centre públic Dep. i CEB,Escola Bora Gran,Serinyà,GIR,GIR,1,9,1,0,1,0,2,0,0,2,0,2,0,0,2,3,0,2,2,1,1,1,1,0
"17003823",ESC,Centre públic Dep. i CEB,Escola Verdaguer,Sils,GIR,GIR,1,18,0,0,0,14,2,2,0,18,14,2,2,0,18,18,16,2,18,0,0,1,1,0
"17003860",ESC,Centre públic Dep. i CEB,Escola Portitxol,L'Estartit (Torroella de Montgrí),GIR,GIR,1,14,1,4,5,13,2,0,0,15,13,0,0,0,13,14,13,0,13,1,1,1,1,0
"17003872",ESC,Centre públic Dep. i CEB,Escola Guillem de Montgrí,Torroella de Montgrí,GIR,GIR,1,28,1,0,1,23,3,0,0,26,23,3,0,0,26,27,23,3,26,1,1,1,1,0
"17003902",ESC-ZER,Centre públic Dep. i CEB,Escola Joan Roura i Parella - ZER El Llierca,Tortellà,GIR,GIR,1,4,1,0,1,0,5,0,0,5,0,3,0,0,3,4,0,3,3,1,1,1,0,0
"17003926",ESC,Centre públic Dep. i CEB,Escola Ignasi Melé i Farré,Tossa de Mar,GIR,GIR,1,19,0,9,9,11,0,0,0,11,11,0,0,0,11,11,11,0,11,8,5,1,1,0
"17003938",ESC-ZER,Centre públic Dep. i CEB,Escola Puig Rodó - ZER Montgrí,Ullà,GIR,GIR,1,6,1,0,1,0,3,0,2,5,0,3,0,2,5,6,0,5,5,1,1,1,0,0
"17003941",ESC-ZER,Centre públic Dep. i CEB,Escola L'Estany - ZER Empordanet-Gavarres,Ullastret,GIR,GIR,1,3,1,0,1,0,0,0,1,1,0,0,0,1,1,2,0,1,1,1,1,1,0,0
"17004001",ESC,Centre públic Dep. i CEB,Escola Verntallat,El Mallol (La Vall d'en Bas),GIR,GIR,1,13,0,0,0,12,1,0,0,13,12,1,0,0,13,13,6,1,7,0,0,1,1,0
"17004049",ESC-ZER,Centre públic Dep. i CEB,Escola Oliveres Mil·lenàries - ZER Tramuntana,Ventalló,GIR,GIR,1,4,1,1,2,0,3,0,0,3,0,3,0,0,3,4,0,3,3,1,1,1,0,0
"17004062",ESC-ZER,Centre públic Dep. i CEB,Escola Santa Bàrbara - ZER Els Castells,Vidrà,CCE,CCE,1,2,0,0,0,3,0,0,0,3,2,0,0,0,2,2,2,0,2,0,0,1,0,0
"17004074",ESC,Centre públic Dep. i CEB,Escola Sant Iscle,Vidreres,GIR,GIR,1,11,0,0,0,11,0,2,0,13,11,0,0,0,11,11,11,0,11,0,0,1,1,0
"17004098",ESC,Centre públic Dep. i CEB,Escola Torre d'en Reig,Vilabertran,GIR,GIR,1,9,1,0,1,9,0,0,0,9,8,0,0,0,8,9,0,0,0,1,1,1,1,0
"17004116",ESC,Centre públic Dep. i CEB,Escola Madrenc,Vilablareix,GIR,GIR,1,18,2,2,4,0,15,0,0,15,0,15,0,0,15,17,0,15,15,3,3,1,1,0
"17004128",ESC-ZER,Centre públic Dep. i CEB,Escola Puig Segalar - ZER Tramuntana,Viladamat,GIR,GIR,1,3,1,2,3,0,0,0,1,1,0,0,0,1,1,2,0,1,1,2,1,1,0,0
"17004153",ESC,Centre públic Dep. i CEB,Escola de Sant Esteve de Guialbes,Sant Esteve de Guialbes (Vilademuls),GIR,GIR,1,9,2,0,2,0,0,4,0,4,0,0,4,0,4,6,4,0,4,2,2,1,1,0
"17004189",ESC-ZER,Centre públic Dep. i CEB,Escola Els Castanyers - ZER Guilleries,Viladrau,CCE,CCE,1,7,2,0,2,0,1,0,2,3,0,1,0,2,3,5,0,3,3,2,2,1,0,0
"17004190",ESC,Centre públic Dep. i CEB,Escola Sol i Vent,Vilafant,GIR,GIR,1,9,0,3,3,3,1,0,0,4,3,1,0,0,4,4,3,0,3,3,3,1,1,0
"17004207",ESC,Centre públic Dep. i CEB,Escola Santiago Ratés,Vilajuïga,GIR,GIR,1,9,1,0,1,3,0,0,0,3,3,0,0,0,3,4,3,0,3,1,1,1,1,0
"17004219",ESC-ZER,Centre públic Dep. i CEB,Escola La Daina - ZER Vall de Ter,Vilallonga de Ter,GIR,GIR,1,2,1,0,1,0,0,0,0,0,0,0,0,0,0,1,0,0,0,1,1,1,0,1
"17004220",ESC-ZER,Centre públic Dep. i CEB,Escola Els Valentins - ZER Tramuntana,Vilamacolum,GIR,GIR,1,3,1,1,2,1,1,0,0,2,1,1,0,0,2,3,0,0,0,1,1,1,0,0
"17004232",ESC,Centre públic Dep. i CEB,Escola Josep de Ribot i Olivas,Vilamalla,GIR,GIR,1,9,1,3,4,6,0,3,0,9,6,0,2,0,8,9,8,0,8,1,1,1,1,0
"17004244",ESC-ZER,Centre públic Dep. i CEB,Escola Tramuntana - ZER Empordà,Vilanant,GIR,GIR,1,3,2,1,3,0,0,2,0,2,0,0,1,0,1,3,0,0,0,2,1,1,0,0
"17004281",ESC,Centre públic Dep. i CEB,Escola Josep Madrenys,Vilobí d'Onyar,GIR,GIR,1,16,0,0,0,13,3,0,0,16,13,3,0,0,16,16,13,3,16,0,0,1,1,0
"17004293",ESC-ZER,Centre públic Dep. i CEB,Escola Manuel de Pedrolo - ZER Les Salines,Biure,GIR,GIR,1,2,1,0,1,0,0,3,0,3,0,0,1,0,1,2,0,0,0,1,1,1,0,0
"17004335",ESC,Centre públic Dep. i CEB,Escola Santa Eugènia,Girona,GIR,GIR,1,9,1,0,1,4,5,0,0,9,4,4,0,0,8,9,4,4,8,1,1,1,1,0
"17004347",ESC,Centre públic Dep. i CEB,Escola Font de la Pólvora,Vila-roja (Girona),GIR,GIR,1,3,1,0,1,2,0,0,0,2,2,0,0,0,2,3,2,0,2,1,1,1,1,0
"17004360",EE,Centre públic Dep. i CEB,CEE La Maçana,Salt,GIR,GIR,1,1,2,0,2,1,0,0,0,1,0,0,0,0,0,2,0,0,0,1,1,1,1,0
"17004438",INS,Centre públic Dep. i CEB,Institut Alexandre Deulofeu,Figueres,GIR,GIR,1,29,0,0,0,28,0,0,0,28,28,0,0,0,28,28,28,0,28,0,0,1,1,0
"17004441",EE,EE Privats,Joan XXIII,Olot,GIR,GIR,0,1,0,0,0,0,0,0,0,0,2,0,0,0,2,2,0,0,0,0,0,0,1,0
"17004451",ESC,Centre públic Dep. i CEB,Escola Jaume Vicens i Vives,Roses,GIR,GIR,1,15,1,5,6,15,0,0,0,15,14,0,0,0,14,15,14,0,14,1,1,1,1,0
"17004463",ESC,Centre públic Dep. i CEB,Escola Anicet de Pagès i de Puig,Figueres,GIR,GIR,1,18,2,0,2,6,5,0,0,11,6,5,0,0,11,13,6,5,11,2,2,1,1,0
"17004487",INS,Centre públic Dep. i CEB,Institut Rafael Campalans,Anglès,GIR,GIR,1,20,21,20,41,7,1,0,0,8,0,0,0,0,0,21,0,0,0,20,6,1,1,0
"17004499",INS,Centre públic Dep. i CEB,Institut Narcís Xifra i Masmitjà,Girona,GIR,GIR,1,49,0,0,0,47,0,0,0,47,47,0,0,0,47,47,47,0,47,0,0,1,1,0
"17004517",INS,Centre públic Dep. i CEB,Institut Anton Busquets i Punset,Sant Hilari Sacalm,GIR,GIR,1,14,0,0,0,20,1,0,0,21,14,0,0,0,14,14,14,0,14,0,0,1,1,0
"17004529",ESC,Centre públic Dep. i CEB,Escola Migdia,Girona,GIR,GIR,1,18,3,2,5,19,4,0,0,23,15,0,0,0,15,18,15,0,15,3,3,1,1,0
"17004530",INS,Centre públic Dep. i CEB,Institut Santiago Sobrequés i Vidal,Girona,GIR,GIR,1,35,1,0,1,25,0,0,0,25,25,0,0,0,25,26,0,1,1,1,1,1,1,0
"17004566",ESC,Centre públic Dep. i CEB,Escola Napoleó Soliva,Blanes,GIR,GIR,1,12,1,0,1,0,0,0,11,11,0,0,0,11,11,12,0,0,0,1,1,1,1,0
"17004578",INS,Centre públic Dep. i CEB,Institut Castell d'Estela,Amer,GIR,GIR,1,17,0,0,0,0,11,0,0,11,0,11,0,0,11,11,0,11,11,0,0,1,1,0
"17004657",ESC,Centre públic Dep. i CEB,Escola Esteve Carles,Lloret de Mar,GIR,GIR,1,12,0,2,2,6,5,0,0,11,6,5,0,0,11,11,6,5,11,1,1,1,1,0
"17004682",ESC,Centre públic Dep. i CEB,Escola L'Estació,Sant Feliu de Guíxols,GIR,GIR,1,17,0,4,4,17,0,0,0,17,17,0,0,0,17,17,6,0,6,0,0,1,1,0
"17004694",ESC,Centre públic Dep. i CEB,Escola Cassià Costal,Girona,GIR,GIR,1,17,1,0,1,16,0,0,0,16,16,0,0,0,16,17,0,0,0,1,1,1,1,0
"17004700",EE,EE Privats,Mare de Déu del Carme,Sarrià de Ter,GIR,GIR,0,1,0,0,0,0,0,0,0,0,3,0,0,0,3,3,0,0,0,0,0,0,1,0
"17004712",EE,Centre públic Dep. i CEB,CEE Ventijol,Blanes,GIR,GIR,1,12,3,1,4,5,2,5,0,12,5,2,2,0,9,12,9,0,9,3,3,1,1,0
"17004724",EE,Centre públic Dep. i CEB,CEE Palau,Girona,GIR,GIR,1,5,3,0,3,9,0,0,0,9,2,0,0,0,2,5,2,0,2,3,2,1,1,0
"17004736",EE,Centre públic Dep. i CEB,CEE Els Àngels,Sant Joan de Palamós (Palamós),GIR,GIR,1,6,6,0,6,7,2,0,0,9,0,0,0,0,0,6,0,0,0,6,2,1,1,0
"17004748",EE,Centre públic Dep. i CEB,CEE Mare de Déu del Mont,Vilafant,GIR,GIR,1,12,11,2,13,4,1,2,1,8,1,0,0,0,1,12,1,0,1,11,4,1,1,0
"17004751",ESC,Centre públic Dep. i CEB,Escola Tomàs Raguer,Ripoll,GIR,GIR,1,9,0,5,5,0,0,4,2,6,0,0,4,2,6,6,4,2,6,3,3,1,1,0
"17004761",EE,Centre públic Dep. i CEB,CEE Doctor Ramon Suriñach,Ripoll,GIR,GIR,1,2,2,1,3,0,0,0,0,0,0,0,0,0,0,2,0,0,0,2,1,1,1,0
"17004827",ESC,Centre públic Dep. i CEB,Escola Alzina Reclamadora,Fontcoberta,GIR,GIR,1,9,0,0,0,0,0,0,11,11,0,0,0,9,9,9,0,0,0,0,0,1,1,0
"17004852",EOI,Centre públic Dep. i CEB,EOI de Girona,Girona,GIR,GIR,1,112,0,2,2,19,2,0,0,21,19,2,0,0,21,21,0,2,2,2,2,1,1,0
"17004864",ESC,Centre públic Dep. i CEB,Escola El Pla,Salt,GIR,GIR,1,18,2,1,3,10,6,0,0,16,10,6,0,0,16,18,10,6,16,2,2,1,1,0
"17004876",ESC,Centre públic Dep. i CEB,Escola l'Olivar Vell,Esclanyà (Begur),GIR,GIR,1,9,2,1,3,1,1,3,0,5,1,1,3,0,5,7,3,1,4,3,3,1,1,0
"17004888",ESC-ZER,Centre públic Dep. i CEB,Escola Santa Cecília - ZER Cerdanya,Bolvir,GIR,APA,1,3,2,0,2,0,0,0,0,0,0,0,0,0,0,2,0,0,0,2,1,1,0,1
"17004891",ESC,Centre públic Dep. i CEB,Escola Josep Pallach,Figueres,GIR,GIR,1,19,1,0,1,12,1,4,1,18,12,1,4,1,18,19,16,2,18,1,1,1,1,0
"17004906",ESC,Centre públic Dep. i CEB,Escola Salvador Espriu,Vidreres,GIR,GIR,1,18,0,6,6,16,2,0,0,18,16,2,0,0,18,18,10,2,12,0,0,1,1,0
"17004943",ESC,Centre públic Dep. i CEB,Escola Montfalgars,Girona,GIR,GIR,1,18,0,0,0,18,0,0,0,18,18,0,0,0,18,18,18,0,18,0,0,1,1,0
"17004955",ESC,Centre públic Dep. i CEB,Escola Pompeu Fabra,Lloret de Mar,GIR,GIR,1,26,7,0,7,0,11,0,12,23,0,11,0,8,19,26,0,0,0,7,7,1,1,0
"17005017",ESC,Centre públic Dep. i CEB,Escola Quatre Vents,Blanes,GIR,GIR,1,18,0,0,0,11,1,0,1,13,11,1,0,1,13,13,11,1,12,0,0,1,1,0
"17005029",ESC-ZER,Centre públic Dep. i CEB,Escola L'Esquirol - ZER Vall de Ter,Ogassa,GIR,GIR,1,1,1,0,1,0,0,1,0,1,0,0,0,0,0,1,0,0,0,1,1,1,0,0
"17005042",INS,Centre públic Dep. i CEB,Institut Carles Rahola i Llorens,Girona,GIR,GIR,1,27,0,0,0,19,2,0,0,21,19,2,0,0,21,21,19,2,21,0,0,1,1,0
"17005182",ESC,Centre públic Dep. i CEB,Escola Can Puig,Banyoles,GIR,GIR,1,18,0,0,0,18,0,0,0,18,18,0,0,0,18,18,10,0,10,0,0,1,1,0
"17005248",ESC,Centre públic Dep. i CEB,Escola Mas Clarà,La Bisbal d'Empordà,GIR,GIR,1,16,0,5,5,0,0,13,0,13,0,0,13,0,13,13,6,0,6,3,3,1,1,0
"17005251",INS,Centre públic Dep. i CEB,Institut El Pedró,L'Escala,GIR,GIR,1,25,7,0,7,19,0,0,0,19,18,0,0,0,18,25,0,0,0,7,7,1,1,0
"17005261",ESC-ZER,Centre públic Dep. i CEB,Escola Montpalau - ZER El Llierca,Argelaguer,GIR,GIR,1,3,1,0,1,0,0,3,0,3,0,0,2,0,2,3,2,0,2,1,1,1,0,0
"17005339",CFA,CFA Departament,CFA Les Bernardes,Salt,GIR,GIR,1,4,0,0,0,7,0,0,0,7,3,0,0,0,3,3,0,0,0,0,0,1,1,0
"17005340",INS,Centre públic Dep. i CEB,EA d'Olot,Olot,GIR,GIR,1,6,7,0,7,0,1,0,0,1,0,0,0,0,0,7,0,0,0,6,2,1,1,0
"17005352",INS,Centre públic Dep. i CEB,Institut de Palamós,Palamós,GIR,GIR,1,23,0,0,0,25,3,0,0,28,23,0,0,0,23,23,0,0,0,0,0,1,1,0
"17005364",INS,Centre públic Dep. i CEB,Institut Cap Norfeu,Roses,GIR,GIR,1,32,1,0,1,24,0,0,0,24,24,0,0,0,24,25,24,0,24,1,1,1,1,0
"17005376",INS,Centre públic Dep. i CEB,Institut de Santa Coloma de Farners,Santa Coloma de Farners,GIR,GIR,1,39,3,0,3,34,0,0,0,34,34,0,0,0,34,37,2,0,2,3,3,1,1,0
"17005388",INS,Centre públic Dep. i CEB,Institut Vallvera,Salt,GIR,GIR,1,36,0,0,0,31,2,0,0,33,31,2,0,0,33,33,0,0,0,0,0,1,1,0
"17005406",EE,EE Privats,Joan Riu,Sant Gregori,GIR,GIR,0,1,0,0,0,0,0,0,0,0,2,0,0,0,2,2,0,0,0,0,0,0,1,0
"17005522",ESC,Centre públic Dep. i CEB,Escola Veïnat,Salt,GIR,GIR,1,9,1,0,1,8,0,0,0,8,8,0,0,0,8,9,4,0,4,1,1,1,1,0
"17005649",INS,Centre públic Dep. i CEB,Institut Cendrassos,Figueres,GIR,GIR,1,34,1,0,1,2,6,0,0,8,2,6,0,0,8,9,2,6,8,1,1,1,1,0
"17005650",INS,Centre públic Dep. i CEB,Institut de Cassà de la Selva,Cassà de la Selva,GIR,GIR,1,29,1,0,1,0,0,10,0,10,0,0,10,0,10,11,0,0,0,1,1,1,1,0
"17005662",INS,Centre públic Dep. i CEB,Institut Serrallarga,Blanes,GIR,GIR,1,29,0,2,2,9,25,0,0,34,9,20,0,0,29,29,0,0,0,0,0,1,1,0
"17005704",INS,Centre públic Dep. i CEB,Institut Abat Oliba,Ripoll,GIR,GIR,1,49,1,0,1,3,8,0,0,11,3,8,0,0,11,12,3,8,11,1,1,1,1,0
"17005731",INS,Centre públic Dep. i CEB,Institut S'Agulla,Blanes,GIR,GIR,1,21,0,0,0,26,0,0,0,26,21,0,0,0,21,21,0,0,0,0,0,1,1,0
"17005741",INS,Centre públic Dep. i CEB,Institut Pere Borrell,Puigcerdà,GIR,APA,1,40,0,0,0,27,2,0,0,29,27,2,0,0,29,29,2,2,4,0,0,1,1,0
"17005893",INS,Centre públic Dep. i CEB,Institut Bosc de la Coma,Olot,GIR,GIR,1,28,1,0,1,27,1,0,0,28,27,0,0,0,27,28,27,0,27,1,1,1,1,0
"17005911",INS,Centre públic Dep. i CEB,Institut Ramon Coll i Rodés,Lloret de Mar,GIR,GIR,1,38,0,0,0,27,0,3,2,32,27,0,3,2,32,32,30,2,32,0,0,1,1,0
"17005923",INS,Centre públic Dep. i CEB,Institut Montgrí,Torroella de Montgrí,GIR,GIR,1,30,4,0,4,27,0,0,0,27,26,0,0,0,26,30,26,0,26,4,4,1,1,0
"17006083",INS,Centre públic Dep. i CEB,Institut Castelló d'Empúries,Castelló d'Empúries,GIR,GIR,1,29,1,0,1,25,0,0,0,25,25,0,0,0,25,26,0,0,0,1,1,1,1,0
"17006605",INS,Centre públic Dep. i CEB,Institut Montsoriu,Arbúcies,GIR,GIR,1,27,0,0,0,19,2,0,0,21,19,2,0,0,21,21,0,0,0,0,0,1,1,0
"17006666",INS,Centre públic Dep. i CEB,Institut Pla de l'Estany,Banyoles,GIR,GIR,1,30,0,1,1,28,0,0,0,28,28,0,0,0,28,28,0,0,0,1,1,1,1,0
"17006681",INS,Centre públic Dep. i CEB,Institut Germans Vila-Riera,Camprodon,GIR,GIR,1,10,0,0,0,0,6,0,0,6,0,6,0,0,6,6,0,2,2,0,0,1,1,0
"17006691",INS,Centre públic Dep. i CEB,Institut Ridaura,Castell d'Aro (Castell-Platja d'Aro),GIR,GIR,1,32,0,0,0,0,10,0,0,10,0,10,0,0,10,10,0,10,10,0,0,1,1,0
"17006708",INS,Centre públic Dep. i CEB,Institut de Celrà,Celrà,GIR,GIR,1,32,0,0,0,21,2,0,0,23,21,2,0,0,23,23,0,0,0,0,0,1,1,0
"17006711",ESC,Centre públic Dep. i CEB,Escola M. Àngels Anglada,Figueres,GIR,GIR,1,10,1,0,1,10,0,0,0,10,9,0,0,0,9,10,6,0,6,1,1,1,1,0
"17006721",ESC,Centre públic Dep. i CEB,Escola Marta Mata,Girona,GIR,GIR,1,17,0,0,0,17,0,0,0,17,17,0,0,0,17,17,9,0,9,0,0,1,1,0
"17006733",INS,Centre públic Dep. i CEB,Institut Vescomtat de Cabrera,Hostalric,GIR,GIR,1,24,0,0,0,19,1,0,0,20,19,1,0,0,20,20,19,1,20,0,0,1,1,0
"17006745",INS,Centre públic Dep. i CEB,Institut de La Jonquera,La Jonquera,GIR,GIR,1,13,0,1,1,10,0,0,0,10,10,0,0,0,10,10,0,0,0,1,1,1,1,0
"17006757",INS,Centre públic Dep. i CEB,Institut de Llagostera,Llagostera,GIR,GIR,1,26,0,0,0,1,0,0,4,5,1,0,0,4,5,5,0,0,0,0,0,1,1,0
"17006769",INS,Centre públic Dep. i CEB,Institut de Llançà,Llançà,GIR,GIR,1,18,0,0,0,17,1,0,0,18,17,1,0,0,18,18,17,1,18,0,0,1,1,0
"17006770",INS,Centre públic Dep. i CEB,Institut Rocagrossa,Lloret de Mar,GIR,GIR,1,33,0,0,0,17,4,0,0,21,17,4,0,0,21,21,17,4,21,0,0,1,1,0
"17006782",ESC,Centre públic Dep. i CEB,Escola Carrilet,Palafrugell,GIR,GIR,1,18,7,0,7,0,1,13,0,14,0,1,10,0,11,18,0,0,0,7,5,1,1,0
"17006800",ESC,Centre públic Dep. i CEB,Escola Els Grecs,Roses,GIR,GIR,1,15,0,0,0,15,0,0,0,15,15,0,0,0,15,15,4,0,4,0,0,1,1,0
"17006812",INS,Centre públic Dep. i CEB,Institut de Tossa de Mar,Tossa de Mar,GIR,GIR,1,13,0,0,0,0,0,11,0,11,0,0,11,0,11,11,2,0,2,0,0,1,1,0
"17006824",INS,Centre públic Dep. i CEB,Institut Vidreres,Vidreres,GIR,GIR,1,26,0,0,0,22,22,0,0,44,22,4,0,0,26,26,0,22,22,0,0,1,1,0
"17006836",ESC,Centre públic Dep. i CEB,Escola Les Mèlies,Vilafant,GIR,GIR,1,18,1,1,2,18,0,0,0,18,17,0,0,0,17,18,17,0,17,1,1,1,1,0
"17006851",INS,Centre públic Dep. i CEB,Institut Illa de Rodes,Roses,GIR,GIR,1,30,0,0,0,21,4,0,0,25,21,4,0,0,25,25,0,0,0,0,0,1,1,0
"17006873",ESC,Centre públic Dep. i CEB,Escola Castellum,Sant Julià de Ramis,GIR,GIR,1,15,0,0,0,12,0,4,0,16,12,0,3,0,15,15,4,0,4,0,0,1,1,0
"17006939",INS,Centre públic Dep. i CEB,Institut Santa Eugènia,Girona,GIR,GIR,1,40,0,3,3,36,0,0,0,36,36,0,0,0,36,36,0,0,0,3,3,1,1,0
"17006940",ESC,Centre públic Dep. i CEB,Escola de Lliurona,Albanyà,GIR,GIR,1,1,1,0,1,0,0,1,1,2,1,0,0,0,1,2,0,0,0,0,0,1,1,0
"17006952",ESC,Centre públic Dep. i CEB,Escola La Draga,Banyoles,GIR,GIR,1,17,0,2,2,17,0,0,0,17,17,0,0,0,17,17,6,0,6,0,0,1,1,0
"17007014",CFA,CFA Departament,CFA Lloret de Mar,Lloret de Mar,GIR,GIR,1,5,0,1,1,3,0,0,0,3,3,0,0,0,3,3,0,0,0,1,0,1,1,0
"17007129",CFA,CFA Departament,CFA Es Piteus,Blanes,GIR,GIR,1,7,1,1,2,0,0,2,0,2,2,0,0,0,2,3,0,0,0,2,0,1,1,0
"17007130",CFA,CFA Municipals no CEB,CFA de Roses(EMFAR),Roses,GIR,GIR,0,1,0,0,0,0,0,0,0,0,1,0,0,0,1,1,0,0,0,0,0,0,1,0
"17007142",CFA,CFA Municipals sense estudis reglats,CFA Torroella de Montgrí,Torroella de Montgrí,GIR,GIR,0,1,0,0,0,0,0,0,0,0,1,0,0,0,1,1,0,0,0,0,0,0,1,0
"17007178",CFA,CFA Departament,CFA Maria Verdaguer,Figueres,GIR,GIR,1,5,0,0,0,9,0,0,0,9,3,0,0,0,3,3,0,0,0,0,0,1,1,0
"17007181",CFA,CFA Departament,CFA Girona,Girona,GIR,GIR,1,7,0,0,0,0,8,0,0,8,3,0,0,0,3,3,0,0,0,0,0,1,1,0
"17007211",CFA,CFA Municipals sense estudis reglats,CFA de Sant Hilari Sacalm,Sant Hilari Sacalm,GIR,GIR,0,1,0,0,0,0,0,0,0,0,1,0,0,0,1,1,0,0,0,0,0,0,1,0
"17007300",INS,Centre públic Dep. i CEB,Institut La Bisbal,La Bisbal d'Empordà,GIR,GIR,1,48,1,0,1,5,0,10,0,15,5,0,10,0,15,16,2,0,2,1,1,1,1,0
"17007312",CFA,CFA Municipals sense estudis reglats,CFA de Palamós,Palamós,GIR,GIR,0,1,0,0,0,0,0,0,0,0,1,0,0,0,1,1,0,0,0,0,0,0,1,0
"17007580",CFA,CFA Municipals sense estudis reglats,CFA de Calonge,Calonge (Calonge i Sant Antoni),GIR,GIR,0,1,0,0,0,0,0,0,0,0,1,0,0,0,1,1,0,0,0,0,0,0,1,0
"17007609",INS,Centre públic Dep. i CEB,Institut Olivar Gran,Figueres,GIR,GIR,1,34,7,0,7,44,0,0,0,44,27,0,0,0,27,34,27,0,27,7,7,1,1,0
"17007658",CFA,CFA Departament,CFA Sant Feliu de Guíxols,Sant Feliu de Guíxols,GIR,GIR,1,6,0,0,0,0,0,2,0,2,2,0,0,0,2,2,0,0,0,0,0,1,1,0
"17007671",CFA,CFA Departament,CFA La Garrotxa,Olot,GIR,GIR,1,6,0,1,1,4,1,0,0,5,3,0,0,0,3,3,0,0,0,1,0,1,1,0
"17007828",ESC,Centre públic Dep. i CEB,Escola Pinya de Rosa,Blanes,GIR,GIR,1,18,0,0,0,18,3,0,0,21,18,0,0,0,18,18,6,0,6,0,0,1,1,0
"17007907",ESC,Centre públic Dep. i CEB,Escola Joana d'Empúries,Castelló d'Empúries,GIR,GIR,1,17,1,0,1,15,0,0,0,15,15,0,0,0,15,16,5,0,5,1,1,1,1,0
"17007919",ESC,Centre públic Dep. i CEB,Escola Mas Masó,Salt,GIR,GIR,1,19,1,0,1,22,0,0,0,22,18,0,0,0,18,19,18,0,18,1,1,1,1,0
"17007981",EOI,Centre públic Dep. i CEB,EOI d'Olot,Olot,GIR,GIR,1,25,0,5,5,2,0,0,0,2,2,0,0,0,2,2,0,0,0,5,5,1,1,0
"17008006",ESC,Centre públic Dep. i CEB,Escola Amistat,Figueres,GIR,GIR,1,17,0,0,0,25,5,0,0,30,17,0,0,0,17,17,0,0,0,0,0,1,1,0
"17008018",ESC,Centre públic Dep. i CEB,Escola Ardenya,Sant Feliu de Guíxols,GIR,GIR,1,17,9,0,9,0,0,8,0,8,0,0,8,0,8,17,8,0,8,9,5,1,1,0
"17008080",ESC,Centre públic Dep. i CEB,Escola Àngels Alemany i Boris,Lloret de Mar,GIR,GIR,1,29,1,5,6,28,0,0,0,28,28,0,0,0,28,29,0,0,0,1,1,1,1,0
"17008110",EOI,Centre públic Dep. i CEB,EOI de Sant Feliu de Guíxols,Sant Feliu de Guíxols,GIR,GIR,0,19,0,0,0,0,0,0,0,0,0,0,0,0,0,0,0,0,0,0,0,1,1,19
"17008122",EOI,Centre públic Dep. i CEB,EOI de Blanes,Blanes,GIR,GIR,1,24,0,0,0,6,1,0,0,7,6,1,0,0,7,7,0,0,0,0,0,1,1,0
"17008134",EOI,Centre públic Dep. i CEB,EOI de Figueres,Figueres,GIR,GIR,1,72,0,0,0,8,1,0,0,9,8,1,0,0,9,9,0,0,0,0,0,1,1,0
"17008146",CFA,CFA Departament,CFA Palafrugell,Palafrugell,GIR,GIR,1,5,0,0,0,4,0,0,0,4,3,0,0,0,3,3,0,0,0,0,0,1,1,0
"17008161",AH,Aules hospitalàries,A. Hospitalària Hospital de Dia Santa Caterina,Salt,GIR,GIR,0,1,0,0,0,0,0,0,0,0,0,0,1,0,1,1,0,0,0,0,0,0,0,0
"17008237",ESC,Centre públic Dep. i CEB,Escola Montserrat Vayreda,Roses,GIR,GIR,1,15,0,0,0,15,0,0,0,15,15,0,0,0,15,15,15,0,15,0,0,1,1,0
"17008249",ESC,Centre públic Dep. i CEB,Escola Castell de Farners,Santa Coloma de Farners,GIR,GIR,1,19,0,0,0,15,3,0,0,18,15,3,0,0,18,18,15,3,18,0,0,1,1,0
"17008274",ESC,Centre públic Dep. i CEB,Escola Sa Forcanera,Blanes,GIR,GIR,1,18,2,0,2,4,13,0,0,17,4,12,0,0,16,18,1,5,6,2,2,1,1,0
"17008286",ESC,Centre públic Dep. i CEB,Escola Domeny,Girona,GIR,GIR,1,18,0,0,0,18,0,0,0,18,18,0,0,0,18,18,10,0,10,0,0,1,1,0
"17008298",ESC,Centre públic Dep. i CEB,Escola El Gegant del Rec,Salt,GIR,GIR,1,18,1,0,1,18,4,0,0,22,17,0,0,0,17,18,0,0,0,1,1,1,1,0
"17008365",CFA,CFA Departament,CFA Pla de l'Estany,Banyoles,GIR,GIR,1,2,0,0,0,3,0,0,0,3,2,0,0,0,2,2,0,0,0,0,0,1,1,0
"17008377",CFA,CFA Departament,CFA Ripollès,Ripoll,GIR,GIR,1,2,0,1,1,3,0,0,0,3,2,0,0,0,2,2,0,0,0,0,0,1,1,0
"17008389",CFA,CFA Departament,CFA La Selva,Santa Coloma de Farners,GIR,GIR,1,3,0,0,0,0,0,0,1,1,1,0,0,0,1,1,0,0,0,0,0,1,1,0
"17008390",INS,Centre públic Dep. i CEB,Institut de Vilafant,Vilafant,GIR,GIR,1,23,7,0,7,0,12,0,0,12,0,12,0,0,12,19,0,0,0,7,6,1,1,0
"17008407",INS,Centre públic Dep. i CEB,Institut Salvador Sunyer i Aimeric,Salt,GIR,GIR,1,16,2,0,2,0,11,0,0,11,0,11,0,0,11,13,0,11,11,2,2,1,1,0
"17008419",ESC,Centre públic Dep. i CEB,Escola Llums del Nord,Puigcerdà,GIR,APA,1,9,0,0,0,0,9,0,0,9,0,9,0,0,9,9,0,5,5,0,0,1,1,0
"17008444",ESC,Centre públic Dep. i CEB,Escola Parc de les Aigües,Figueres,GIR,GIR,1,18,1,1,2,18,0,0,0,18,17,0,0,0,17,18,9,0,9,1,1,1,1,0
"17008468",ESC,Centre públic Dep. i CEB,Escola La Sínia,Sant Antoni de Calonge (Calonge i Sant Antoni),GIR,GIR,1,9,0,0,0,0,5,0,0,5,0,5,0,0,5,5,0,5,5,0,0,1,1,0
"17008471",ESC,Centre públic Dep. i CEB,Escola Les Falgueres,Celrà,GIR,GIR,1,17,3,0,3,0,17,0,0,17,0,14,0,0,14,17,0,14,14,3,3,1,1,0
"17008481",ESC,Centre públic Dep. i CEB,Escola L'Esculapi,L'Escala,GIR,GIR,1,10,1,4,5,0,0,0,8,8,0,0,0,8,8,9,0,0,0,2,2,1,1,0
"17008493",ESC,Centre públic Dep. i CEB,Escola Vall-llobrega,Vall-llobrega,GIR,GIR,1,9,1,0,1,0,0,0,9,9,0,0,0,8,8,9,0,8,8,1,1,1,1,0
"17008501",ESC,Centre públic Dep. i CEB,Escola Aldric,Cassà de la Selva,GIR,GIR,1,18,0,0,0,19,1,0,0,20,18,0,0,0,18,18,10,0,10,0,0,1,1,0
"17008523",ESC,Centre públic Dep. i CEB,Escola Pi Verd,Palafrugell,GIR,GIR,1,19,1,4,5,12,0,0,0,12,12,0,0,0,12,13,6,0,6,5,5,1,1,0
"17008547",ESC,Centre públic Dep. i CEB,Escola Les Arrels,Maçanet de la Selva,GIR,GIR,1,11,0,3,3,2,4,0,0,6,2,4,0,0,6,6,4,0,4,3,3,1,1,0
"17008596",CJJ,Justícia juvenil,C.Educ.Justícia Montilivi,Girona,GIR,GIR,0,2,0,0,0,0,0,0,0,0,0,0,2,0,2,2,0,0,0,0,0,0,1,0
"17008641",ESC,Centre públic Dep. i CEB,Escola de Cabanes,Cabanes,GIR,GIR,1,9,2,1,3,8,0,0,0,8,7,0,0,0,7,9,7,0,7,2,2,1,1,0
"17008651",INS,Centre públic Dep. i CEB,Institut de Caldes de Malavella,Caldes de Malavella,GIR,GIR,1,13,1,0,1,6,0,0,0,6,6,0,0,0,6,7,0,0,0,1,1,1,1,0
"17008675",ESC,Centre públic Dep. i CEB,Escola Pericot,Girona,GIR,GIR,1,18,0,0,0,0,18,0,0,18,0,18,0,0,18,18,0,18,18,0,0,1,1,0
"17008687",ESC,Centre públic Dep. i CEB,Escola Les Deveses,Salt,GIR,GIR,1,18,1,0,1,18,0,0,0,18,17,0,0,0,17,18,0,0,0,1,1,1,1,0
"17008778",ESC,Centre públic Dep. i CEB,Escola El Morrot,Olot,GIR,GIR,1,10,0,0,0,6,6,3,3,18,6,4,0,0,10,10,0,9,9,0,0,1,1,0
"17008781",ESC,Centre públic Dep. i CEB,Escola La Benaula,Caldes de Malavella,GIR,GIR,1,10,5,0,5,8,0,1,0,9,5,0,0,0,5,10,5,0,5,5,3,1,1,0
"17008808",ESC,Centre públic Dep. i CEB,Escola Carme Guasch i Darné,Figueres,GIR,GIR,1,18,0,2,2,18,0,0,0,18,18,0,0,0,18,18,12,0,12,0,0,1,1,0
"17008821",EOI,Centre públic Dep. i CEB,EOI de Banyoles,Banyoles,GIR,GIR,1,13,0,0,0,4,0,0,0,4,4,0,0,0,4,4,4,0,4,0,0,1,1,0
"17008882",ESC,Centre públic Dep. i CEB,Escola La Bòbila,Les Preses,GIR,GIR,1,10,0,2,2,6,3,0,0,9,6,3,0,0,9,9,2,3,5,1,1,1,1,0
"17008894",ESC,Centre públic Dep. i CEB,Escola Alzines Balladores,Sant Feliu de Buixalleu,GIR,GIR,1,9,1,1,2,0,0,3,9,12,0,0,3,5,8,9,3,5,8,1,1,1,1,0
"17008951",INS,Centre públic Dep. i CEB,Institut Maçanet de la Selva,Maçanet de la Selva,GIR,GIR,1,15,0,0,0,11,0,0,0,11,11,0,0,0,11,11,11,0,11,0,0,1,1,0
"17008997",ESC,Centre públic Dep. i CEB,Escola Forallac,Vulpellac (Forallac),GIR,GIR,1,9,1,0,1,7,7,0,0,14,7,1,0,0,8,9,0,7,7,1,1,1,1,0
"17009126",ESC,Centre públic Dep. i CEB,Escola El Bosc de la Pabordia,Girona,GIR,GIR,1,20,0,1,1,21,0,0,0,21,20,0,0,0,20,20,0,0,0,0,0,1,1,0
"17009138",ESC,Centre públic Dep. i CEB,Escola Puig de les Cadiretes,Llagostera,GIR,GIR,1,18,0,5,5,2,1,10,2,15,2,1,10,2,15,15,0,2,2,3,3,1,1,0
"17009199",ESC,Centre públic Dep. i CEB,Escola Els Estanys,Sils,GIR,GIR,1,10,0,0,0,0,0,9,0,9,0,0,9,0,9,9,5,0,5,0,0,1,1,0
"17009205",INS,Centre públic Dep. i CEB,Institut de Vilablareix,Vilablareix,GIR,GIR,1,24,2,0,2,22,0,0,0,22,22,0,0,0,22,24,0,0,0,2,2,1,1,0
"17009242",ESC,Centre públic Dep. i CEB,Escola Nou de Quart,Quart,GIR,GIR,1,9,1,0,1,0,9,0,0,9,0,8,0,0,8,9,0,8,8,1,1,1,1,0
"17009278",ESC,Centre públic Dep. i CEB,Escola Fanals d'Aro,Castell d'Aro (Castell-Platja d'Aro),GIR,GIR,1,9,0,2,2,0,0,7,0,7,0,0,7,0,7,7,7,0,7,2,2,1,1,0
"17009308",INS,Centre públic Dep. i CEB,Institut de Sils,Sils,GIR,GIR,1,13,0,0,0,0,1,0,0,1,0,1,0,0,1,1,0,1,1,0,0,1,1,0
"17009345",ESC,Centre públic Dep. i CEB,Escola Camins,Banyoles,GIR,GIR,1,13,1,0,1,0,0,0,2,2,0,0,0,2,2,3,0,2,2,1,1,1,1,0
"17009710",ESC,Centre públic Dep. i CEB,Escola Empordanet,La Bisbal d'Empordà,GIR,GIR,1,9,1,0,1,0,9,0,0,9,0,8,0,0,8,9,0,8,8,1,1,1,1,0
"17009783",INS,Centre públic Dep. i CEB,Institut La Miquela,Bescanó,GIR,GIR,1,14,0,0,0,14,0,0,0,14,14,0,0,0,14,14,14,0,14,0,0,1,1,0
"17009795",IE,Centre públic Dep. i CEB,Institut Escola Francesc Cambó i Batlle,Verges,GIR,GIR,1,21,0,0,0,0,22,0,0,22,0,21,0,0,21,21,0,0,0,0,0,1,1,0
"17009801",IE,Centre públic Dep. i CEB,Institut Escola Salvador Vilarrasa,Besalú,GIR,GIR,1,23,1,0,1,2,0,0,0,2,2,0,0,0,2,3,2,0,2,1,1,1,1,0
"17009813",IE,Centre públic Dep. i CEB,Institut Escola Mestre Andreu,Sant Joan de les Abadesses,GIR,GIR,1,20,1,1,2,6,15,0,0,21,6,13,0,0,19,20,6,5,11,1,1,1,1,0
"17009850",ESC,Centre públic Dep. i CEB,Escola Les Arrels,Salt,GIR,GIR,1,18,1,0,1,0,0,0,12,12,0,0,0,12,12,13,0,12,12,1,1,1,1,0
"17009898",IE,Centre públic Dep. i CEB,Institut Escola Lloret de Mar,Lloret de Mar,GIR,GIR,1,29,1,28,29,0,6,0,0,6,0,6,0,0,6,7,0,6,6,23,8,1,1,0
"17010037",INS,Centre públic Dep. i CEB,Institut El Bruc,Riells i Viabrea,GIR,GIR,1,5,0,0,0,0,6,0,0,6,0,5,0,0,5,5,0,0,0,0,0,1,1,0
"17010049",ESC,Centre públic Dep. i CEB,Escola Balandrau,Girona,GIR,GIR,1,9,0,0,0,0,0,0,0,0,0,0,0,0,0,0,0,0,0,0,0,1,1,9
"17010098",CFA,CFA Municipals no CEB,CFA de Vidreres,Vidreres,GIR,GIR,0,1,0,0,0,0,0,0,0,0,1,0,0,0,1,1,0,0,0,0,0,0,1,0
"17010189",INS,Centre públic Dep. i CEB,Institut Vall de Llémena,Sant Gregori,GIR,GIR,1,15,1,1,2,7,2,2,0,11,7,2,2,0,11,12,9,2,11,2,2,1,1,0
"17010281",IE,Concertada 30% NESE,Escola Pia de Salt,Salt,GIR,GIR,0,10,0,0,0,0,0,0,0,0,10,0,0,0,10,10,0,0,0,0,0,0,1,0
"17010414",INS,Centre públic Dep. i CEB,Institut Ermessenda de Girona,Girona,GIR,GIR,1,26,3,0,3,0,12,0,6,18,0,12,0,6,18,21,0,18,18,3,3,1,1,0
"17010441",CFA,CFA Departament,CFA Nou Girona,Girona,GIR,GIR,1,4,0,0,0,5,0,0,0,5,3,0,0,0,3,3,0,0,0,0,0,1,1,0
"17010451",CFA,CFA Departament,CFA Tramuntana,Figueres,GIR,GIR,1,3,0,0,0,9,0,0,0,9,3,0,0,0,3,3,0,0,0,0,0,1,1,0
"17010682",INS,Centre públic Dep. i CEB,Institut de Sarrià de Ter,Sarrià de Ter,GIR,GIR,1,19,0,1,1,0,0,0,6,6,0,0,0,6,6,6,0,6,6,1,1,1,1,0
"17010694",IE,Centre públic Dep. i CEB,Institut Escola El Bruel-Empuriabrava,Castelló d'Empúries,GIR,GIR,1,19,4,0,4,14,0,0,0,14,14,0,0,0,14,18,3,0,3,4,4,1,1,0
"17010700",INS,Centre públic Dep. i CEB,Institut Sant Quirze,Lloret de Mar,GIR,GIR,1,10,0,0,0,3,0,0,4,7,3,0,0,4,7,7,0,0,0,0,0,1,1,0
"17010797",IE,Centre públic Dep. i CEB,Institut Escola Caritat Serinyana - Cap de Creus,Cadaqués,GIR,GIR,1,15,1,0,1,15,0,0,0,15,14,0,0,0,14,15,14,0,14,1,1,1,1,0
"17010803",IE,Centre públic Dep. i CEB,Institut Escola Vall de Ribes,Ribes de Freser,GIR,GIR,1,13,0,0,0,15,0,0,0,15,13,0,0,0,13,13,13,0,13,0,0,1,1,0
"17010815",IE,Centre públic Dep. i CEB,Institut Escola Vila-romà,Palamós,GIR,GIR,1,26,6,2,8,0,30,0,0,30,0,20,0,0,20,26,0,20,20,6,6,1,1,0
"17010827",IE,Centre públic Dep. i CEB,Institut Escola Greda,Olot,GIR,GIR,1,17,6,0,6,12,0,0,0,12,11,0,0,0,11,17,0,0,0,6,5,1,1,0
"17010839",INS,Centre públic Dep. i CEB,Institut de Peralada,Peralada,GIR,GIR,1,7,6,2,8,1,0,0,0,1,1,0,0,0,1,7,1,0,1,6,2,1,1,0
"17010840",INS,Centre públic Dep. i CEB,Institut La Sureda,Palafrugell,GIR,GIR,1,10,0,0,0,0,3,0,0,3,0,3,0,0,3,3,0,3,3,0,0,1,1,0
"17010921",IE,Centre públic Dep. i CEB,Institut Escola Montseny,Breda,GIR,GIR,1,25,0,13,13,8,0,0,0,8,8,0,0,0,8,8,7,0,7,13,7,1,1,0
"17010931",ESC-ZER,Centre públic Dep. i CEB,Escola Les Curculles-ZER Empordà,Palau de Santa Eulàlia,GIR,GIR,1,1,0,0,0,0,1,0,0,1,0,1,0,0,1,1,0,0,0,0,0,1,0,0
"17011042",IE,Obre el curs 2023-24,Institut Escola Mossèn Joan Batlle,Blanes,GIR,GIR,0,15,0,0,0,0,0,0,0,0,15,0,0,0,15,15,15,0,15,0,0,1,1,0
"17011054",ESC,Obre el curs 2023-24,Escola de Campllong,Campllong,GIR,GIR,0,2,0,0,0,0,0,0,0,0,2,0,0,0,2,2,0,0,0,0,0,1,1,0
"17011066",IE,Obre el curs 2023-24,Institut Escola Josep Pous i Pagès,Figueres,GIR,GIR,0,11,0,0,0,0,0,0,0,0,4,6,0,0,10,10,3,6,9,0,1,1,1,0
"17011081",IE,Obre el curs 2023-24,Institut Escola Cent Fonts-Sant Josep,Sant Hilari Sacalm,GIR,GIR,0,13,0,0,0,0,0,0,0,0,13,0,0,0,13,13,0,0,0,0,0,1,1,0
"25000031",ESC-ZER,Centre públic Dep. i CEB,Escola Andreu Farran - ZER Montsec,Àger,LLE,LLE,1,2,0,0,0,0,0,1,1,2,0,0,1,1,2,2,0,0,0,0,0,1,0,0
"25000067",ESC,Centre públic Dep. i CEB,Escola Macià-Companys,Agramunt,LLE,LLE,1,18,1,0,1,9,1,0,0,10,9,1,0,0,10,11,9,1,10,1,1,1,1,0
"25000110",ESC-ZER,Centre públic Dep. i CEB,Escola Arrels - ZER L'Horta de Lleida,Els Alamús,LLE,LLE,1,4,0,0,0,0,1,0,0,1,0,1,0,0,1,1,0,1,1,0,0,1,0,0
"25000122",ESC-ZER,Centre públic Dep. i CEB,Escola Sant Esteve - ZER Urgellet,Alàs i Cerc,LLE,APA,1,2,0,0,0,2,0,0,0,2,2,0,0,0,2,2,2,0,2,0,0,1,0,0
"25000146",ESC-ZER,Centre públic Dep. i CEB,Escola Mare de Déu de Montserrat - ZER Vall de l'Aranyó,L'Albagés,LLE,LLE,1,1,0,0,0,2,0,0,0,2,1,0,0,0,1,1,1,0,1,0,0,1,0,0
"25000158",ESC,Centre públic Dep. i CEB,Escola Sant Salvador,Albatàrrec,LLE,LLE,1,10,2,3,5,5,1,0,0,6,5,1,0,0,6,8,5,1,6,4,3,1,1,0
"25000161",ESC,Centre públic Dep. i CEB,Escola L'Àlber,Albesa,LLE,LLE,1,9,1,0,1,9,0,0,0,9,8,0,0,0,8,9,3,0,3,1,1,1,1,0
"25000171",ESC-ZER,Centre públic Dep. i CEB,Escola Els Aubis - ZER Riu Set,L'Albi,LLE,LLE,1,4,0,0,0,3,0,0,1,4,3,0,0,1,4,4,3,1,4,0,0,1,0,0
"25000183",ESC-ZER,Centre públic Dep. i CEB,Escola La Dula - ZER L'Eral,Alcanó,LLE,LLE,1,1,0,0,0,1,1,0,0,2,1,0,0,0,1,1,0,1,1,0,0,1,0,0
"25000195",ESC,Centre públic Dep. i CEB,Escola Comtes de Torregrossa,Alcarràs,LLE,LLE,1,24,1,1,2,22,0,0,0,22,22,0,0,0,22,23,22,0,22,2,2,1,1,0
"25000225",ESC,Centre públic Dep. i CEB,Escola Mare de Déu del Carme,Alcoletge,LLE,LLE,1,19,13,9,22,0,0,5,4,9,0,0,5,1,6,19,0,0,0,13,5,1,1,0
"25000274",ESC-ZER,Centre públic Dep. i CEB,Escola d'Alfés - ZER L'Eral,Alfés,LLE,LLE,1,2,0,0,0,0,1,0,0,1,0,1,0,0,1,1,0,0,0,0,0,1,0,0
"25000286",ESC-ZER,Centre públic Dep. i CEB,Escola Sant Blai - ZER Serra Llarga,Algerri,LLE,LLE,1,2,0,0,0,3,1,0,0,4,2,0,0,0,2,2,2,0,2,0,0,1,0,0
"25000316",ESC-ZER,Centre públic Dep. i CEB,Escola d'Alins - ZER Alt Pallars Sobirà,Alins,LLE,APA,1,1,1,0,1,0,1,0,0,1,0,0,1,0,1,2,0,0,0,0,0,1,1,0
"25000341",ESC,Centre públic Dep. i CEB,Escola Antònia Simó Arnó,Almacelles,LLE,LLE,1,24,3,0,3,26,0,1,0,27,21,0,0,0,21,24,21,0,21,3,3,1,1,0
"25000468",ESC,Centre públic Dep. i CEB,Escola Doctor Serés,Alpicat,LLE,LLE,1,20,1,0,1,9,10,0,0,19,9,10,0,0,19,20,0,6,6,1,1,1,1,0
"25000481",ESC-ZER,Centre públic Dep. i CEB,Escola Sant Isidre - ZER Ponent,Gimenells (Gimenells i el Pla de la Font),LLE,LLE,1,3,0,0,0,4,0,0,0,4,3,0,0,0,3,3,3,0,3,0,0,1,0,0
"25000511",ESC-ZER,Centre públic Dep. i CEB,Escola Inocencio Pardos - ZER Ponent,El Pla de la Font (Gimenells i el Pla de la Font),LLE,LLE,1,2,0,0,0,1,0,0,0,1,1,0,0,0,1,1,1,0,1,0,0,1,0,0
"25000535",ESC-ZER,Centre públic Dep. i CEB,Escola Loseron - ZER Val d'Aran,Arties (Naut Aran),LLE,APA,1,3,0,0,0,0,3,0,0,3,0,3,0,0,3,3,0,0,0,0,0,1,0,0
"25000559",ESC-ZER,Centre públic Dep. i CEB,Escola Sant Martí - ZER Val d'Aran,Gessa (Naut Aran),LLE,APA,1,1,0,1,1,1,0,0,0,1,1,0,0,0,1,1,0,0,0,0,0,1,0,0
"25000560",ESC-ZER,Centre públic Dep. i CEB,Escola Ruda - ZER Val d'Aran,Salardú (Naut Aran),LLE,APA,1,5,0,1,1,2,2,0,0,4,2,2,0,0,4,4,2,2,4,1,1,1,0,0
"25000584",ESC,Centre públic Dep. i CEB,Escola Santa Creu,Anglesola,LLE,LLE,1,9,1,0,1,9,0,0,0,9,8,0,0,0,8,9,8,0,8,1,1,1,1,0
"25000602",ESC,Centre públic Dep. i CEB,Escola Albirka,Arbeca,LLE,LLE,1,9,0,0,0,8,1,0,0,9,8,1,0,0,9,9,8,1,9,0,0,1,1,0
"25000626",ESC,Centre públic Dep. i CEB,Escola Els Til.lers,Artesa de Lleida,LLE,LLE,1,9,0,0,0,0,0,0,4,4,0,0,0,4,4,4,0,4,4,0,0,1,1,0
"25000638",ESC,Centre públic Dep. i CEB,Escola Els Planells,Artesa de Segre,LLE,LLE,1,17,1,0,1,0,0,1,0,1,0,0,1,0,1,2,0,0,0,1,1,1,1,0
"25000675",ESC-ZER,Centre públic Dep. i CEB,Escola Mare de Déu de la Guardiola - ZER El Romaní,La Sentiu de Sió,LLE,LLE,1,2,1,0,1,1,0,0,0,1,1,0,0,0,1,2,0,0,0,1,1,1,0,0
"25000699",ESC-ZER,Centre públic Dep. i CEB,Escola de Les Avellanes - ZER Montsec,Les Avellanes (Les Avellanes i Santa Linya),LLE,LLE,1,1,0,0,0,0,0,2,0,2,0,0,1,0,1,1,0,0,0,0,0,1,0,0
"25000717",ESC-ZER,Centre públic Dep. i CEB,Escola de Tartareu - ZER Montsec,Tartareu (Les Avellanes i Santa Linya),LLE,LLE,1,1,0,0,0,0,0,1,0,1,0,0,1,0,1,1,1,0,1,0,0,1,0,0
"25000730",ESC,Centre públic Dep. i CEB,Escola Francesc Feliu,Aitona,LLE,LLE,1,14,1,1,2,4,10,0,0,14,4,9,0,0,13,14,4,9,13,1,1,1,1,0
"25000778",ESC,Centre públic Dep. i CEB,Escola Gaspar de Portolà,Balaguer,LLE,LLE,1,19,19,0,19,0,0,9,0,9,0,0,0,0,0,19,0,0,0,19,5,1,1,0
"25000781",ESC,Centre públic Dep. i CEB,Escola Àngel Guimerà,Balaguer,LLE,LLE,1,9,1,0,1,9,0,0,0,9,8,0,0,0,8,9,8,0,8,1,1,1,1,0
"25000811",IE,Concertada 30% NESE,Escola Pia de Balaguer,Balaguer,LLE,LLE,0,14,0,0,0,0,0,0,0,0,14,0,0,0,14,14,0,0,0,0,0,0,1,0
"25000821",IE,Concertada 30% NESE,Vedruna Balaguer,Balaguer,LLE,LLE,0,27,0,0,0,0,0,0,0,0,27,0,0,0,27,27,0,0,0,0,0,0,1,0
"25000833",INS,Centre públic Dep. i CEB,Institut Ciutat de Balaguer,Balaguer,LLE,LLE,1,24,2,0,2,20,0,0,0,20,20,0,0,0,20,22,20,0,20,2,2,1,1,0
"25000857",ESC,Centre públic Dep. i CEB,Escola La Noguera,Balaguer,LLE,LLE,1,9,1,1,2,0,3,0,0,3,0,3,0,0,3,4,0,3,3,2,2,1,1,0
"25000869",ESC-ZER,Centre públic Dep. i CEB,Escola Sant Roc - ZER Riu Ondara,Barbens,LLE,LLE,1,5,0,0,0,5,0,0,0,5,5,0,0,0,5,5,3,0,3,0,0,1,0,0
"25000951",ESC-ZER,Centre públic Dep. i CEB,Escola Pere Teixiné - ZER Riu Corb,Belianes,LLE,LLE,1,3,0,2,2,2,0,0,0,2,2,0,0,0,2,2,1,0,1,1,1,1,0,0
"25000961",ESC,Centre públic Dep. i CEB,Escola Bonavista,Bellcaire d'Urgell,LLE,LLE,1,9,1,0,1,4,3,0,0,7,4,3,0,0,7,8,4,3,7,1,1,1,1,0
"25000985",ESC,Centre públic Dep. i CEB,Escola Ramon Farrerons,Bell-lloc d'Urgell,LLE,LLE,1,10,0,0,0,10,2,0,0,12,10,0,0,0,10,10,2,2,4,0,0,1,1,0
"25001001",ESC-ZER,Centre públic Dep. i CEB,Escola Sant Bartomeu - ZER Espernallac,Bellmunt d'Urgell,LLE,LLE,1,1,0,0,0,0,2,0,0,2,0,0,1,0,1,1,0,0,0,0,0,1,1,0
"25001011",ESC,Centre públic Dep. i CEB,Escola Valeri Serra,Bellpuig,LLE,LLE,1,13,1,0,1,14,0,0,0,14,12,0,0,0,12,13,5,0,5,1,1,1,1,0
"25001059",ESC,Centre públic Dep. i CEB,Escola Mare de Déu de Talló,Bellver de Cerdanya,LLE,APA,1,9,1,0,1,1,8,0,0,9,1,7,0,0,8,9,1,7,8,1,1,1,1,0
"25001084",ESC,Centre públic Dep. i CEB,Escola Joaquim Palacín,Bellvís,LLE,LLE,1,9,1,2,3,5,0,0,0,5,5,0,0,0,5,6,0,0,0,3,3,1,1,0
"25001096",ESC,Centre públic Dep. i CEB,Escola Sant Joan,Benavent de Segrià,LLE,LLE,1,14,1,0,1,10,5,0,0,15,10,3,0,0,13,14,10,3,13,1,1,1,1,0
"25001126",ESC-ZER,Centre públic Dep. i CEB,Escola Vallmajor - ZER Elaia,Bovera,LLE,LLE,1,2,0,0,0,1,0,0,0,1,1,0,0,0,1,1,1,0,1,0,0,1,0,0
"25001138",ESC-ZER,Centre públic Dep. i CEB,Escola Casteth Leon - ZER Val d'Aran,Es Bòrdes,LLE,APA,1,1,1,0,1,0,1,0,0,1,0,0,0,0,0,1,0,0,0,1,1,1,0,0
"25001141",ESC,Centre públic Dep. i CEB,Escola Joan XXIII,Les Borges Blanques,LLE,LLE,1,18,0,0,0,23,2,0,0,25,18,0,0,0,18,18,18,0,18,0,0,1,1,0
"25001199",ESC,Centre públic Dep. i CEB,Escola Sant Ròc,Bossòst,LLE,APA,1,9,0,1,1,3,1,0,0,4,3,1,0,0,4,4,3,1,4,1,1,1,1,0
"25001229",ESC-ZER,Centre públic Dep. i CEB,Escola Dos Rius - ZER El Jonc,Camarasa,LLE,LLE,1,3,0,0,0,0,0,3,1,4,0,0,3,0,3,3,3,0,3,0,0,1,0,0
"25001242",ESC-ZER,Centre públic Dep. i CEB,Escola Castell-Ciutat - ZER Urgellet,Castellciutat (La Seu d'Urgell),LLE,APA,1,3,1,0,1,2,1,0,0,3,2,0,0,0,2,3,2,0,2,1,1,1,0,0
"25001254",ESC-ZER,Centre públic Dep. i CEB,Escola Timorell - ZER Vall de l'Aranyó,Castelldans,LLE,LLE,1,3,0,0,0,4,0,0,0,4,3,0,0,0,3,3,2,0,2,0,0,1,0,0
"25001266",ESC-ZER,Centre públic Dep. i CEB,Escola L'Estel - ZER Vent Serè,Castellnou de Seana,LLE,LLE,1,4,2,0,2,2,1,0,0,3,2,0,0,0,2,4,1,1,2,2,2,1,0,0
"25001278",ESC-ZER,Centre públic Dep. i CEB,Escola Santa Maria - ZER Serra Llarga,Castelló de Farfanya,LLE,LLE,1,2,1,1,2,3,1,0,0,4,1,0,0,0,1,2,0,0,0,1,1,1,0,0
"25001281",ESC-ZER,Centre públic Dep. i CEB,Escola El Terrall - ZER Espernallac,Castellserà,LLE,LLE,1,6,0,1,1,5,0,0,0,5,5,0,0,0,5,5,0,0,0,1,1,1,0,0
"25001291",ESC,Centre públic Dep. i CEB,Escola Jaume Balmes,Cervera,LLE,LLE,1,16,1,0,1,15,0,0,0,15,15,0,0,0,15,16,0,0,0,1,1,1,1,0
"25001311",INS,Centre públic Dep. i CEB,Institut Antoni Torroja,Cervera,LLE,LLE,1,16,2,0,2,6,0,0,0,6,6,0,0,0,6,8,6,0,6,2,2,1,1,0
"25001321",ESC,Centre públic Dep. i CEB,Escola Mossèn Josep Arques,Cervera,LLE,LLE,1,16,1,0,1,12,0,0,2,14,12,0,0,2,14,15,4,0,4,1,1,1,1,0
"25001333",ESC-ZER,Centre públic Dep. i CEB,Escola El Cérvol - ZER Riu Set,Cervià de les Garrigues,LLE,LLE,1,2,0,1,1,1,2,0,1,4,1,1,0,0,2,2,1,0,1,0,0,1,0,0
"25001357",ESC-ZER,Centre públic Dep. i CEB,Escola de Ciutadilla - ZER Guicivervi,Ciutadilla,LLE,LLE,1,1,1,1,2,0,0,0,0,0,0,0,0,0,0,1,0,0,0,1,1,1,0,0
"25001400",ESC-ZER,Centre públic Dep. i CEB,Escola Sant Climent - ZER Narieda,Coll de Nargó,LLE,APA,1,3,0,0,0,0,3,0,0,3,0,3,0,0,3,3,0,3,3,0,0,1,0,0
"25001424",ESC,Centre públic Dep. i CEB,Escola Sol Ixent,Corbins,LLE,LLE,1,15,3,2,5,8,1,0,0,9,8,1,0,0,9,12,8,1,9,5,4,1,1,0
"25001436",ESC-ZER,Centre públic Dep. i CEB,Escola Sol Naixent - ZER El Romaní,Cubells,LLE,LLE,1,1,0,0,0,0,0,1,0,1,0,0,1,0,1,1,0,0,0,0,0,1,1,0
"25001473",ESC-ZER,Centre públic Dep. i CEB,Escola Porcel de Cervera - ZER Pedrera,L'Espluga Calba,LLE,LLE,1,2,0,1,1,1,0,0,0,1,1,0,0,0,1,1,1,0,1,1,1,1,0,0
"25001539",ESC,Centre públic Dep. i CEB,Escola La Closa,Esterri d'Àneu,LLE,APA,1,9,1,0,1,4,4,0,0,8,4,4,0,0,8,9,4,4,8,1,1,1,1,0
"25001606",ESC,Centre públic Dep. i CEB,Escola Minyons d'Urgell,Fondarella,LLE,LLE,1,9,2,0,2,6,0,0,3,9,6,0,0,1,7,9,2,3,5,2,2,1,1,0
"25001618",ESC,Centre públic Dep. i CEB,Escola Guillem Isarn,La Fuliola,LLE,LLE,1,9,0,0,0,5,4,0,0,9,5,4,0,0,9,9,5,4,9,0,0,1,1,0
"25001692",ESC,Centre públic Dep. i CEB,Escola Francesc Arenes,Golmés,LLE,LLE,1,9,0,0,0,12,1,0,0,13,9,0,0,0,9,9,6,0,6,0,0,1,1,0
"25001709",ESC-ZER,Centre públic Dep. i CEB,Escola Santa Margarida - ZER Alt Berguedà,Gósol,CCE,CCE,1,1,0,0,0,0,0,0,0,0,0,0,0,0,0,0,0,0,0,0,0,1,0,1
"25001710",ESC-ZER,Centre públic Dep. i CEB,Escola de la Granadella - ZER Elaia,La Granadella,LLE,LLE,1,3,0,0,0,5,1,0,0,6,3,0,0,0,3,3,3,0,3,0,0,1,0,0
"25001722",ESC-ZER,Centre públic Dep. i CEB,Escola Sant Jaume - ZER L'Oliver,La Granja d'Escarp,LLE,LLE,1,4,1,0,1,0,0,5,0,5,0,0,3,0,3,4,0,0,0,1,1,1,0,0
"25001758",ESC-ZER,Centre públic Dep. i CEB,Escola de Guimerà - ZER Guicivervi,Guimerà,LLE,LLE,1,1,0,1,1,0,0,0,1,1,0,0,0,1,1,1,0,1,1,0,0,1,0,0
"25001761",ESC,Centre públic Dep. i CEB,Escola Ramon Faus i Esteve,Guissona,LLE,LLE,1,19,1,4,5,0,4,14,0,18,0,4,14,0,18,19,14,4,18,1,1,1,1,0
"25001795",ESC-ZER,Centre públic Dep. i CEB,Escola Sant Sebastià - ZER Serra Llarga,Ivars de Noguera,LLE,LLE,1,2,0,1,1,2,0,0,0,2,2,0,0,0,2,2,0,0,0,0,0,1,0,0
"25001801",ESC,Centre públic Dep. i CEB,Escola Mare de Déu de l'Horta,Ivars d'Urgell,LLE,LLE,1,9,2,1,3,6,0,2,0,8,6,0,1,0,7,9,7,0,7,2,2,1,1,0
"25001886",ESC-ZER,Centre públic Dep. i CEB,Escola Aeso - ZER Pallars Jussà,Isona (Isona i Conca Dellà),LLE,APA,1,4,0,0,0,4,0,0,0,4,4,0,0,0,4,4,0,0,0,0,0,1,0,0
"25001916",ESC-ZER,Centre públic Dep. i CEB,Escola L'Espígol - ZER Garrigues Altes,Juncosa,LLE,LLE,1,3,1,0,1,3,0,0,0,3,2,0,0,0,2,3,2,0,2,1,1,1,0,0
"25001928",ESC,Centre públic Dep. i CEB,Escola Manuel Ortiz i Castelló,Juneda,LLE,LLE,1,17,0,0,0,10,12,0,0,22,10,7,0,0,17,17,12,5,17,0,0,1,1,0
"25001953",ESC,Centre públic Dep. i CEB,Escola Enric Farreny,Lleida,LLE,LLE,1,9,1,0,1,8,1,0,0,9,8,0,0,0,8,9,3,1,4,1,1,1,1,0
"25001990",ESC-ZER,Centre públic Dep. i CEB,Escola Antoni Bergós - ZER L'Horta de Lleida,Butsènit (Lleida),LLE,LLE,1,2,0,0,0,0,0,2,0,2,0,0,2,0,2,2,2,0,2,0,0,1,0,0
"25002003",ESC,Centre públic Dep. i CEB,Escola Santa Maria de Gardeny,Lleida,LLE,LLE,1,15,3,0,3,12,3,0,0,15,12,0,0,0,12,15,12,0,12,3,3,1,1,0
"25002064",ESC,Centre públic Dep. i CEB,Escola Camps Elisis,Lleida,LLE,LLE,1,13,2,0,2,10,1,0,0,11,10,1,0,0,11,13,0,0,0,2,2,1,1,0
"25002076",ESC,Centre públic Dep. i CEB,Escola La Seu Vella,Lleida,LLE,LLE,1,9,1,7,8,2,0,2,2,6,2,0,2,2,6,7,0,0,0,3,3,1,1,0
"25002088",ESC,Centre públic Dep. i CEB,Escola Riu Segre,Lleida,LLE,LLE,1,18,1,0,1,28,0,0,0,28,17,0,0,0,17,18,0,0,0,1,1,1,1,0
"25002091",ESC,Centre públic Dep. i CEB,Escola Magí Morera i Galícia,Lleida,LLE,LLE,1,9,10,3,13,3,0,2,0,5,0,0,0,0,0,10,0,0,0,9,3,1,1,0
"25002106",ESC,Centre públic Dep. i CEB,Escola Pardinyes,Lleida,LLE,LLE,1,9,1,0,1,9,2,0,0,11,8,0,0,0,8,9,8,0,8,1,1,1,1,0
"25002121",ESC,Centre públic Dep. i CEB,Escola Príncep de Viana,Lleida,LLE,LLE,1,11,5,0,5,9,0,0,0,9,6,0,0,0,6,11,6,0,6,5,3,1,1,0
"25002131",ESC-ZER,Centre públic Dep. i CEB,Escola Creu del Batlle - ZER L'Horta de Lleida,Lleida,LLE,LLE,1,2,0,0,0,1,0,0,0,1,1,0,0,0,1,1,1,0,1,0,0,1,0,0
"25002222",IE,Concertada 30% NESE,FEDAC-Lleida,Lleida,LLE,LLE,0,19,0,0,0,0,0,0,0,0,19,0,0,0,19,19,0,0,0,0,0,0,1,0
"25002234",IE,Concertada 30% NESE,Santa Anna,Lleida,LLE,LLE,0,26,0,0,0,0,0,0,0,0,26,0,0,0,26,26,0,0,0,0,0,0,1,0
"25002431",IE,Concertada 30% NESE,Sagrada Família,Lleida,LLE,LLE,0,24,0,0,0,0,0,0,0,0,24,0,0,0,24,24,0,0,0,0,0,0,1,0
"25002623",ESC,Concertada 30% NESE,Sant Jaume,Lleida,LLE,LLE,0,9,0,0,0,0,0,0,0,0,9,0,0,0,9,9,0,0,0,0,0,0,1,0
"25002659",ESC,Centre públic Dep. i CEB,Escola Sant Josep de Calassanç,Lleida,LLE,LLE,1,9,1,0,1,9,0,0,0,9,8,0,0,0,8,9,6,0,6,1,1,1,1,0
"25002672",ESC,Centre públic Dep. i CEB,Escola de Pràctiques I,Lleida,LLE,LLE,1,9,1,0,1,6,3,0,0,9,6,2,0,0,8,9,0,3,3,1,1,1,1,0
"25002684",INS,Centre públic Dep. i CEB,Institut Samuel Gili i Gaya,Lleida,LLE,LLE,1,28,0,1,1,24,0,0,0,24,24,0,0,0,24,24,24,0,24,1,1,1,1,0
"25002696",INS,Centre públic Dep. i CEB,Institut Marius Torres,Lleida,LLE,LLE,1,36,2,1,3,24,5,0,0,29,24,5,0,0,29,31,0,0,0,3,3,1,1,0
"25002726",INS,Centre públic Dep. i CEB,Institut Guindàvols,Lleida,LLE,LLE,1,32,0,1,1,0,20,0,0,20,0,20,0,0,20,20,0,20,20,1,1,1,1,0
"25002787",INS,Centre públic Dep. i CEB,Institut Joan Oró,Lleida,LLE,LLE,1,34,4,0,4,18,4,0,0,22,18,4,0,0,22,26,0,0,0,4,4,1,1,0
"25002799",INS,Centre públic Dep. i CEB,Institut Caparrella,Lleida,LLE,LLE,1,45,4,2,6,18,2,15,0,35,18,2,15,0,35,39,0,0,0,6,6,1,1,0
"25002854",ESC-ZER,Centre públic Dep. i CEB,Escola El Segrià - ZER L'Horta de Lleida,Llívia (Lleida),LLE,LLE,1,6,0,0,0,2,0,0,2,4,2,0,0,2,4,4,2,2,4,0,0,1,0,0
"25002921",ESC-ZER,Centre públic Dep. i CEB,Escola El Vilot - ZER Ponent,Sucs (Lleida),LLE,LLE,1,5,0,0,0,3,0,2,0,5,3,0,2,0,5,5,3,0,3,0,0,1,0,0
"25002957",ESC,Centre públic Dep. i CEB,Escola Estudi Alejandro Casona,Les,LLE,APA,1,9,1,0,1,4,0,0,0,4,4,0,0,0,4,5,4,0,4,1,1,1,1,0
"25002970",ESC,Centre públic Dep. i CEB,Escola El Sitjar,Linyola,LLE,LLE,1,15,1,2,3,5,0,0,0,5,5,0,0,0,5,6,4,0,4,3,3,1,1,0
"25002982",ESC-ZER,Centre públic Dep. i CEB,Escola de Lladurs - ZER El Solsonès,Lladurs,CCE,CCE,1,2,1,0,1,1,0,0,0,1,1,0,0,0,1,2,0,0,0,1,1,1,0,0
"25003019",ESC-ZER,Centre públic Dep. i CEB,Escola Arc d'Adà - ZER L'Oliver,Llardecans,LLE,LLE,1,3,2,0,2,2,1,0,0,3,1,0,0,0,1,3,1,0,1,2,1,1,0,0
"25003032",ESC-ZER,Centre públic Dep. i CEB,Escola de Llavorsí - ZER Alt Pallars Sobirà,Llavorsí,LLE,APA,1,2,1,0,1,1,0,0,1,2,1,0,0,0,1,2,0,0,0,1,1,1,0,0
"25003056",ESC-ZER,Centre públic Dep. i CEB,Escola Portella Blanca - ZER Baridà-Batllia,Lles de Cerdanya,LLE,APA,1,2,0,0,0,0,1,0,0,1,0,1,0,0,1,1,0,0,0,0,0,1,0,0
"25003093",ESC-ZER,Centre públic Dep. i CEB,Escola de Llobera - ZER El Solsonès,Llobera,CCE,CCE,1,2,1,0,1,0,0,1,1,2,0,0,1,0,1,2,0,1,1,1,1,1,0,0
"25003111",ESC-ZER,Centre públic Dep. i CEB,Escola de Massalcoreig - ZER L'Oliver,Massalcoreig,LLE,LLE,1,3,1,0,1,1,1,0,0,2,1,1,0,0,2,3,1,1,2,1,1,1,0,0
"25003123",ESC-ZER,Centre públic Dep. i CEB,Escola Otogesa - ZER L'Oliver,Maials,LLE,LLE,1,5,0,1,1,3,1,0,0,4,3,1,0,0,4,4,3,1,4,1,1,1,0,0
"25003135",ESC-ZER,Centre públic Dep. i CEB,Escola Joan Ros i Porta - ZER El Jonc,Menàrguens,LLE,LLE,1,3,0,1,1,2,1,0,0,3,2,1,0,0,3,3,1,1,2,0,0,1,0,0
"25003147",ESC,Centre públic Dep. i CEB,Escola Sant Miquel,Miralcamp,LLE,LLE,1,9,0,0,0,0,7,0,3,10,0,7,0,2,9,9,0,9,9,0,0,1,1,0
"25003202",FP,Centre públic Dep. i CEB,Institut Mollerussa,Mollerussa,LLE,LLE,1,32,0,0,0,2,23,0,0,25,2,23,0,0,25,25,2,23,25,0,0,1,1,0
"25003238",ESC-ZER,Centre públic Dep. i CEB,Escola de Butsènit - ZER El Sió,Butsènit (Montgai),LLE,LLE,1,1,0,0,0,1,1,0,0,2,1,0,0,0,1,1,1,0,1,0,0,1,0,0
"25003241",ESC-ZER,Centre públic Dep. i CEB,Escola Colomina - ZER El Romaní,Montgai,LLE,LLE,1,2,1,0,1,0,0,0,1,1,0,0,0,1,1,2,0,1,1,1,1,1,0,0
"25003263",ESC-ZER,Centre públic Dep. i CEB,Escola Pere Sarret - ZER Baridà-Batllia,Martinet (Montellà i Martinet),LLE,APA,1,1,0,0,0,0,0,0,0,0,0,0,0,0,0,0,0,0,0,0,0,1,0,1
"25003275",ESC,Centre públic Dep. i CEB,Escola Ridolaina,Montellà (Montellà i Martinet),LLE,APA,1,8,0,0,0,1,0,3,0,4,1,0,3,0,4,4,4,0,4,0,0,1,1,0
"25003299",ESC,Centre públic Dep. i CEB,Escola Rosa Campà,Montferrer (Montferrer i Castellbò),LLE,APA,1,16,1,0,1,5,0,0,0,5,5,0,0,0,5,6,5,0,5,1,1,1,1,0
"25003305",ESC-ZER,Centre públic Dep. i CEB,Escola Sant Isidre - ZER La Coma,Montoliu de Lleida,LLE,LLE,1,3,0,0,0,3,0,0,0,3,3,0,0,0,3,3,3,0,3,0,0,1,0,0
"25003330",ESC-ZER,Centre públic Dep. i CEB,Escola Aiguadora - ZER El Solsonès,Navès,CCE,CCE,1,3,1,0,1,0,0,0,2,2,0,0,0,2,2,3,0,0,0,1,1,1,0,0
"25003469",ESC-ZER,Centre públic Dep. i CEB,Escola Miret i Sans - ZER Narieda,Organyà,LLE,APA,1,4,0,0,0,5,0,0,0,5,4,0,0,0,4,4,4,0,4,0,0,1,0,0
"25003470",ESC-ZER,Centre públic Dep. i CEB,Escola L'Espígol - ZER Montsec,Gerb (Os de Balaguer),LLE,LLE,1,3,0,0,0,0,0,3,0,3,0,0,3,0,3,3,3,0,3,0,0,1,0,0
"25003482",ESC-ZER,Centre públic Dep. i CEB,Escola Leandre Cristòfol - ZER Montsec,Os de Balaguer,LLE,LLE,1,2,0,1,1,0,0,0,1,1,0,0,0,1,1,1,0,1,1,1,1,1,0,0
"25003494",ESC,Centre públic Dep. i CEB,Escola Arnau Berenguer,El Palau d'Anglesola,LLE,LLE,1,10,0,0,0,10,7,0,0,17,10,0,0,0,10,10,10,0,10,0,0,1,1,0
"25003500",ESC-ZER,Centre públic Dep. i CEB,Escola de les Pallargues - ZER La Segarra,Els Plans de Sió,LLE,LLE,1,3,0,0,0,0,0,4,0,4,0,0,3,0,3,3,1,0,1,0,0,1,0,0
"25003536",ESC-ZER,Centre públic Dep. i CEB,Escola de la Coma - ZER El Solsonès,La Coma i la Pedra,CCE,CCE,1,1,1,0,1,0,0,0,0,0,0,0,1,0,1,2,0,0,0,0,0,1,1,0
"25003551",ESC-ZER,Centre públic Dep. i CEB,Escola Ramon Gombal - ZER Espernallac,Penelles,LLE,LLE,1,2,1,2,3,1,0,0,0,1,1,0,0,0,1,2,0,0,0,1,1,1,0,0
"25003585",ESC-ZER,Centre públic Dep. i CEB,Escola Sant Miquel - ZER Narieda,Peramola,LLE,APA,1,2,0,0,0,0,0,2,0,2,0,0,2,0,2,2,2,0,2,0,0,1,0,0
"25003627",ESC-ZER,Centre públic Dep. i CEB,Escola de Sant Climenç - ZER El Solsonès,Sant Climenç (Pinell de Solsonès),CCE,CCE,1,1,1,0,1,1,0,0,0,1,0,0,1,0,1,2,0,0,0,0,0,1,1,0
"25003652",ESC-ZER,Centre públic Dep. i CEB,Escola El Roser - ZER Plaurcén,El Poal,LLE,LLE,1,4,1,1,2,1,1,0,0,2,1,1,0,0,2,3,1,1,2,2,2,1,0,0
"25003676",ESC-ZER,Centre públic Dep. i CEB,Escola Els Set Focs - ZER Elaia,Bellaguarda,LLE,LLE,1,1,0,0,0,1,0,0,1,2,1,0,0,0,1,1,1,0,1,0,0,1,0,0
"25003688",ESC,Centre públic Dep. i CEB,Escola Els Raiers,La Pobla de Segur,LLE,APA,1,15,2,1,3,0,0,18,0,18,0,0,13,0,13,15,0,0,0,2,2,1,1,0
"25003718",ESC,Centre públic Dep. i CEB,Escola de Ponts,Ponts,LLE,LLE,1,16,1,2,3,12,0,0,0,12,12,0,0,0,12,13,0,0,0,3,3,1,1,0
"25003755",ESC,Centre públic Dep. i CEB,Escola Ribagorçana,El Pont de Suert,LLE,APA,1,10,1,0,1,7,2,0,0,9,7,2,0,0,9,10,7,2,9,1,1,1,1,0
"25003792",ESC-ZER,Centre públic Dep. i CEB,Escola Blanca de Villalonga - ZER Alt Segrià,La Portella,LLE,LLE,1,3,1,0,1,1,0,0,0,1,1,0,0,0,1,2,1,0,1,1,1,1,0,0
"25003809",ESC-ZER,Centre públic Dep. i CEB,Escola Montalbà - ZER Riu Corb,Preixana,LLE,LLE,1,1,0,0,0,3,0,0,0,3,1,0,0,0,1,1,1,0,1,0,0,1,0,0
"25003810",ESC-ZER,Centre públic Dep. i CEB,Escola de Preixens - ZER El Sió,Preixens,LLE,LLE,1,2,1,1,2,0,0,0,1,1,0,0,0,1,1,2,0,0,0,1,1,1,0,0
"25003822",ESC-ZER,Casos especials,Escola de Les Ventoses - ZER El Sió,Les Ventoses (Preixens),LLE,LLE,1,0,0,0,0,1,0,0,0,1,0,0,0,0,0,0,0,0,0,0,0,1,0,0
"25003846",ESC-ZER,Centre públic Dep. i CEB,Escola El Puig - ZER Baridà-Batllia,Prullans,LLE,APA,1,2,0,0,0,0,0,0,1,1,0,0,2,0,2,2,0,0,0,0,0,1,1,0
"25003858",ESC-ZER,Centre públic Dep. i CEB,Escola de Puigverd d'Agramunt - ZER El Sió,Puigverd d'Agramunt,LLE,LLE,1,1,0,0,0,1,0,0,0,1,0,0,1,0,1,1,0,0,0,0,0,1,1,0
"25003861",ESC,Centre públic Dep. i CEB,Escola Sant Jordi,Puigverd de Lleida,LLE,LLE,1,9,1,0,1,2,2,0,0,4,2,2,0,0,4,5,2,2,4,1,1,1,1,0
"25003871",ESC-ZER,Centre públic Dep. i CEB,Escola Montsent de Pallars - ZER Alt Pallars Sobirà,Rialp,LLE,APA,1,3,0,0,0,2,3,0,0,5,2,1,0,0,3,3,0,2,2,0,0,1,0,0
"25003895",ESC-ZER,Centre públic Dep. i CEB,Escola Els Minairons - ZER Alt Pallars Sobirà,Ribera de Cardós (Vall de Cardós),LLE,APA,1,4,2,0,2,1,0,1,0,2,1,0,1,0,2,4,2,0,2,2,2,1,0,0
"25003950",ESC-ZER,Centre públic Dep. i CEB,Escola Arnau Mir - ZER Urgellet,El Pla de Sant Tirs (Ribera d'Urgellet),LLE,APA,1,3,0,1,1,2,0,1,0,3,2,0,1,0,3,3,3,0,3,0,0,1,0,0
"25003974",ESC-ZER,Centre públic Dep. i CEB,Escola de Freixinet de Solsona - ZER El Solsonès,Riner,CCE,CCE,1,2,1,0,1,1,0,0,0,1,1,0,0,0,1,2,1,0,1,1,1,1,0,0
"25004000",ESC,Centre públic Dep. i CEB,Escola La Rosella,Rosselló,LLE,LLE,1,16,2,1,3,11,0,0,6,17,11,0,0,3,14,16,11,3,14,2,2,1,1,0
"25004024",ESC-ZER,Centre públic Dep. i CEB,Escola de Sanaüja - ZER La Segarra,Sanaüja,LLE,LLE,1,1,0,0,0,3,0,0,0,3,1,0,0,0,1,1,0,0,0,0,0,1,0,0
"25004036",ESC,Centre públic Dep. i CEB,Escola L'Estel,Sant Guim de Freixenet,LLE,LLE,1,9,0,0,0,8,7,0,0,15,8,1,0,0,9,9,8,1,9,0,0,1,1,0
"25004073",ESC,Centre públic Dep. i CEB,Escola Mare de Déu de la Mercè,Sant Ramon,LLE,LLE,1,9,2,0,2,0,0,2,0,2,0,0,2,0,2,4,0,0,0,2,2,1,1,0
"25004085",ESC-ZER,Centre públic Dep. i CEB,Escola Vall Ondara - ZER La Segarra,Els Hostalets (Ribera d'Ondara),LLE,LLE,1,3,0,0,0,3,0,0,0,3,3,0,0,0,3,3,3,0,3,0,0,1,0,0
"25004103",ESC-ZER,Centre públic Dep. i CEB,Escola El Tallat - ZER Riu Corb,Sant Martí de Maldà (Sant Martí de Riucorb),LLE,LLE,1,4,1,0,1,1,1,0,0,2,1,1,0,0,2,3,1,1,2,1,1,1,0,0
"25004115",ESC-ZER,Centre públic Dep. i CEB,Escola La Roca - ZER L'Eral,Sarroca de Lleida,LLE,LLE,1,1,0,0,0,0,1,0,0,1,0,1,0,0,1,1,0,1,1,0,0,1,0,0
"25004140",ESC,Centre públic Dep. i CEB,Escola Mossèn Albert Vives,La Seu d'Urgell,LLE,APA,1,19,12,0,12,3,0,15,0,18,3,0,4,0,7,19,7,0,7,12,5,1,1,0
"25004188",INS,Centre públic Dep. i CEB,Institut Joan Brudieu,La Seu d'Urgell,LLE,APA,1,30,0,0,0,28,0,0,0,28,28,0,0,0,28,28,0,0,0,0,0,1,1,0
"25004218",ESC,Centre públic Dep. i CEB,Escola Miquel Baró Daban,Seròs,LLE,LLE,1,10,2,0,2,11,0,0,0,11,8,0,0,0,8,10,0,0,0,2,2,1,1,0
"25004221",ESC-ZER,Centre públic Dep. i CEB,Escola El Timó - ZER Plaurcén,Sidamon,LLE,LLE,1,4,0,0,0,0,1,2,0,3,0,1,2,0,3,3,2,0,2,0,0,1,0,0
"25004231",ESC-ZER,Centre públic Dep. i CEB,Escola del Soleràs - ZER Garrigues Altes,El Soleràs,LLE,LLE,1,2,1,0,1,2,0,0,0,2,1,0,0,0,1,2,1,0,1,1,1,1,0,0
"25004243",ESC,Centre públic Dep. i CEB,Escola Setelsis,Solsona,CCE,CCE,1,20,0,0,0,16,3,0,0,19,16,3,0,0,19,19,6,0,6,0,0,1,1,0
"25004395",ESC,Centre públic Dep. i CEB,Escola Jaume Miret,Soses,LLE,LLE,1,9,1,0,1,7,0,0,2,9,7,0,0,1,8,9,3,1,4,1,1,1,1,0
"25004401",ESC-ZER,Centre públic Dep. i CEB,Escola El Roser - ZER La Coma,Sudanell,LLE,LLE,1,4,0,1,1,4,0,0,0,4,4,0,0,0,4,4,4,0,4,0,0,1,0,0
"25004413",ESC-ZER,Centre públic Dep. i CEB,Escola de Sunyer - ZER L'Eral,Sunyer,LLE,LLE,1,2,1,1,2,0,1,0,0,1,0,1,0,0,1,2,0,1,1,1,1,1,0,0
"25004462",ESC,Centre públic Dep. i CEB,Escola Jacint Verdaguer,Tàrrega,LLE,LLE,1,20,3,1,4,16,3,0,0,19,16,1,0,0,17,20,16,1,17,3,3,1,1,0
"25004486",IE,Concertada 30% NESE,Vedruna Tàrrega,Tàrrega,LLE,LLE,0,25,0,0,0,0,0,0,0,0,25,0,0,0,25,25,0,0,0,0,0,0,1,0
"25004498",INS,Centre públic Dep. i CEB,Institut Manuel de Pedrolo,Tàrrega,LLE,LLE,1,20,1,1,2,16,0,0,0,16,16,0,0,0,16,17,16,0,16,2,2,1,1,0
"25004516",EE,EE Privats,Santa Maria del Alba,Tàrrega,LLE,LLE,0,1,0,0,0,0,0,0,0,0,2,0,0,0,2,2,0,0,0,0,0,0,1,0
"25004528",INS,Centre públic Dep. i CEB,EA Ondara,Tàrrega,LLE,LLE,1,9,0,0,0,0,5,0,0,5,0,5,0,0,5,5,0,0,0,0,0,1,1,0
"25004531",ESC,Centre públic Dep. i CEB,Escola Àngel Guimerà,Tàrrega,LLE,LLE,1,18,1,0,1,18,0,4,0,22,17,0,0,0,17,18,17,0,17,1,1,1,1,0
"25004565",ESC,Centre públic Dep. i CEB,Escola Alfred Potrony,Térmens,LLE,LLE,1,8,0,0,0,1,0,3,2,6,1,0,3,2,6,6,1,2,3,0,0,1,1,0
"25004577",ESC-ZER,Centre públic Dep. i CEB,Escola de Tírvia - ZER Alt Pallars Sobirà,Tírvia,LLE,APA,1,1,0,0,0,0,0,0,1,1,0,0,0,1,1,1,0,1,1,0,0,1,0,0
"25004607",ESC,Centre públic Dep. i CEB,Escola Sant Gil,Torà,LLE,LLE,1,9,2,1,3,7,0,5,0,12,7,0,0,0,7,9,3,0,3,2,2,1,1,0
"25004644",ESC-ZER,Centre públic Dep. i CEB,Escola Espígol - ZER Riu Ondara,Tornabous,LLE,LLE,1,5,0,0,0,6,0,0,0,6,5,0,0,0,5,5,3,0,3,0,0,1,0,0
"25004656",ESC-ZER,Centre públic Dep. i CEB,Escola de Torrebesses - ZER L'Eral,Torrebesses,LLE,LLE,1,1,0,0,0,2,0,0,0,2,1,0,0,0,1,1,1,0,1,0,0,1,0,0
"25004711",ESC,Centre públic Dep. i CEB,Escola la Creu,Torrefarrera,LLE,LLE,1,19,1,0,1,20,0,0,0,20,18,0,0,0,18,19,18,0,18,1,1,1,1,0
"25004723",ESC,Centre públic Dep. i CEB,Escola La Bassa,Torregrossa,LLE,LLE,1,9,1,7,8,3,6,0,0,9,3,5,0,0,8,9,3,5,8,1,1,1,1,0
"25004747",ESC,Centre públic Dep. i CEB,Escola Carrassumada,Torres de Segre,LLE,LLE,1,9,0,2,2,7,0,0,0,7,7,0,0,0,7,7,0,0,0,2,2,1,1,0
"25004759",ESC-ZER,Centre públic Dep. i CEB,Escola El Roser - ZER Alt Segrià,Torre-serona,LLE,LLE,1,2,1,0,1,0,0,0,1,1,0,0,0,1,1,2,0,1,1,1,1,1,0,0
"25004772",ESC,Centre públic Dep. i CEB,Escola Valldeflors,Tremp,LLE,APA,1,18,13,0,13,0,0,7,0,7,0,0,5,0,5,18,0,0,0,13,5,1,1,0
"25004826",ESC-ZER,Centre públic Dep. i CEB,Escola de Tuixent - ZER Urgellet,Tuixén (Josa i Tuixén),LLE,APA,1,1,0,0,0,0,0,1,0,1,0,0,1,0,1,1,0,0,0,0,0,1,0,0
"25004851",ESC,Centre públic Dep. i CEB,Escola Salvador Espriu,Vallfogona de Balaguer,LLE,LLE,1,9,4,2,6,0,0,5,1,6,9,0,0,0,9,13,0,0,0,0,0,1,1,0
"25004863",ESC-ZER,Centre públic Dep. i CEB,Escola Jardí - ZER Guicivervi,Verdú,LLE,LLE,1,4,0,0,0,4,0,0,0,4,4,0,0,0,4,4,0,4,4,0,0,1,0,0
"25004929",ESC,Centre públic Dep. i CEB,Escola Garona,Vielha (Vielha e Mijaran),LLE,APA,1,23,0,0,0,18,4,0,0,22,18,4,0,0,22,22,18,4,22,0,0,1,1,0
"25004966",ESC-ZER,Centre públic Dep. i CEB,Escola Ramon Perelló - ZER Guicivervi,Vilagrassa,LLE,LLE,1,4,0,0,0,3,1,0,0,4,3,1,0,0,4,4,3,1,4,0,0,1,0,0
"25004981",ESC-ZER,Centre públic Dep. i CEB,Escola Vidal i Abad - ZER Alta Ribagorça,Vilaller,LLE,APA,1,3,0,1,1,3,0,0,0,3,3,0,0,0,3,3,0,0,0,0,0,1,0,0
"25005016",ESC,Centre públic Dep. i CEB,Escola Marinada,Vilanova de Bellpuig,LLE,LLE,1,9,0,5,5,5,0,0,2,7,5,0,0,2,7,7,0,0,0,2,2,1,1,0
"25005053",ESC-ZER,Centre públic Dep. i CEB,Escola Mare de Déu del Puig de Meià - ZER El Romaní,Vilanova de Meià,LLE,LLE,1,2,0,2,2,0,0,0,1,1,0,0,0,1,1,1,0,1,1,1,1,1,0,0
"25005065",ESC-ZER,Centre públic Dep. i CEB,Escola de Vilanova de Segrià - ZER Alt Segrià,Vilanova de Segrià,LLE,LLE,1,5,0,0,0,1,0,4,0,5,1,0,4,0,5,5,5,0,5,0,0,1,0,0
"25005077",ESC-ZER,Centre públic Dep. i CEB,Escola Mossèn Ton Clavé - ZER Vent Serè,Vila-sana,LLE,LLE,1,5,2,0,2,3,0,0,0,3,3,0,0,0,3,5,3,0,3,2,2,1,0,0
"25005090",ESC-ZER,Centre públic Dep. i CEB,Escola Mestral - ZER Argelaga,Vilanova de la Barca,LLE,LLE,1,5,0,0,0,4,1,0,0,5,4,1,0,0,5,5,4,1,5,0,0,1,0,0
"25005107",ESC-ZER,Centre públic Dep. i CEB,Escola Sant Bonifaci - ZER Riu Set,Vinaixa,LLE,LLE,1,3,1,0,1,2,0,0,0,2,2,0,0,0,2,3,2,0,2,1,1,1,0,0
"25005119",ESC,Centre públic Dep. i CEB,Escola Pinyana,Alfarràs,LLE,LLE,1,11,11,1,12,0,0,0,0,0,0,0,0,0,0,11,0,0,0,11,3,1,1,0
"25005120",ESC,Centre públic Dep. i CEB,Escola Teresa Bergadà,Alguaire,LLE,LLE,1,12,1,0,1,13,0,0,0,13,11,0,0,0,11,12,0,0,0,1,1,1,1,0
"25005144",ESC,Centre públic Dep. i CEB,Escola Àngel Serafí i Casanovas,Sort,LLE,APA,1,14,0,0,0,12,2,0,0,14,12,2,0,0,14,14,7,1,8,0,0,1,1,0
"25005171",ESC,Centre públic Dep. i CEB,Escola Mestre Ignasi Peraire,Mollerussa,LLE,LLE,1,17,15,0,15,11,0,0,0,11,2,0,0,0,2,17,2,0,2,15,5,1,1,0
"25005260",INS,Centre públic Dep. i CEB,Institut Ribera del Sió,Agramunt,LLE,LLE,1,19,3,0,3,5,7,0,0,12,5,7,0,0,12,15,0,0,0,3,3,1,1,0
"25005341",EE,EE Privats,Aremi,Lleida,LLE,LLE,0,1,0,0,0,0,0,0,0,0,1,0,0,0,1,1,0,0,0,0,0,0,1,0
"25005417",EE,EE Privats,Plançó,Lleida,LLE,LLE,0,1,0,0,0,0,0,0,0,0,1,0,0,0,1,1,0,0,0,0,0,0,1,0
"25005429",INS,Centre públic Dep. i CEB,Institut Els Planells,Artesa de Segre,LLE,LLE,1,14,0,0,0,0,2,0,0,2,0,2,0,0,2,2,0,0,0,0,0,1,1,0
"25005430",ESC,Centre públic Dep. i CEB,Escola Joan XXIII,Lleida,LLE,LLE,1,11,1,1,2,12,0,0,0,12,10,0,0,0,10,11,6,4,10,1,1,1,1,0
"25005442",FP,Centre públic Dep. i CEB,Institut Escola del Treball,Lleida,LLE,LLE,1,17,0,10,10,7,7,1,0,15,7,7,1,0,15,15,0,0,0,2,2,1,1,0
"25005454",INS,Centre públic Dep. i CEB,Institut Francesc Ribalta,Solsona,CCE,CCE,1,22,11,1,12,20,0,0,0,20,11,0,0,0,11,22,0,0,0,11,6,1,1,0
"25005466",EE,EE municipals,CEE Escoles Especials de la Llar de Sant Josep,Lleida,LLE,LLE,0,1,0,0,0,0,0,0,0,0,1,0,0,0,1,1,0,0,0,0,0,0,1,0
"25005533",ESC,Centre públic Dep. i CEB,Escola Pau Claris,La Seu d'Urgell,LLE,APA,1,12,2,0,2,12,0,0,2,14,10,0,0,0,10,12,10,0,10,2,2,1,1,0
"25005545",ESC,Centre públic Dep. i CEB,Escola Pompeu Fabra,Mollerussa,LLE,LLE,1,19,0,0,0,19,0,0,0,19,19,0,0,0,19,19,0,0,0,0,0,1,1,0
"25005557",EE,Centre públic Dep. i CEB,CEE Siloé,Mollerussa,LLE,LLE,1,3,5,1,6,1,0,1,0,2,0,0,0,0,0,5,0,0,0,3,1,1,1,0
"25005582",INS,Centre públic Dep. i CEB,Institut Terres de Ponent,Mollerussa,LLE,LLE,1,27,2,0,2,16,1,0,0,17,27,0,0,0,27,29,0,0,0,0,0,1,1,0
"25005673",ESC,Centre públic Dep. i CEB,Escola Joan Maragall,Lleida,LLE,LLE,1,12,1,0,1,0,13,0,0,13,0,11,0,0,11,12,0,11,11,1,1,1,1,0
"25005685",INS,Centre públic Dep. i CEB,Institut La Segarra,Cervera,LLE,LLE,1,33,1,18,19,12,1,2,0,15,12,1,2,0,15,16,0,0,0,18,9,1,1,0
"25005727",INS,Centre públic Dep. i CEB,Institut Almatà,Balaguer,LLE,LLE,1,30,5,0,5,26,2,0,0,28,25,0,0,0,25,30,0,0,0,5,5,1,1,0
"25005880",ESC,Centre públic Dep. i CEB,Escola Frederic Godas,Lleida,LLE,LLE,1,20,5,2,7,6,0,0,0,6,6,0,0,0,6,11,0,0,0,7,6,1,1,0
"25005892",ESC-ZER,Centre públic Dep. i CEB,Escola Maldanell - ZER Riu Corb,Maldà,LLE,LLE,1,1,0,1,1,1,0,0,0,1,1,0,0,0,1,1,0,0,0,0,0,1,0,0
"25005909",ESC-ZER,Casos especials,Escola Mossèn Ramon Muntanyola - ZER Riu Corb,Els Omells de Na Gaia,LLE,LLE,1,0,0,0,0,0,0,0,0,0,0,0,0,0,0,0,0,0,0,0,0,1,0,0
"25005910",ESC-ZER,Centre públic Dep. i CEB,Escola Abat Ruera - ZER Pedrera,Puiggròs,LLE,LLE,1,3,0,2,2,2,0,0,0,2,2,0,0,0,2,2,2,0,2,1,1,1,0,0
"25005983",ESC-ZER,Centre públic Dep. i CEB,Escola Sant Serni - ZER Baridà-Batllia,Prats i Sansor,LLE,APA,1,3,1,0,1,0,0,1,0,1,0,0,1,0,1,2,1,0,1,1,1,1,0,0
"25006033",APD,APD & FP Municipals no CEB,EA Municipal Leandre Cristòfol,Lleida,LLE,LLE,0,0,0,0,0,0,0,0,0,0,0,0,0,0,0,0,0,0,0,0,0,0,0,0
"25006069",ESC-ZER,Centre públic Dep. i CEB,Escola d'Ardèvol - ZER El Solsonès,Ardèvol (Pinós),CCE,CCE,1,2,1,0,1,0,0,0,1,1,0,0,0,1,1,2,0,1,1,1,1,1,0,0
"25006082",EE,EE Privats,L'Estel,Balaguer,LLE,LLE,0,1,0,0,0,0,0,0,0,0,1,0,0,0,1,1,0,0,0,0,0,0,1,0
"25006094",EE,EE Privats,Apromi,Juneda,LLE,LLE,0,1,0,0,0,0,0,0,0,0,1,0,0,0,1,1,0,0,0,0,0,0,1,0
"25006148",FP,Centre públic Dep. i CEB,Institut d'Ostalaria de Les-Val d'Aran,Les,LLE,APA,1,4,0,0,0,8,3,0,0,11,4,0,0,0,4,4,0,0,0,0,0,1,1,0
"25006215",FP,Casos especials,Institut Escola de Sobrestants,Tàrrega,LLE,LLE,0,0,0,0,0,0,0,0,0,0,0,0,0,0,0,0,0,0,0,0,0,0,0,0
"25006227",INS,Centre públic Dep. i CEB,Institut d'Almenar,Almenar,LLE,LLE,1,21,1,0,1,0,0,0,10,10,0,0,0,10,10,11,0,0,0,1,1,1,1,0
"25006239",INS,Centre públic Dep. i CEB,Institut d'Aran,Vielha (Vielha e Mijaran),LLE,APA,1,22,1,0,1,4,6,0,0,10,4,6,0,0,10,11,4,6,10,1,1,1,1,0
"25006240",INS,Centre públic Dep. i CEB,Institut El Pont de Suert,El Pont de Suert,LLE,APA,1,20,0,0,0,18,0,0,0,18,18,0,0,0,18,18,0,0,0,0,0,1,1,0
"25006252",EOI,Centre públic Dep. i CEB,EOI de Lleida,Lleida,LLE,LLE,1,122,0,1,1,22,0,0,0,22,22,0,0,0,22,22,0,0,0,1,1,1,1,0
"25006264",ESC,Centre públic Dep. i CEB,Escola Espiga,Lleida,LLE,LLE,1,18,0,3,3,18,2,0,0,20,18,0,0,0,18,18,18,0,18,0,0,1,1,0
"25006276",ESC,Centre públic Dep. i CEB,Escola Sant Jordi,Lleida,LLE,LLE,1,9,0,0,0,9,0,0,0,9,9,0,0,0,9,9,2,0,2,0,0,1,1,0
"25006288",INS,Centre públic Dep. i CEB,Institut de Tremp,Tremp,LLE,APA,1,22,1,2,3,9,11,0,0,20,9,11,0,0,20,21,9,11,20,2,2,1,1,0
"25006291",INS,Centre públic Dep. i CEB,Institut Hug Roger III,Sort,LLE,APA,1,20,3,0,3,0,12,0,2,14,0,12,0,2,14,17,0,0,0,3,3,1,1,0
"25006409",ESC,Centre públic Dep. i CEB,Escola Joc de la Bola,Lleida,LLE,LLE,1,18,19,0,19,0,1,3,0,4,0,0,0,0,0,19,0,0,0,18,5,1,1,0
"25006410",CFA,CFA Departament,CFA Segrià,Lleida,LLE,LLE,1,3,3,3,6,1,0,3,0,4,0,0,0,0,0,3,0,0,0,3,0,1,1,0
"25006483",INS,Centre públic Dep. i CEB,Institut Canigó,Almacelles,LLE,LLE,1,22,0,0,0,18,0,0,2,20,18,0,0,2,20,20,18,2,20,0,0,1,1,0
"25006495",INS,Centre públic Dep. i CEB,Institut Josep Lladonosa,Lleida,LLE,LLE,1,27,2,0,2,15,3,0,0,18,15,3,0,0,18,20,15,3,18,2,2,1,1,0
"25006501",ESC,Centre públic Dep. i CEB,Escola Alba,Corbins,LLE,LLE,1,18,0,0,0,18,0,0,0,18,18,0,0,0,18,18,18,0,18,0,0,1,1,0
"25006513",INS,Centre públic Dep. i CEB,Institut Manuel de Montsuar,Lleida,LLE,LLE,1,27,6,0,6,19,0,0,0,19,19,0,0,0,19,25,19,0,19,6,6,1,1,0
"25006525",INS,Centre públic Dep. i CEB,Institut Josep Vallverdú,Les Borges Blanques,LLE,LLE,1,39,1,0,1,25,0,0,0,25,25,0,0,0,25,26,25,0,25,1,1,1,1,0
"25006549",ESC-ZER,Centre públic Dep. i CEB,Escola d'Espluga de Serra - ZER Alta Ribagorça,Espluga de Serra (Tremp),LLE,APA,1,1,0,0,0,1,0,0,0,1,1,0,0,0,1,1,1,0,1,0,0,1,0,0
"25006574",INS,Centre públic Dep. i CEB,Institut de Ponts,Ponts,LLE,LLE,1,11,0,0,0,8,0,0,0,8,8,0,0,0,8,8,8,0,8,0,0,1,1,0
"25006598",INS,Centre públic Dep. i CEB,Institut Lo Pla d'Urgell,Bellpuig,LLE,LLE,1,23,3,0,3,17,0,0,0,17,17,0,0,0,17,20,17,0,17,3,3,1,1,0
"25006720",FP,Centre públic Dep. i CEB,Institut d'Hoteleria i Turisme,Lleida,LLE,LLE,1,13,0,0,0,3,1,3,0,7,3,1,3,0,7,7,6,1,7,0,0,1,1,0
"25006732",INS,Centre públic Dep. i CEB,Institut Torrevicens,Lleida,LLE,LLE,1,42,2,2,4,30,6,2,3,41,30,6,2,2,40,42,0,0,0,2,2,1,1,0
"25006744",EE,Centre públic Dep. i CEB,CEE Esperança,Lleida,LLE,LLE,1,3,6,0,6,1,4,0,0,5,0,0,0,0,0,6,0,0,0,3,1,1,1,0
"25006771",INS,Centre públic Dep. i CEB,Institut Ronda,Lleida,LLE,LLE,1,20,1,3,4,22,2,0,0,24,19,0,0,0,19,20,19,0,19,1,1,1,1,0
"25006781",INS,Centre públic Dep. i CEB,Institut Alfons Costafreda,Tàrrega,LLE,LLE,1,29,2,2,4,14,6,6,0,26,14,6,6,0,26,28,0,3,3,3,3,1,1,0
"25006926",EE,EE municipals,CEE Les Basses,Lleida,LLE,LLE,0,1,0,0,0,0,0,0,0,0,1,0,0,0,1,1,0,0,0,0,0,0,1,0
"25007025",INS,Centre públic Dep. i CEB,Institut Morelló,Esterri d'Àneu,LLE,APA,1,4,0,0,0,3,1,0,0,4,3,1,0,0,4,4,0,1,1,0,0,1,1,0
"25007153",INS,Centre públic Dep. i CEB,Institut d'Alcarràs,Alcarràs,LLE,LLE,1,27,5,0,5,13,6,0,0,19,13,6,0,0,19,24,0,6,6,5,5,1,1,0
"25007189",INS,Centre públic Dep. i CEB,Institut Maria Rúbies,Lleida,LLE,LLE,1,21,0,0,0,22,0,0,0,22,21,0,0,0,21,21,0,0,0,0,0,1,1,0
"25007499",INS,Centre públic Dep. i CEB,Institut l'Olivera,La Granadella,LLE,LLE,1,5,0,0,0,5,0,0,0,5,5,0,0,0,5,5,0,0,0,0,0,1,1,0
"25007505",INS,Centre públic Dep. i CEB,Institut de Guissona,Guissona,LLE,LLE,1,25,0,0,0,6,2,0,0,8,6,2,0,0,8,8,0,2,2,0,0,1,1,0
"25007517",INS,Centre públic Dep. i CEB,Institut La Serra,Mollerussa,LLE,LLE,1,22,0,0,0,14,2,0,0,16,14,2,0,0,16,16,0,0,0,0,0,1,1,0
"25007529",INS,Centre públic Dep. i CEB,Institut Seròs,Seròs,LLE,LLE,1,18,3,0,3,0,0,0,0,0,0,0,0,0,0,3,0,0,0,3,3,1,1,15
"25007611",CFA,CFA Departament,CFA Victorina Vila,Lleida,LLE,LLE,1,3,0,0,0,4,0,3,0,7,3,0,0,0,3,3,0,0,0,0,0,1,1,0
"25007700",INS,Centre públic Dep. i CEB,Institut Ermengol IV,Bellcaire d'Urgell,LLE,LLE,1,16,2,0,2,12,0,0,0,12,12,0,0,0,12,14,0,0,0,2,2,1,1,0
"25007992",ESC,Centre públic Dep. i CEB,Escola d'Almenar,Almenar,LLE,LLE,1,13,7,0,7,0,0,10,0,10,0,0,6,0,6,13,0,0,0,7,4,1,1,0
"25008212",ESC,Centre públic Dep. i CEB,Escola Pràctiques II,Lleida,LLE,LLE,1,18,1,20,21,6,0,3,0,9,6,0,3,0,9,10,9,0,9,9,5,1,1,0
"25008352",INS,Centre públic Dep. i CEB,Institut de La Pobla de Segur,La Pobla de Segur,LLE,APA,1,10,1,0,1,10,0,0,0,10,9,0,0,0,9,10,0,0,0,1,1,1,1,0
"25008406",AH,Aules hospitalàries,A. Hospitalària Hospital Universitari Arnau de Vilanova,Lleida,LLE,LLE,0,1,0,0,0,0,0,0,0,0,0,0,1,0,1,1,0,0,0,0,0,0,0,0
"25008467",FP,APD & FP Municipals no CEB,EFTE Centre Públic de Tècnics Esportius dera Val d'Aran,Salardú (Naut Aran),LLE,APA,0,12,0,0,0,0,0,0,0,0,12,0,0,0,12,12,0,0,0,0,0,0,1,0
"25008534",ESC-ZER,Centre públic Dep. i CEB,Escola de La Vall de Boí - ZER Alta Ribagorça,Barruera (La Vall de Boí),LLE,APA,1,5,0,0,0,6,1,0,0,7,5,0,0,0,5,5,5,0,5,0,0,1,0,0
"25008546",EOI,Centre públic Dep. i CEB,EOI de Tàrrega,Tàrrega,LLE,LLE,1,17,0,0,0,0,7,0,0,7,0,7,0,0,7,7,0,0,0,0,0,1,1,0
"25008558",EOI,Centre públic Dep. i CEB,EOI de La Seu d'Urgell,La Seu d'Urgell,LLE,APA,1,52,0,0,0,0,7,0,0,7,0,7,0,0,7,7,0,7,7,0,0,1,1,0
"25008561",CFA,CFA Departament,CFA Balaguer,Balaguer,LLE,LLE,1,1,0,1,1,0,3,0,0,3,1,0,0,0,1,1,0,0,0,0,0,1,1,0
"25008571",CFA,CFA Departament,CFA Joan Comorera,Cervera,LLE,LLE,1,2,0,0,0,4,0,0,0,4,2,0,0,0,2,2,0,0,0,0,0,1,1,0
"25008583",CFA,CFA Departament,CFA La Seu d'Urgell,La Seu d'Urgell,LLE,APA,1,2,0,0,0,0,0,0,0,0,2,0,0,0,2,2,0,0,0,0,0,1,1,0
"25008595",CFA,CFA Departament,CFA Tàrrega,Tàrrega,LLE,LLE,1,3,0,0,0,4,1,0,0,5,3,0,0,0,3,3,0,0,0,0,0,1,1,0
"25008625",CFA,CFA Departament,CFA Mollerussa,Mollerussa,LLE,LLE,1,3,0,1,1,0,3,0,0,3,3,0,0,0,3,3,0,0,0,0,0,1,1,0
"25008649",ESC,Centre públic Dep. i CEB,Escola Francesco Tonucci,Lleida,LLE,LLE,1,23,8,3,11,4,0,0,0,4,4,0,0,0,4,12,0,0,0,11,6,1,1,0
"25008741",CFA,CFA Departament,CFA Val d'Aran,Vielha (Vielha e Mijaran),LLE,APA,1,1,0,0,0,0,0,0,0,0,1,0,0,0,1,1,0,0,0,0,0,1,1,0
"25008753",CFA,CFA Departament,CFA Solsonès,Solsona,CCE,CCE,1,4,0,0,0,2,1,0,0,3,3,0,0,0,3,3,0,0,0,0,0,1,1,0
"25008765",ESC-ZER,Centre públic Dep. i CEB,Escola La Vall Fosca - ZER Pallars Jussà,La Plana de Mont-ros (La Torre de Cabdella),LLE,APA,1,3,0,0,0,5,0,0,0,5,3,0,0,0,3,3,3,0,3,0,0,1,0,0
"25008777",ESC,Centre públic Dep. i CEB,Escola Parc de l'Aigua,Lleida,LLE,LLE,1,18,14,10,24,3,1,6,0,10,3,1,0,0,4,18,4,0,4,14,5,1,1,0
"25008789",ESC,Centre públic Dep. i CEB,Escola Mont-roig,Balaguer,LLE,LLE,1,12,1,0,1,11,0,0,0,11,11,0,0,0,11,12,0,0,0,1,1,1,1,0
"25008790",ESC,Centre públic Dep. i CEB,Escola Maria-Mercè Marçal,Tàrrega,LLE,LLE,1,16,3,0,3,0,0,0,14,14,0,0,0,13,13,16,0,13,13,3,3,1,1,0
"25008893",ESC,Centre públic Dep. i CEB,Escola Parc del Saladar,Alcarràs,LLE,LLE,1,24,6,0,6,19,0,0,0,19,18,0,0,0,18,24,6,0,6,6,6,1,1,0
"25008923",CFA,CFA Departament,CFA Enric Granados,Lleida,LLE,LLE,1,8,0,0,0,0,0,0,0,0,3,0,0,0,3,3,0,0,0,0,0,1,1,0
"25008935",ESC-ZER,Centre públic Dep. i CEB,Escola La Ràpita - ZER El Jonc,La Ràpita (Vallfogona de Balaguer),LLE,LLE,1,3,0,0,0,3,1,0,0,4,3,0,0,0,3,3,3,0,3,0,0,1,0,0
"25008959",CJJ,Justícia juvenil,C.Educ.Justícia El Segre,Lleida,LLE,LLE,0,3,2,0,2,0,0,0,0,0,0,0,3,0,3,5,0,0,0,0,0,0,1,0
"25008984",CFA,CFA Departament,CFA Tremp,Tremp,LLE,APA,1,1,0,1,1,1,0,0,1,2,1,0,0,0,1,1,0,0,0,0,0,1,1,0
"25009034",ESC,Centre públic Dep. i CEB,Escola Ciutat Jardí,Lleida,LLE,LLE,1,18,0,10,10,10,1,0,0,11,10,1,0,0,11,11,10,1,11,7,5,1,1,0
"25009071",ESC,Centre públic Dep. i CEB,Escola Països Catalans,Lleida,LLE,LLE,1,18,0,0,0,0,3,0,0,3,0,3,0,0,3,3,0,3,3,0,0,1,1,0
"25009095",ESC,Centre públic Dep. i CEB,Escola Les Savines,Cervera,LLE,LLE,1,9,1,0,1,3,6,0,0,9,3,5,0,0,8,9,3,5,8,1,1,1,1,0
"25009101",ESC,Centre públic Dep. i CEB,Escola El Vinyet,Solsona,CCE,CCE,1,9,0,0,0,9,0,0,0,9,9,0,0,0,9,9,0,0,0,0,0,1,1,0
"25009113",ESC,Centre públic Dep. i CEB,Escola Mestre Ramon Estadella i Torradeflot,Guissona,LLE,LLE,1,13,2,0,2,15,2,0,0,17,11,0,0,0,11,13,11,0,11,2,2,1,1,0
"25009186",INS,Centre públic Dep. i CEB,Institut La Valira,La Seu d'Urgell,LLE,APA,1,10,1,0,1,8,1,0,0,9,8,1,0,0,9,10,8,1,9,1,1,1,1,0
"25009344",ESC,Centre públic Dep. i CEB,Escola La Mitjana,Lleida,LLE,LLE,1,18,0,0,0,14,4,0,0,18,14,4,0,0,18,18,14,0,14,0,0,1,1,0
"25009356",ESC,Centre públic Dep. i CEB,Escola Les Arrels,Mollerussa,LLE,LLE,1,10,1,4,5,7,0,0,0,7,7,0,0,0,7,8,0,0,0,3,3,1,1,0
"25009368",ESC-ZER,Centre públic Dep. i CEB,Escola La Valira-ZER Urgellet,La Seu d'Urgell,LLE,APA,1,1,0,0,0,0,1,0,0,1,0,1,0,0,1,1,0,1,1,0,0,1,0,0
"25009681",CFA,CFA Municipals no CEB,CFA del Pont de Suert,El Pont de Suert,LLE,APA,0,1,0,0,0,0,0,0,0,0,1,0,0,0,1,1,0,0,0,0,0,0,1,0
"25009721",INS,Centre públic Dep. i CEB,Institut d'Alpicat,Alpicat,LLE,LLE,1,10,6,0,6,0,0,1,5,6,0,0,1,3,4,10,0,0,0,6,3,1,1,0
"25009733",INS,Centre públic Dep. i CEB,Institut Joan Solà,Torrefarrera,LLE,LLE,1,19,8,0,8,16,3,0,0,19,11,0,0,0,11,19,0,0,0,8,5,1,1,0
"25009800",ESC-ZER,Centre públic Dep. i CEB,Escola Torrelameu - ZER Argelaga,Torrelameu,LLE,LLE,1,3,1,0,1,3,0,0,0,3,2,0,0,0,2,3,0,0,0,1,1,1,0,0
"25009836",INS,Centre públic Dep. i CEB,Institut La Mitjana,Lleida,LLE,LLE,1,19,1,7,8,18,0,0,0,18,18,0,0,0,18,19,0,0,0,1,1,1,1,0
"25010085",ESC-ZER,Centre públic Dep. i CEB,Escola Josep Mañé i Gavaldà - ZER Ponent,Raïmat (Lleida),LLE,LLE,1,3,0,0,0,0,2,0,2,4,0,2,0,1,3,3,0,3,3,0,0,1,0,0
"25010127",INS,Centre públic Dep. i CEB,Institut Castell dels Templers,Lleida,LLE,LLE,1,11,0,0,0,4,0,9,0,13,4,0,7,0,11,11,0,0,0,0,0,1,1,0
"25010188",INS,Concertada 30% NESE,Les Heures,Lleida,LLE,LLE,0,4,0,0,0,0,0,0,0,0,4,0,0,0,4,4,0,0,0,0,0,0,1,0
"25010231",ESC-ZER,Centre públic Dep. i CEB,Escola de Salàs de Pallars - ZER Pallars Jussà,Salàs de Pallars,LLE,APA,1,3,1,0,1,3,1,0,0,4,2,0,0,0,2,3,0,1,1,1,1,1,0,0
"25010280",IE,Centre públic Dep. i CEB,Institut Escola Torre Queralt,Lleida,LLE,LLE,1,18,3,4,7,0,0,5,0,5,0,0,5,0,5,8,0,0,0,7,5,1,1,0
"25010310",INS,Centre públic Dep. i CEB,Institut de Mollerussa IV,Mollerussa,LLE,LLE,1,13,10,0,10,0,0,0,0,0,0,0,0,0,0,10,0,0,0,10,4,1,1,3
"25010334",IE,Centre públic Dep. i CEB,Institut Escola Magraners,Lleida,LLE,LLE,1,14,4,0,4,7,1,0,0,8,7,1,0,0,8,12,7,1,8,4,4,1,1,0
"25010358",IE,Centre públic Dep. i CEB,Institut Escola Vall de Lord,Sant Llorenç de Morunys,CCE,CCE,1,13,4,4,8,0,5,0,2,7,0,5,0,2,7,11,2,5,7,6,4,1,1,0
"25010361",INS,Centre públic Dep. i CEB,Institut Centre d'Esports de Muntanya del Pallars,La Pobla de Segur,LLE,APA,1,2,0,0,0,4,2,2,2,10,2,0,0,0,2,2,2,0,2,0,0,1,1,0
"25010383",IE,Centre públic Dep. i CEB,Institut Escola d'Oliana,Oliana,LLE,APA,1,13,0,3,3,14,1,0,0,15,13,0,0,0,13,13,0,0,0,0,0,1,1,0
"25010413",ESC,Centre públic Dep. i CEB,Escola Balàfia-Pinyana,Lleida,LLE,LLE,0,19,0,0,0,0,0,0,0,0,0,0,0,0,0,0,0,0,0,0,0,1,1,19
"25010450",INS,Obre el curs 2023-24,Institut Nou Alcarràs,Alcarràs,LLE,LLE,0,3,0,0,0,0,0,0,0,0,3,0,0,0,3,3,0,0,0,0,0,1,1,0
"43000020",ESC,Centre públic Dep. i CEB,Escola Sant Miquel,El Pla de Manlleu (Aiguamúrcia),TAR,TAR,1,9,1,1,2,2,1,0,0,3,2,1,0,0,3,4,2,0,2,2,2,1,1,0
"43000081",ESC,Centre públic Dep. i CEB,Escola Joan Baptista Serra,Alcanar,TEB,TEB,1,27,21,0,21,14,4,0,0,18,6,0,0,0,6,27,0,1,1,21,7,1,1,0
"43000135",ESC,Centre públic Dep. i CEB,Escola Mare de Déu del Remei,Alcover,TAR,TAR,1,22,1,0,1,24,0,0,0,24,21,0,0,0,21,22,0,0,0,1,1,1,1,0
"43000184",ESC-ZER,Centre públic Dep. i CEB,Escola Teresa Salvat i Llauradó - ZER Baix Camp Nord,L'Aleixar,TAR,TAR,1,5,1,0,1,0,0,3,2,5,0,0,3,1,4,5,3,1,4,1,1,1,0,0
"43000214",ESC,Centre públic Dep. i CEB,Escola Josep Fusté,Alforja,TAR,TAR,1,9,6,5,11,5,0,0,0,5,3,0,0,0,3,9,2,0,2,6,3,1,1,0
"43000226",ESC-ZER,Centre públic Dep. i CEB,Escola La Barquera - ZER Atzavara,Alió,TAR,TAR,1,2,1,1,2,1,0,1,0,2,1,0,0,0,1,2,0,0,0,1,1,1,0,0
"43000251",ESC,Centre públic Dep. i CEB,Escola La Portalada,Altafulla,TAR,TAR,1,19,0,2,2,18,0,0,0,18,18,0,0,0,18,18,0,0,0,1,1,1,1,0
"43000263",ESC,Centre públic Dep. i CEB,Escola Sant Jordi,L'Ametlla de Mar,TEB,TEB,1,22,0,0,0,22,1,0,0,23,22,0,0,0,22,22,10,0,10,0,0,1,1,0
"43000275",ESC,Centre públic Dep. i CEB,Escola Miquel Granell,Amposta,TEB,TEB,1,18,0,8,8,16,2,0,0,18,16,2,0,0,18,18,0,2,2,0,0,1,1,0
"43000329",INS,Centre públic Dep. i CEB,Institut Ramon Berenguer IV,Amposta,TEB,TEB,1,28,1,20,21,4,0,5,1,10,4,0,5,1,10,11,0,1,1,18,8,1,1,0
"43000378",ESC,Centre públic Dep. i CEB,Escola Sant Julià,L'Arboç,TAR,PEN,1,21,0,0,0,0,19,0,0,19,0,19,0,0,19,19,0,19,19,0,0,1,1,0
"43000421",ESC-ZER,Centre públic Dep. i CEB,Escola La Miranda - ZER Ports-Algars,Arnes,TEB,TEB,1,3,1,0,1,0,0,2,1,3,0,0,2,0,2,3,1,1,2,1,1,1,0,0
"43000433",ESC,Centre públic Dep. i CEB,Escola Sant Miquel,Ascó,TEB,TEB,1,9,3,0,3,8,1,0,0,9,6,0,0,0,6,9,3,0,3,3,3,1,1,0
"43000470",ESC-ZER,Centre públic Dep. i CEB,Escola Valldemur - ZER Conca de Barberà,Barberà de la Conca,TAR,TAR,1,4,1,0,1,3,0,0,0,3,3,0,0,0,3,4,3,0,3,1,1,1,0,0
"43000512",ESC-ZER,Centre públic Dep. i CEB,Escola El Sarraí - ZER Baix Priorat,Bellmunt del Priorat,TAR,TAR,1,1,1,0,1,0,0,0,0,0,0,0,1,0,1,2,0,0,0,0,0,1,1,0
"43000548",ESC,Centre públic Dep. i CEB,Escola La Muntanyeta,Bellvei,TAR,PEN,1,13,2,1,3,13,0,0,0,13,11,0,0,0,11,13,11,0,11,2,2,1,1,0
"43000551",ESC-ZER,Centre públic Dep. i CEB,Escola Llorenç Vallespí i Vidiella - ZER Riu i Serra,Benifallet,TEB,TEB,1,3,1,0,1,3,0,0,0,3,2,0,0,0,2,3,2,0,2,1,1,1,0,0
"43000561",ESC-ZER,Centre públic Dep. i CEB,Escola Antoni Nat - ZER Benissanet-Miravet,Benissanet,TEB,TEB,1,6,1,2,3,5,1,0,0,6,5,0,0,0,5,6,3,1,4,1,1,1,0,0
"43000597",ESC,Centre públic Dep. i CEB,Escola Ull del Vent,La Bisbal del Penedès,TAR,PEN,1,17,0,0,0,16,1,0,0,17,16,1,0,0,17,17,16,1,17,0,0,1,1,0
"43000603",ESC-ZER,Centre públic Dep. i CEB,Escola de Blancafort - ZER Poblet,Blancafort,TAR,TAR,1,2,1,0,1,2,0,0,0,2,1,0,0,0,1,2,1,0,1,1,1,1,0,0
"43000615",ESC-ZER,Centre públic Dep. i CEB,Escola L'Estel - ZER Els Ceps,Bonastre,TAR,PEN,1,4,1,0,1,0,4,0,0,4,0,3,0,0,3,4,0,1,1,1,1,1,0,0
"43000627",ESC,Centre públic Dep. i CEB,Escola Rocabruna,Les Borges del Camp,TAR,TAR,1,9,0,0,0,9,0,0,0,9,9,0,0,0,9,9,3,0,3,0,0,1,1,0
"43000639",ESC-ZER,Centre públic Dep. i CEB,Escola Sant Blai - ZER Terra Alta-Centre,Bot,TEB,TEB,1,3,1,0,1,3,1,0,0,4,2,0,0,0,2,3,2,0,2,1,1,1,0,0
"43000640",ESC,Centre públic Dep. i CEB,Escola Mare de Déu de la Candela,Botarell,TAR,TAR,1,9,1,1,2,0,8,0,0,8,0,8,0,0,8,9,0,8,8,1,1,1,1,0
"43000652",ESC-ZER,Centre públic Dep. i CEB,Escola Sant Jaume de Bràfim - ZER Atzavara,Bràfim,TAR,TAR,1,5,1,0,1,0,4,0,0,4,0,4,0,0,4,5,0,2,2,1,1,1,0,0
"43000676",ESC-ZER,Centre públic Dep. i CEB,Escola El Castell - ZER Montsant,Cabacés,TAR,TAR,1,2,1,0,1,0,2,0,0,2,0,1,0,0,1,2,0,0,0,1,1,1,0,0
"43000688",ESC-ZER,Centre públic Dep. i CEB,Escola de Cabra del Camp - ZER La Parellada,Cabra del Camp,TAR,TAR,1,3,1,0,1,1,3,0,0,4,1,1,0,0,2,3,1,1,2,1,1,1,0,0
"43000706",ESC,Centre públic Dep. i CEB,Escola Santa Creu de Calafell,Calafell,TAR,PEN,1,27,2,4,6,21,0,0,0,21,21,0,0,0,21,23,0,0,0,6,6,1,1,0
"43000721",ESC,Centre públic Dep. i CEB,Escola Mossèn Jacint Verdaguer,Segur de Calafell (Calafell),TAR,PEN,1,21,0,4,4,17,0,0,0,17,17,0,0,0,17,17,17,0,17,4,4,1,1,0
"43000779",INS,Centre públic Dep. i CEB,Institut Ramon Berenguer IV,Cambrils,TAR,TAR,1,29,1,0,1,24,1,0,0,25,24,1,0,0,25,26,24,1,25,1,1,1,1,0
"43000792",ESC-ZER,Centre públic Dep. i CEB,Escola Sant Isidre - ZER Les Vinyes,Capçanes,TAR,TAR,1,2,1,0,1,0,0,0,1,1,0,0,0,1,1,2,0,1,1,1,1,1,0,0
"43000809",ESC-ZER,Centre públic Dep. i CEB,Escola La Gessera - ZER Ports-Algars,Caseres,TEB,TEB,1,1,1,0,1,0,0,0,1,1,0,0,1,0,1,2,0,0,0,0,0,1,1,0
"43000871",ESC,Centre públic Dep. i CEB,Escola Maria Jesús Ortí i Abella,La Sénia,TEB,TEB,1,21,19,2,21,0,1,17,2,20,0,1,1,0,2,21,2,0,2,19,6,1,1,0
"43000895",ESC,Centre públic Dep. i CEB,Escola Mossèn Ramon Bergadà,Constantí,TAR,TAR,1,18,0,1,1,14,0,0,4,18,14,0,0,4,18,18,0,0,0,0,0,1,1,0
"43000950",ESC-ZER,Centre públic Dep. i CEB,Escola Doctor Ferran - ZER Terra Alta-Centre,Corbera d'Ebre,TEB,TEB,1,3,1,0,1,1,2,0,0,3,1,1,0,0,2,3,1,1,2,1,1,1,0,0
"43000998",ESC,Centre públic Dep. i CEB,Escola Pompeu Fabra,Cunit,TAR,PEN,1,15,0,0,0,13,1,0,0,14,13,1,0,0,14,14,6,1,7,0,0,1,1,0
"43001000",ESC,Centre públic Dep. i CEB,Escola de Xerta,Xerta,TEB,TEB,1,9,1,0,1,5,0,0,0,5,5,0,0,0,5,6,3,0,3,1,1,1,1,0
"43001036",ESC,Centre públic Dep. i CEB,Escola Martí Poch,L'Espluga de Francolí,TAR,TAR,1,9,1,0,1,9,2,0,0,11,8,0,0,0,8,9,0,0,0,1,1,1,1,0
"43001051",ESC,Centre públic Dep. i CEB,Escola Antoni Vilanova,Falset,TAR,TAR,1,15,0,0,0,16,1,0,0,17,15,0,0,0,15,15,0,1,1,0,0,1,1,0
"43001097",ESC-ZER,Centre públic Dep. i CEB,Escola Los Castellets - ZER Terra Alta Nord,La Fatarella,TEB,TEB,1,3,1,0,1,0,0,0,3,3,0,0,0,2,2,3,0,0,0,1,1,1,0,0
"43001115",ESC-ZER,Centre públic Dep. i CEB,Escola Mare de Déu de l'Esperança - ZER La Parellada,Figuerola del Camp,TAR,TAR,1,3,1,0,1,3,0,0,0,3,2,0,0,0,2,3,2,0,2,1,1,1,0,0
"43001127",ESC,Centre públic Dep. i CEB,Escola Enric Grau i Fontserè,Flix,TEB,TEB,1,14,6,1,7,14,0,0,0,14,8,0,0,0,8,14,6,0,6,6,4,1,1,0
"43001231",ESC,Centre públic Dep. i CEB,Escola Puig Cavaller,Gandesa,TEB,TEB,1,17,8,0,8,0,17,0,0,17,0,9,0,0,9,17,0,9,9,8,5,1,1,0
"43001280",ESC-ZER,Centre públic Dep. i CEB,Escola Pàmies - ZER La Font de l'Aiguadí,Ginestar,TEB,TEB,1,3,1,0,1,0,1,0,2,3,0,1,0,1,2,3,0,2,2,1,1,1,0,0
"43001310",ESC-ZER,Centre públic Dep. i CEB,Escola Llicorella - ZER L'Aglà,Gratallops,TAR,TAR,1,1,1,0,1,0,0,0,1,1,0,0,0,0,0,1,0,0,0,1,1,1,0,0
"43001334",ESC-ZER,Centre públic Dep. i CEB,Escola Sant Feliu - ZER Les Vinyes,Els Guiamets,TAR,TAR,1,1,1,0,1,0,0,0,1,1,0,0,0,0,0,1,0,0,0,1,1,1,0,0
"43001346",ESC,Centre públic Dep. i CEB,Escola Montsagre,Horta de Sant Joan,TEB,TEB,1,4,4,0,4,0,0,3,2,5,4,0,0,0,4,8,0,0,0,0,0,1,1,0
"43001361",ESC,Centre públic Dep. i CEB,Escola Les Cometes,Llorenç del Penedès,TAR,PEN,1,15,0,0,0,6,10,0,0,16,6,9,0,0,15,15,6,9,15,0,0,1,1,0
"43001383",ESC-ZER,Centre públic Dep. i CEB,Escola Anicet Villar - ZER Les Vinyes,Marçà,TAR,TAR,1,2,1,0,1,0,0,0,1,1,0,0,0,1,1,2,0,1,1,1,1,1,0,0
"43001395",ESC-ZER,Centre públic Dep. i CEB,Escola Teresa Subirats i Mestre - ZER Montsià,Mas de Barberans,TEB,TEB,1,3,0,1,1,3,0,0,0,3,3,0,0,0,3,3,0,0,0,0,0,1,0,0
"43001437",ESC-ZER,Centre públic Dep. i CEB,Escola Rosa Gisbert - ZER Montsià,Masdenverge,TEB,TEB,1,5,1,0,1,5,0,0,0,5,4,0,0,0,4,5,4,0,4,1,1,1,0,0
"43001462",ESC-ZER,Centre públic Dep. i CEB,Escola Els Til·lers - ZER El Francolí,La Masó,TAR,TAR,1,2,1,0,1,0,0,1,0,1,0,0,1,0,1,2,1,0,1,1,1,1,0,0
"43001498",ESC-ZER,Centre públic Dep. i CEB,Escola Onze de Setembre - ZER Baix Priorat,El Masroig,TAR,TAR,1,2,1,0,1,0,0,0,2,2,0,0,0,1,1,2,0,0,0,1,1,1,0,0
"43001553",ESC,Centre públic Dep. i CEB,Escola Les Muralles,Montblanc,TAR,TAR,1,20,4,0,4,18,1,0,2,21,16,0,0,0,16,20,16,0,16,4,4,1,1,0
"43001565",EE,EE Privats,Tilmar,Montblanc,TAR,TAR,0,1,0,0,0,0,0,0,0,0,2,0,0,0,2,2,0,0,0,0,0,0,1,0
"43001607",ESC,Centre públic Dep. i CEB,Escola Josep M. Soler i Gené,Montbrió del Camp,TAR,TAR,1,16,4,0,4,15,0,0,0,15,12,0,0,0,12,16,12,0,12,4,4,1,1,0
"43001656",ESC,Centre públic Dep. i CEB,Escola Teresa Godes i Domènech,La Juncosa del Montmell (El Montmell),TAR,PEN,1,9,1,0,1,7,1,0,0,8,7,1,0,0,8,9,0,1,1,1,1,1,1,0
"43001668",ESC,Centre públic Dep. i CEB,Escola Mare de Déu de la Roca,Mont-roig del Camp,TAR,TAR,1,19,0,2,2,20,0,0,0,20,19,0,0,0,19,19,19,0,19,0,0,1,1,0
"43001681",ESC,Centre públic Dep. i CEB,Escola Lluís Viñas i Viñoles,Móra d'Ebre,TEB,TEB,1,17,0,6,6,14,1,4,0,19,14,1,2,0,17,17,7,1,8,0,0,1,1,0
"43001735",ESC,Centre públic Dep. i CEB,Escola Ventura Gassol,El Morell,TAR,TAR,1,20,2,1,3,25,0,4,0,29,18,0,0,0,18,20,18,0,18,2,2,1,1,0
"43001796",ESC,Centre públic Dep. i CEB,Escola Sant Sebastià,Nulles,TAR,TAR,1,5,0,0,0,4,0,0,0,4,4,0,0,0,4,4,4,0,4,0,0,1,1,0
"43001826",ESC,Centre públic Dep. i CEB,Escola Sant Sebastià,Els Pallaresos,TAR,TAR,1,13,2,2,4,13,1,0,0,14,11,0,0,0,11,13,11,0,11,2,2,1,1,0
"43001851",ESC-ZER,Centre públic Dep. i CEB,Escola Sant Roc - ZER Riu i Serra,Paüls,TEB,TEB,1,3,1,0,1,3,0,0,0,3,2,0,0,0,2,3,1,0,1,1,1,1,0,0
"43001942",ESC-ZER,Centre públic Dep. i CEB,Escola Cèsar Martinell - ZER Terra Alta-Centre,El Pinell de Brai,TEB,TEB,1,4,0,2,2,4,0,0,0,4,4,0,0,0,4,4,4,0,4,0,0,1,0,0
"43001954",ESC-ZER,Centre públic Dep. i CEB,Escola Antoni Tous - ZER Conca de Barberà,Pira,TAR,TAR,1,4,1,0,1,0,0,2,1,3,0,0,2,1,3,4,0,0,0,1,1,1,0,0
"43001966",ESC,Centre públic Dep. i CEB,Escola Sant Ramon,El Pla de Santa Maria,TAR,TAR,1,9,1,0,1,0,9,0,0,9,0,8,0,0,8,9,0,8,8,1,1,1,1,0
"43002016",ESC-ZER,Centre públic Dep. i CEB,Escola L'Ametller - ZER Terra Alta Nord,La Pobla de Massaluca,TEB,TEB,1,2,1,0,1,0,1,0,0,1,0,1,0,0,1,2,0,0,0,1,1,1,0,0
"43002053",ESC-ZER,Centre públic Dep. i CEB,Escola Garbí - ZER Montsant-Serra de Prades,Poboleda,TAR,TAR,1,2,1,0,1,0,0,1,1,2,0,0,1,0,1,2,1,0,1,1,1,1,0,0
"43002144",ESC-ZER,Centre públic Dep. i CEB,Escola Mare de Déu de la Fontcalda - ZER Ports-Algars,Prat de Comte,TEB,TEB,1,1,1,0,1,0,0,1,0,1,0,0,0,0,0,1,0,0,0,1,1,1,0,0
"43002171",ESC,Centre públic Dep. i CEB,Escola Joan Plana,Puigpelat,TAR,TAR,1,9,1,2,3,0,6,0,0,6,0,6,0,0,6,7,0,6,6,3,3,1,1,0
"43002211",ESC,Centre públic Dep. i CEB,Escola Prat de la Riba,Reus,TAR,TAR,1,9,1,9,10,3,0,1,1,5,3,0,1,1,5,6,2,1,3,4,3,1,1,0
"43002235",ESC,Centre públic Dep. i CEB,Escola Pompeu Fabra,Reus,TAR,TAR,1,9,1,0,1,9,0,0,0,9,8,0,0,0,8,9,8,0,8,1,1,1,1,0
"43002247",ESC,Centre públic Dep. i CEB,Escola Misericòrdia,Reus,TAR,TAR,1,9,1,3,4,9,0,0,0,9,8,0,0,0,8,9,8,0,8,1,1,1,1,0
"43002259",ESC,Centre públic Dep. i CEB,Escola Marià Fortuny,Reus,TAR,TAR,1,30,0,10,10,0,18,0,0,18,0,18,0,0,18,18,0,18,18,10,8,1,1,0
"43002260",ESC,Centre públic Dep. i CEB,Escola Ciutat de Reus,Reus,TAR,TAR,0,2,0,0,0,0,0,0,0,0,0,0,0,0,0,0,0,0,0,0,0,1,1,2
"43002272",ESC,Centre públic Dep. i CEB,Escola General Prim,Reus,TAR,TAR,1,11,0,0,0,0,0,15,1,16,0,0,11,0,11,11,11,0,11,0,0,1,1,0
"43002478",ESC,Concertada 30% NESE,Sant Pau,Reus,TAR,TAR,0,9,0,0,0,0,0,0,0,0,9,0,0,0,9,9,0,0,0,0,0,0,1,0
"43002570",INS,Centre públic Dep. i CEB,Institut Gaudí,Reus,TAR,TAR,1,28,0,0,0,31,2,0,0,33,28,0,0,0,28,28,0,0,0,0,0,1,1,0
"43002582",INS,Centre públic Dep. i CEB,Institut Salvador Vilaseca,Reus,TAR,TAR,1,29,2,2,4,22,0,0,0,22,22,0,0,0,22,24,0,0,0,4,4,1,1,0
"43002594",INS,Centre públic Dep. i CEB,Institut Baix Camp,Reus,TAR,TAR,1,51,1,0,1,40,3,0,0,43,40,3,0,0,43,44,40,3,43,1,1,1,1,0
"43002661",ESC-ZER,Centre públic Dep. i CEB,Escola Sant Agustí - ZER Ebre,Riba-roja d'Ebre,TEB,TEB,1,4,1,0,1,4,1,0,0,5,3,0,0,0,3,4,2,1,3,1,1,1,0,0
"43002752",ESC,Centre públic Dep. i CEB,Escola Beat Bonaventura Gran,Riudoms,TAR,TAR,1,19,0,0,0,19,0,0,0,19,19,0,0,0,19,19,19,0,19,0,0,1,1,0
"43002776",ESC,Centre públic Dep. i CEB,Escola Salvador Espriu,Roda de Berà,TAR,TAR,1,17,2,2,4,11,4,0,0,15,11,4,0,0,15,17,11,4,15,2,2,1,1,0
"43002831",ESC,Centre públic Dep. i CEB,Escola Mestre Marcel·lí Domingo,Roquetes,TEB,TEB,1,27,17,0,17,24,2,0,0,26,10,0,0,0,10,27,10,0,10,17,7,1,1,0
"43002892",ESC,Centre públic Dep. i CEB,Escola Carles III,Sant Carles de la Ràpita,TEB,TEB,1,26,0,2,2,24,1,0,0,25,24,1,0,0,25,25,3,1,4,1,1,1,1,0
"43003008",ESC,Centre públic Dep. i CEB,Escola Jaume Balmes,Santa Bàrbara,TEB,TEB,1,18,0,0,0,14,4,0,0,18,14,4,0,0,18,18,2,4,6,0,0,1,1,0
"43003011",ESC,Centre públic Dep. i CEB,Escola Cor de Roure,Santa Coloma de Queralt,TAR,TAR,1,9,1,0,1,8,1,0,0,9,8,0,0,0,8,9,8,0,8,1,1,1,1,0
"43003069",ESC,Centre públic Dep. i CEB,Escola Salvador Ninot,Sarral,TAR,TAR,1,9,2,0,2,9,0,0,0,9,7,0,0,0,7,9,7,0,7,2,2,1,1,0
"43003082",ESC,Centre públic Dep. i CEB,Escola Guillem de Claramunt,La Secuita,TAR,TAR,1,9,1,1,2,9,0,0,0,9,8,0,0,0,8,9,8,0,8,1,1,1,1,0
"43003100",ESC,Centre públic Dep. i CEB,Escola Abel Ferrater,La Selva del Camp,TAR,TAR,1,19,0,0,0,20,0,0,0,20,19,0,0,0,19,19,19,0,19,0,0,1,1,0
"43003112",ESC,Concertada 30% NESE,Sant Rafael,La Selva del Camp,TAR,TAR,0,9,0,0,0,0,0,0,0,0,9,0,0,0,9,9,0,0,0,0,0,0,1,0
"43003124",ESC-ZER,Centre públic Dep. i CEB,Escola Sagrat Cor - ZER Conca de Barberà,Solivella,TAR,TAR,1,3,1,2,3,0,1,2,0,3,0,1,1,0,2,3,0,1,1,1,1,1,0,0
"43003136",ESC,Centre públic Dep. i CEB,Escola Bonavista,Bonavista (Tarragona),TAR,TAR,1,19,0,2,2,14,2,3,0,19,14,2,3,0,19,19,6,0,6,0,0,1,1,0
"43003185",ESC,Centre públic Dep. i CEB,Escola La Canonja,La Canonja,TAR,TAR,1,25,0,25,25,3,1,0,0,4,3,1,0,0,4,4,3,1,4,21,7,1,1,0
"43003227",ESC,Centre públic Dep. i CEB,Escola Sant Salvador,Sant Salvador (Tarragona),TAR,TAR,1,23,1,1,2,20,0,0,0,20,20,0,0,0,20,21,0,0,0,2,2,1,1,0
"43003306",ESC,Centre públic Dep. i CEB,Escola Serrallo,Tarragona,TAR,TAR,1,9,0,8,8,0,0,2,0,2,0,0,2,0,2,2,0,0,0,7,3,1,1,0
"43003321",ESC,Centre públic Dep. i CEB,Escola Sant Pere i Sant Pau,Tarragona,TAR,TAR,1,9,1,0,1,0,11,0,0,11,0,8,0,0,8,9,0,8,8,1,1,1,1,0
"43003501",IE,Concertada 30% NESE,El Carme,Tarragona,TAR,TAR,0,26,0,0,0,0,0,0,0,0,26,0,0,0,26,26,0,0,0,0,0,0,1,0
"43003525",IE,Concertada 30% NESE,Dominiques Tarragona,Tarragona,TAR,TAR,0,24,0,0,0,0,0,0,0,0,24,0,0,0,24,24,0,0,0,0,0,0,1,0
"43003616",EE,EE municipals,CEE San Rafael,Tarragona,TAR,TAR,0,1,0,0,0,0,0,0,0,0,4,0,0,0,4,4,0,0,0,0,0,0,1,0
"43003631",EE,EE Privats,Estela,Tarragona,TAR,TAR,0,1,0,0,0,0,0,0,0,0,3,0,0,0,3,3,0,0,0,0,0,0,1,0
"43003641",INS,Centre públic Dep. i CEB,Institut Antoni de Martí i Franquès,Tarragona,TAR,TAR,1,48,3,3,6,6,18,7,0,31,6,18,7,0,31,34,13,18,31,6,6,1,1,0
"43003653",INS,Centre públic Dep. i CEB,Institut Comte de Rius,Tarragona,TAR,TAR,1,22,0,0,0,14,4,0,0,18,14,4,0,0,18,18,14,4,18,0,0,1,1,0
"43003690",ESC,Centre públic Dep. i CEB,Escola de Pràctiques,Tarragona,TAR,TAR,1,18,0,0,0,13,6,0,0,19,13,5,0,0,18,18,13,5,18,0,0,1,1,0
"43003720",ESC,Centre públic Dep. i CEB,Escola El Miracle,Tarragona,TAR,TAR,1,13,3,0,3,11,0,0,0,11,10,0,0,0,10,13,10,0,10,3,3,1,1,0
"43003732",INS,Centre públic Dep. i CEB,Institut Pons d'Icart,Tarragona,TAR,TAR,1,21,0,1,1,21,1,0,0,22,21,0,0,0,21,21,0,1,1,0,0,1,1,0
"43003756",ESC,Centre públic Dep. i CEB,Escola Torreforta,Torreforta (Tarragona),TAR,TAR,1,18,0,0,0,18,1,0,0,19,18,0,0,0,18,18,0,0,0,0,0,1,1,0
"43003768",ESC,Centre públic Dep. i CEB,Escola Els Àngels,Torreforta (Tarragona),TAR,TAR,1,20,0,0,0,18,4,0,0,22,18,2,0,0,20,20,18,2,20,0,0,1,1,0
"43003801",ESC-ZER,Centre públic Dep. i CEB,Escola La Pineda - ZER Riu Avall,Tivenys,TEB,TEB,1,4,2,0,2,1,0,3,0,4,1,0,1,0,2,4,1,0,1,2,2,1,0,0
"43003835",ESC-ZER,Centre públic Dep. i CEB,Escola Josep Riba - ZER Les Vinyes,La Serra d'Almós (Tivissa),TEB,TEB,1,1,1,0,1,1,0,0,0,1,0,0,0,0,0,1,0,0,0,1,1,1,0,0
"43003847",ESC,Centre públic Dep. i CEB,Escola Marcel·lí Domingo,Tivissa,TEB,TEB,1,9,1,1,2,1,0,6,0,7,1,0,6,0,7,8,4,0,4,2,2,1,1,0
"43003884",ESC,Centre públic Dep. i CEB,Escola Antoni Roig,Torredembarra,TAR,TAR,1,19,0,0,0,19,0,0,0,19,19,0,0,0,19,19,10,0,10,0,0,1,1,0
"43003941",EE,EE municipals,CEE Sant Jordi,Jesús (Tortosa),TEB,TEB,0,1,0,0,0,0,0,0,0,0,2,0,0,0,2,2,0,0,0,0,0,0,1,0
"43003951",ESC-ZER,Centre públic Dep. i CEB,Escola Bítem - ZER Riu Avall,Bítem (Tortosa),TEB,TEB,1,5,1,0,1,6,0,0,0,6,4,0,0,0,4,5,4,0,4,1,1,1,0,0
"43003975",ESC,Centre públic Dep. i CEB,Escola Sant Àngel,Camarles,TEB,TEB,1,11,4,2,6,10,1,0,0,11,7,0,0,0,7,11,4,1,5,4,3,1,1,0
"43003987",ESC-ZER,Centre públic Dep. i CEB,Escola Port rodó - ZER Mestral,Camp-redó (Tortosa),TEB,TEB,1,7,1,0,1,7,0,0,0,7,6,0,0,0,6,7,4,0,4,1,1,1,0,0
"43004013",ESC,Centre públic Dep. i CEB,Escola Sant Miquel,Deltebre,TEB,TEB,1,18,0,0,0,18,0,0,0,18,18,0,0,0,18,18,12,0,12,0,0,1,1,0
"43004037",ESC,Centre públic Dep. i CEB,Escola Maria García i Cabanes,L'Aldea,TEB,TEB,1,9,0,0,0,9,0,0,0,9,9,0,0,0,9,9,4,0,4,0,0,1,1,0
"43004050",ESC,Centre públic Dep. i CEB,Escola 21 d'Abril,L'Aldea,TEB,TEB,1,9,0,0,0,9,0,0,0,9,9,0,0,0,9,9,5,0,5,0,0,1,1,0
"43004074",ESC,Centre públic Dep. i CEB,Escola L'Assumpció,Deltebre,TEB,TEB,1,16,0,2,2,10,5,0,0,15,10,5,0,0,15,15,5,5,10,1,1,1,1,0
"43004116",ESC-ZER,Centre públic Dep. i CEB,Escola del Lligallo del Gànguil - ZER Mestral,El Lligallo del Gànguil (Camarles),TEB,TEB,1,4,1,0,1,4,0,0,0,4,3,0,0,0,3,4,3,0,3,1,1,1,0,0
"43004189",ESC,Centre públic Dep. i CEB,Escola Sant Jaume,Sant Jaume d'Enveja,TEB,TEB,1,13,0,0,0,13,0,0,0,13,13,0,0,0,13,13,4,0,4,0,0,1,1,0
"43004232",ESC,Centre públic Dep. i CEB,Escola La Mercè,Tortosa,TEB,TEB,1,11,2,4,6,10,1,0,0,11,9,0,0,0,9,11,2,0,2,2,2,1,1,0
"43004256",ESC,Centre públic Dep. i CEB,Escola Ferreries,Tortosa,TEB,TEB,1,19,6,1,7,20,0,0,0,20,13,0,0,0,13,19,13,0,13,6,5,1,1,0
"43004268",ESC,Centre públic Dep. i CEB,Escola Remolins,Tortosa,TEB,TEB,1,9,2,0,2,1,0,5,3,9,1,0,5,1,7,9,2,1,3,2,2,1,1,0
"43004438",INS,Centre públic Dep. i CEB,Institut Dertosa,Tortosa,TEB,TEB,1,50,2,17,19,12,2,17,0,31,12,2,17,0,31,33,0,2,2,19,13,1,1,0
"43004441",INS,Centre públic Dep. i CEB,Institut de l'Ebre,Tortosa,TEB,TEB,1,33,0,0,0,28,6,0,0,34,28,5,0,0,33,33,4,3,7,0,0,1,1,0
"43004463",ESC,Centre públic Dep. i CEB,Escola Ramón y Cajal,Ulldecona,TEB,TEB,1,24,15,2,17,14,0,6,0,20,9,0,0,0,9,24,9,0,9,15,7,1,1,0
"43004487",ESC-ZER,Centre públic Dep. i CEB,Escola Montsant - ZER Montsant-Serra de Prades,Ulldemolins,TAR,TAR,1,2,1,0,1,0,2,0,0,2,0,1,0,0,1,2,0,1,1,1,1,1,0,0
"43004505",ESC,Centre públic Dep. i CEB,Escola Mare de Déu del Roser,Vallmoll,TAR,TAR,1,9,0,0,0,0,9,0,0,9,0,9,0,0,9,9,0,0,0,0,0,1,1,0
"43004517",ESC-ZER,Centre públic Dep. i CEB,Escola Rocabruna - ZER El Francolí,Picamoixons (Valls),TAR,TAR,1,5,0,0,0,3,1,0,0,4,3,1,0,0,4,4,4,0,4,0,0,1,0,0
"43004529",ESC,Centre públic Dep. i CEB,Escola Mare de Déu de la Candela,Valls,TAR,TAR,1,9,1,0,1,0,9,0,0,9,0,8,0,0,8,9,0,8,8,1,1,1,1,0
"43004530",ESC,Centre públic Dep. i CEB,Escola Baltasar Segú,Valls,TAR,TAR,1,9,1,0,1,6,3,0,0,9,6,2,0,0,8,9,6,2,8,1,1,1,1,0
"43004608",INS,Centre públic Dep. i CEB,Institut Narcís Oller,Valls,TAR,TAR,1,40,0,0,0,27,3,0,0,30,27,3,0,0,30,30,27,3,30,0,0,1,1,0
"43004611",INS,Centre públic Dep. i CEB,Institut Jaume Huguet,Valls,TAR,TAR,1,43,3,0,3,58,0,0,0,58,40,0,0,0,40,43,40,0,40,3,3,1,1,0
"43004633",ESC,Centre públic Dep. i CEB,Escola Eugeni d'Ors,Valls,TAR,TAR,1,18,12,4,16,18,0,0,0,18,6,0,0,0,6,18,6,0,6,12,5,1,1,0
"43004657",ESC,Centre públic Dep. i CEB,Escola Mestral,L'Hospitalet de l'Infant (Vandellòs i l'Hospitalet de l'Infant),TAR,TAR,1,28,0,7,7,26,0,0,0,26,26,0,0,0,26,26,26,0,26,2,2,1,1,0
"43004700",ESC,Centre públic Dep. i CEB,Escola Valdelors,Vandellòs (Vandellòs i l'Hospitalet de l'Infant),TAR,TAR,1,9,0,1,1,3,0,0,0,3,3,0,0,0,3,3,3,0,3,1,1,1,1,0
"43004748",ESC,Centre públic Dep. i CEB,Escola Àngel Guimerà,El Vendrell,TAR,PEN,1,22,0,0,0,18,4,0,0,22,18,4,0,0,22,22,18,4,22,0,0,1,1,0
"43004797",INS,Centre públic Dep. i CEB,Institut Baix Penedès,El Vendrell,TAR,PEN,1,28,0,4,4,28,0,0,0,28,28,0,0,0,28,28,0,0,0,0,0,1,1,0
"43004803",INS,Centre públic Dep. i CEB,Institut Andreu Nin,El Vendrell,TAR,PEN,1,35,1,11,12,37,0,0,0,37,34,0,0,0,34,35,34,0,34,1,1,1,1,0
"43004815",ESC,Centre públic Dep. i CEB,Escola Pau Casals,El Vendrell,TAR,PEN,1,19,0,2,2,20,0,0,0,20,19,0,0,0,19,19,0,0,0,0,0,1,1,0
"43004864",ESC,Centre públic Dep. i CEB,Escola Pere Virgili,Vilallonga del Camp,TAR,TAR,1,18,1,0,1,16,1,0,0,17,16,1,0,0,17,18,16,1,17,1,1,1,1,0
"43004888",ESC-ZER,Centre públic Dep. i CEB,Escola Font de l'Arc - ZER Baix Camp Sud,Vilanova d'Escornalbou,TAR,TAR,1,4,2,1,3,0,3,0,0,3,0,2,0,0,2,4,0,2,2,2,2,1,0,0
"43004921",ESC,Centre públic Dep. i CEB,Escola Bernardí Tolrà,Vila-rodona,TAR,TAR,1,9,2,1,3,9,0,0,0,9,7,0,0,0,7,9,5,0,5,2,2,1,1,0
"43004931",ESC,Centre públic Dep. i CEB,Escola Santa Maria del Mar,Salou,TAR,TAR,1,20,0,0,0,14,6,0,0,20,14,6,0,0,20,20,14,6,20,0,0,1,1,0
"43004979",ESC,Centre públic Dep. i CEB,Escola Torroja i Miret,Vila-seca de Solcina (Vila-seca),TAR,TAR,1,18,0,8,8,14,4,0,0,18,14,4,0,0,18,18,7,4,11,0,0,1,1,0
"43005005",ESC,Centre públic Dep. i CEB,Escola Sant Bernat Calvó,Vila-seca de Solcina (Vila-seca),TAR,TAR,1,18,0,4,4,16,2,0,0,18,16,2,0,0,18,18,7,2,9,0,0,1,1,0
"43005017",ESC-ZER,Centre públic Dep. i CEB,Escola del Montgoi - ZER Poblet,Vilaverd,TAR,TAR,1,1,1,1,2,0,0,0,2,2,0,0,0,0,0,1,0,0,0,1,1,1,0,0
"43005081",ESC-ZER,Centre públic Dep. i CEB,Escola Mare de Déu dels Torrents - ZER Poblet,Vimbodí (Vimbodí i Poblet),TAR,TAR,1,3,1,0,1,4,0,0,0,4,2,0,0,0,2,3,2,0,2,1,1,1,0,0
"43005108",ESC-ZER,Centre públic Dep. i CEB,Escola Les Eres - ZER Ribera d'Ebre Nord,Vinebre,TEB,TEB,1,3,0,1,1,0,0,2,1,3,0,0,2,1,3,3,2,1,3,0,0,1,0,0
"43005121",ESC,Centre públic Dep. i CEB,Escola Santa Caterina,Vinyols i els Arcs,TAR,TAR,1,9,1,0,1,9,0,0,0,9,8,0,0,0,8,9,8,0,8,1,1,1,1,0
"43005133",ESC,Centre públic Dep. i CEB,Escola Mare de Déu del Priorat,Banyeres del Penedès,TAR,PEN,1,10,1,0,1,0,0,10,0,10,0,0,9,0,9,10,9,0,9,1,1,1,1,0
"43005145",ESC,Centre públic Dep. i CEB,Escola Els Ametllers,La Pobla de Montornès,TAR,TAR,1,11,3,0,3,6,1,0,0,7,6,1,0,0,7,10,6,1,7,3,3,1,1,0
"43005157",ESC,Centre públic Dep. i CEB,Escola Montoliu,La Riera de Gaià,TAR,TAR,1,9,1,0,1,7,0,2,1,10,7,0,1,0,8,9,8,0,8,1,1,1,1,0
"43005169",ESC,Centre públic Dep. i CEB,Escola Pau Delclòs,Tarragona,TAR,TAR,1,19,0,0,0,16,2,0,0,18,16,2,0,0,18,18,16,2,18,0,0,1,1,0
"43005170",ESC,Centre públic Dep. i CEB,Escola La Floresta,Torreforta (Tarragona),TAR,TAR,1,9,1,0,1,7,2,0,0,9,7,1,0,0,8,9,7,1,8,1,1,1,1,0
"43005182",EE,EE Privats,Mercè Pla,Tortosa,TEB,TEB,0,1,0,0,0,0,0,0,0,0,3,0,0,0,3,3,0,0,0,0,0,0,1,0
"43005194",ESC,Centre públic Dep. i CEB,Escola Mediterrani,L'Ampolla,TEB,TEB,1,12,2,0,2,11,0,0,0,11,10,0,0,0,10,12,4,0,4,2,2,1,1,0
"43005297",ESC,Centre públic Dep. i CEB,Escola Joan Perucho,Albinyana,TAR,PEN,1,9,1,0,1,0,0,0,9,9,0,0,0,8,8,9,0,8,8,1,1,1,1,0
"43005303",ESC-ZER,Centre públic Dep. i CEB,Escola Sant Jordi - ZER Riu i Serra,Aldover,TEB,TEB,1,3,1,0,1,3,0,0,0,3,2,0,0,0,2,3,2,0,2,1,1,1,0,0
"43005315",ESC-ZER,Centre públic Dep. i CEB,Escola d'Alfara de Carles - ZER Mont Caro,Alfara de Carles,TEB,TEB,1,2,1,0,1,2,0,0,0,2,1,0,0,0,1,2,0,0,0,1,1,1,0,0
"43005327",ESC,Centre públic Dep. i CEB,Escola Ramon Sugrañes,Almoster,TAR,TAR,1,9,1,0,1,9,0,0,0,9,8,0,0,0,8,9,8,0,8,1,1,1,1,0
"43005339",ESC-ZER,Centre públic Dep. i CEB,Escola Montsant - ZER Montsant,La Bisbal de Falset,TAR,TAR,1,2,3,2,5,0,0,1,0,1,0,0,0,0,0,3,0,0,0,2,1,1,0,0
"43005340",ESC,Centre públic Dep. i CEB,Escola Santa Anna,Castellvell del Camp,TAR,TAR,1,10,1,1,2,12,0,0,0,12,9,0,0,0,9,10,3,0,3,1,1,1,1,0
"43005364",ESC,Centre públic Dep. i CEB,Escola Les Eres,Creixell,TAR,TAR,1,11,1,1,2,0,11,0,0,11,0,10,0,0,10,11,0,3,3,1,1,1,1,0
"43005376",ESC-ZER,Centre públic Dep. i CEB,Escola Puigmarí - ZER Baix Camp Sud,Duesaigües,TAR,TAR,1,1,1,0,1,0,0,1,0,1,0,0,1,0,1,2,0,0,0,0,0,1,1,0
"43005388",ESC-ZER,Centre públic Dep. i CEB,Escola Mestre Josep Roncero i Pallarès - ZER Montsià,Freginals,TEB,TEB,1,2,2,1,3,0,0,2,0,2,0,0,0,0,0,2,0,0,0,2,1,1,0,0
"43005391",ESC-ZER,Centre públic Dep. i CEB,Escola Sant Llorenç - ZER Montsià,La Galera,TEB,TEB,1,4,3,1,4,4,0,0,0,4,1,0,0,0,1,4,1,0,1,3,2,1,0,0
"43005406",ESC-ZER,Centre públic Dep. i CEB,Escola El Verger - ZER Ribera d'Ebre Nord,Garcia,TEB,TEB,1,2,1,0,1,3,0,0,0,3,1,0,0,0,1,2,1,0,1,1,1,1,0,0
"43005418",ESC-ZER,Centre públic Dep. i CEB,Escola Sant Salvador - ZER Montsià,Godall,TEB,TEB,1,1,2,1,3,2,0,0,0,2,0,0,0,0,0,2,0,0,0,1,1,1,0,0
"43005421",ESC-ZER,Centre públic Dep. i CEB,Escola Berenguer de Montoliu - ZER Els Ceps,Masllorenç,TAR,PEN,1,3,1,0,1,0,0,2,0,2,0,0,2,0,2,3,2,0,2,1,1,1,0,0
"43005443",ESC-ZER,Centre públic Dep. i CEB,Escola Roc Llop i Convalia - ZER Benissanet-Miravet,Miravet,TEB,TEB,1,3,1,1,2,3,0,1,0,4,2,0,0,0,2,3,2,0,2,1,1,1,0,0
"43005455",ESC-ZER,Centre públic Dep. i CEB,Escola Pius XII - ZER L'Aglà,El Molar,TAR,TAR,1,1,1,0,1,0,0,1,0,1,0,0,0,0,0,1,0,0,0,1,1,1,0,0
"43005467",ESC,Centre públic Dep. i CEB,Escola Les Codinetes,La Nou de Gaià,TAR,TAR,1,9,0,0,0,2,1,4,0,7,2,1,4,0,7,7,4,1,5,0,0,1,1,0
"43005479",ESC-ZER,Centre públic Dep. i CEB,Escola 1 d'Abril - ZER Ebre,La Palma d'Ebre,TEB,TEB,1,1,1,0,1,1,1,0,0,2,0,0,0,0,0,1,0,0,0,1,1,1,0,0
"43005480",ESC,Centre públic Dep. i CEB,Escola Mare de Déu del Lledó,La Pobla de Mafumet,TAR,TAR,1,20,2,3,5,0,20,0,0,20,0,18,0,0,18,20,0,6,6,2,2,1,1,0
"43005492",ESC-ZER,Centre públic Dep. i CEB,Escola Santa Magdalena - ZER La Parellada,El Pont d'Armentera,TAR,TAR,1,3,1,0,1,1,3,0,0,4,1,1,0,0,2,3,1,1,2,1,1,1,0,0
"43005509",ESC-ZER,Centre públic Dep. i CEB,Escola Rossend Giol - ZER Baix Priorat,Porrera,TAR,TAR,1,1,1,0,1,0,0,0,1,1,0,0,0,0,0,1,0,0,0,1,1,1,0,0
"43005510",ESC-ZER,Centre públic Dep. i CEB,Escola Serra de Prades - ZER Montsant-Serra de Prades,Prades,TAR,TAR,1,3,1,0,1,1,0,1,1,3,1,0,1,0,2,3,2,0,2,1,1,1,0,0
"43005522",ESC,Centre públic Dep. i CEB,Escola Santa Marina,Pratdip,TAR,TAR,1,9,1,1,2,2,2,0,0,4,2,2,0,0,4,5,2,2,4,2,2,1,1,0
"43005534",ESC-ZER,Centre públic Dep. i CEB,Escola Les Eres de Rasquera - ZER La Font de l'Aiguadí,Rasquera,TEB,TEB,1,4,1,0,1,5,0,0,0,5,3,0,0,0,3,4,0,0,0,1,1,1,0,0
"43005546",ESC-ZER,Centre públic Dep. i CEB,Escola de La Riba - ZER El Francolí,La Riba,TAR,TAR,1,3,0,0,0,0,3,0,0,3,0,3,0,0,3,3,0,0,0,0,0,1,0,0
"43005558",ESC,Centre públic Dep. i CEB,Escola Sant Mateu,Riudecanyes,TAR,TAR,1,9,1,1,2,7,0,0,0,7,7,0,0,0,7,8,2,0,2,2,2,1,1,0
"43005561",ESC,Centre públic Dep. i CEB,Escola Mare de Déu del Roser,Riudecols,TAR,TAR,1,9,1,1,2,6,0,0,0,6,6,0,0,0,6,7,2,0,2,2,2,1,1,0
"43005571",ESC,Centre públic Dep. i CEB,Escola Les Comes,Rodonyà,TAR,TAR,1,9,1,0,1,8,0,0,0,8,8,0,0,0,8,9,8,0,8,1,1,1,1,0
"43005583",ESC,Centre públic Dep. i CEB,Escola Els Quatre Vents,Sant Jaume dels Domenys,TAR,PEN,1,13,0,1,1,6,9,0,0,15,6,7,0,0,13,13,6,7,13,0,0,1,1,0
"43005595",ESC,Centre públic Dep. i CEB,Escola La Parellada,Santa Oliva,TAR,PEN,1,13,0,0,0,10,4,0,0,14,10,3,0,0,13,13,4,2,6,0,0,1,1,0
"43005601",ESC-ZER,Centre públic Dep. i CEB,Escola El Tormo - ZER Ribera d'Ebre Nord,La Torre de l'Espanyol,TEB,TEB,1,2,0,0,0,1,0,2,0,3,1,0,1,0,2,2,2,0,2,0,0,1,0,0
"43005613",ESC-ZER,Centre públic Dep. i CEB,Escola Setze de Febrer - ZER Mediterrània,Els Muntells (Sant Jaume d'Enveja),TEB,TEB,1,1,0,1,1,2,0,0,0,2,1,0,0,0,1,1,1,0,1,0,0,1,0,0
"43005625",ESC-ZER,Centre públic Dep. i CEB,Escola Sant Antoni Abat - ZER Mont Caro,Els Reguers (Tortosa),TEB,TEB,1,3,1,1,2,2,0,0,0,2,2,0,0,0,2,3,0,0,0,1,1,1,0,0
"43005637",ESC-ZER,Centre públic Dep. i CEB,Escola Manuel de Castellví i Feliu - ZER Atzavara,Vilabella,TAR,TAR,1,3,1,0,1,2,1,0,0,3,2,0,0,0,2,3,2,0,2,1,1,1,0,0
"43005650",ESC-ZER,Centre públic Dep. i CEB,Escola El Diví Mestre - ZER Terra Alta Nord,Vilalba dels Arcs,TEB,TEB,1,3,1,0,1,2,1,0,0,3,2,0,0,0,2,3,2,0,2,1,1,1,0,0
"43005662",ESC,Centre públic Dep. i CEB,Escola Josep Nin,Salomó,TAR,TAR,1,9,0,1,1,0,0,0,4,4,0,0,0,4,4,4,0,4,4,1,1,1,1,0
"43005674",ESC-ZER,Centre públic Dep. i CEB,Escola Raval de Cristo - ZER Mont Caro,El Raval de Crist (Roquetes),TEB,TEB,1,6,2,0,2,4,0,2,0,6,4,0,0,0,4,6,3,0,3,2,2,1,0,0
"43005686",ESC,Centre públic Dep. i CEB,Escola Riu Clar,Torreforta (Tarragona),TAR,TAR,1,9,1,6,7,3,0,3,3,9,3,0,3,2,8,9,7,1,8,1,1,1,1,0
"43005698",ESC-ZER,Centre públic Dep. i CEB,Escola Marjal - ZER Mediterrània,Les Cases d'Alcanar (Alcanar),TEB,TEB,1,6,2,3,5,5,0,0,0,5,4,0,0,0,4,6,4,0,4,2,2,1,0,0
"43005704",INS,Centre públic Dep. i CEB,Institut Francesc Vidal i Barraquer,Tarragona,TAR,TAR,1,34,0,0,0,6,14,0,0,20,6,14,0,0,20,20,6,14,20,0,0,1,1,0
"43005731",EE,EE Privats,La Muntanyeta,Tarragona,TAR,TAR,0,1,0,0,0,0,0,0,0,0,2,0,0,0,2,2,0,0,0,0,0,0,1,0
"43005741",EE,EE Privats,Ntra. Sra. del Mar,Reus,TAR,TAR,0,1,0,0,0,0,0,0,0,0,2,0,0,0,2,2,0,0,0,0,0,0,1,0
"43005753",ESC,Centre públic Dep. i CEB,Escola Doctor Alberich i Casas,Reus,TAR,TAR,1,18,0,0,0,12,3,3,0,18,12,3,3,0,18,18,12,0,12,0,0,1,1,0
"43005765",ESC,Centre públic Dep. i CEB,Escola Eduard Toda i Güell,Reus,TAR,TAR,1,16,0,0,0,16,1,0,0,17,16,0,0,0,16,16,16,0,16,0,0,1,1,0
"43005893",ESC,Centre públic Dep. i CEB,Escola Centcelles,Constantí,TAR,TAR,1,10,1,3,4,7,0,1,0,8,7,0,1,0,8,9,3,0,3,2,2,1,1,0
"43005901",ESC,Centre públic Dep. i CEB,Escola Joan Rebull,Reus,TAR,TAR,1,26,0,2,2,15,7,0,0,22,15,7,0,0,22,22,2,1,3,2,2,1,1,0
"43005911",ESC,Centre públic Dep. i CEB,Escola Campclar,Torreforta (Tarragona),TAR,TAR,1,11,1,3,4,12,0,0,0,12,10,0,0,0,10,11,4,0,4,1,1,1,1,0
"43005935",ESC,Centre públic Dep. i CEB,Escola Sant Bernat Calvó,Reus,TAR,TAR,1,16,0,0,0,16,0,0,0,16,16,0,0,0,16,16,16,0,16,0,0,1,1,0
"43005947",ESC,Centre públic Dep. i CEB,Escola Cal·lípolis,Platja de la Pineda (Vila-seca),TAR,TAR,1,16,6,4,10,10,0,1,0,11,10,0,0,0,10,16,10,0,10,6,5,1,1,0
"43005959",ESC,Centre públic Dep. i CEB,Escola Cèsar August,Tarragona,TAR,TAR,1,20,0,6,6,19,3,0,0,22,19,1,0,0,20,20,6,1,7,0,0,1,1,0
"43005972",INS,Centre públic Dep. i CEB,Institut Ramon Barbat i Miracle,Vila-seca de Solcina (Vila-seca),TAR,TAR,1,41,1,7,8,24,0,0,0,24,24,0,0,0,24,25,24,0,24,8,8,1,1,0
"43006046",ESC-ZER,Centre públic Dep. i CEB,Escola Divina Pastora - ZER Mestral,Vinallop (Tortosa),TEB,TEB,1,1,1,0,1,1,0,0,0,1,0,0,0,0,0,1,0,0,0,1,1,1,0,0
"43006061",ESC,Centre públic Dep. i CEB,Escola Rubió i Ors,Reus,TAR,TAR,1,18,3,2,5,0,0,19,0,19,0,0,15,0,15,18,0,0,0,3,3,1,1,0
"43006095",EE,EE Privats,Jerónimo de Moragas,Móra d'Ebre,TEB,TEB,0,1,0,0,0,0,0,0,0,0,1,0,0,0,1,1,0,0,0,0,0,0,1,0
"43006101",INS,Centre públic Dep. i CEB,Institut Montsià,Amposta,TEB,TEB,1,28,0,0,0,29,1,0,0,30,28,0,0,0,28,28,28,0,28,0,0,1,1,0
"43006125",INS,Centre públic Dep. i CEB,Institut Campclar,Tarragona,TAR,TAR,1,33,3,0,3,3,2,30,0,35,3,2,25,0,30,33,0,0,0,3,3,1,1,0
"43006162",EE,EE Privats,Solc,Tarragona,TAR,TAR,0,1,0,0,0,0,0,0,0,0,2,0,0,0,2,2,0,0,0,0,0,0,1,0
"43006174",ESC,Centre públic Dep. i CEB,Escola Les Moreres,Les Pobles (Aiguamúrcia),TAR,TAR,1,9,1,1,2,3,0,0,0,3,3,0,0,0,3,4,3,0,3,2,2,1,1,0
"43006186",ESC,Centre públic Dep. i CEB,Escola Soriano Montagut,Amposta,TEB,TEB,1,18,13,0,13,12,0,3,3,18,5,0,0,0,5,18,5,0,5,13,5,1,1,0
"43006216",ESC,Centre públic Dep. i CEB,Escola Cèlia Artiga,Reus,TAR,TAR,1,9,1,8,9,6,1,1,0,8,6,1,1,0,8,9,0,0,0,1,1,1,1,0
"43006228",ESC,Centre públic Dep. i CEB,Escola Rosa Sensat,Reus,TAR,TAR,1,9,1,0,1,11,0,0,0,11,8,0,0,0,8,9,5,0,5,1,1,1,1,0
"43006241",ESC,Centre públic Dep. i CEB,Escola La Plana,La Plana (Vila-seca),TAR,TAR,1,9,1,7,8,5,4,0,0,9,5,3,0,0,8,9,2,3,5,1,1,1,1,0
"43006253",APD,APD & FP Municipals no CEB,EASD de Tarragona,Tarragona,TAR,TAR,0,0,0,0,0,0,0,0,0,0,0,0,0,0,0,0,0,0,0,0,0,0,0,0
"43006332",ESC,Centre públic Dep. i CEB,Escola Mestral,Vila-seca de Solcina (Vila-seca),TAR,TAR,1,13,0,4,4,0,0,15,0,15,0,0,13,0,13,13,0,0,0,0,0,1,1,0
"43006356",ESC,Centre públic Dep. i CEB,Escola Marinada,Cambrils,TAR,TAR,1,17,2,0,2,17,0,0,0,17,15,0,0,0,15,17,9,0,9,2,2,1,1,0
"43006371",ESC-ZER,Centre públic Dep. i CEB,Escola Sant Roc - ZER Conca de Barberà,Rocafort de Queralt,TAR,TAR,1,1,1,0,1,0,0,0,1,1,0,0,0,0,0,1,0,0,0,1,1,1,0,0
"43006393",ESC,Centre públic Dep. i CEB,Escola Europa,Salou,TAR,TAR,1,21,0,4,4,19,0,0,0,19,19,0,0,0,19,19,10,0,10,2,2,1,1,0
"43006496",INS,Centre públic Dep. i CEB,Institut Manuel Sales i Ferré,Ulldecona,TEB,TEB,1,21,12,0,12,13,4,0,0,17,9,0,0,0,9,21,5,2,7,12,6,1,1,0
"43006541",ESC,Centre públic Dep. i CEB,Escola Teresa Miquel i Pàmies,Reus,TAR,TAR,1,18,0,1,1,15,1,0,0,16,15,1,0,0,16,16,0,0,0,1,1,1,1,0
"43006551",ESC,Centre públic Dep. i CEB,Escola Horta Vella,Sant Carles de la Ràpita,TEB,TEB,1,20,0,0,0,20,0,0,0,20,20,0,0,0,20,20,9,0,9,0,0,1,1,0
"43006563",ESC,Centre públic Dep. i CEB,Escola Marcel·lí Domingo,Tarragona,TAR,TAR,1,16,0,1,1,18,0,0,0,18,16,0,0,0,16,16,10,0,10,0,0,1,1,0
"43006575",ESC,Centre públic Dep. i CEB,Escola Eladi Homs,Valls,TAR,TAR,1,10,0,1,1,7,3,0,0,10,7,3,0,0,10,10,7,3,10,0,0,1,1,0
"43006587",ESC,Centre públic Dep. i CEB,Escola Àngels Garriga,El Vendrell,TAR,PEN,1,21,0,0,0,16,0,0,15,31,16,0,0,5,21,21,16,5,21,0,0,1,1,0
"43006599",EE,EE Privats,L'Àngel,Amposta,TEB,TEB,0,1,0,0,0,0,0,0,0,0,2,0,0,0,2,2,0,0,0,0,0,0,1,0
"43006617",INS,Centre públic Dep. i CEB,Institut Joan Amigó i Callau,L'Espluga de Francolí,TAR,TAR,1,5,0,14,14,10,0,0,0,10,5,0,0,0,5,5,0,0,0,0,0,1,1,0
"43006630",INS,Centre públic Dep. i CEB,Institut Pere Martell,Tarragona,TAR,TAR,1,59,0,10,10,16,20,0,0,36,16,20,0,0,36,36,0,0,0,10,10,1,1,0
"43006642",INS,Centre públic Dep. i CEB,Institut Terra Alta,Gandesa,TEB,TEB,1,18,1,2,3,18,1,0,0,19,17,0,0,0,17,18,2,0,2,1,1,1,1,0
"43006654",INS,Centre públic Dep. i CEB,Institut Cambrils,Cambrils,TAR,TAR,1,22,1,1,2,21,0,0,0,21,21,0,0,0,21,22,21,0,21,1,1,1,1,0
"43006678",INS,Centre públic Dep. i CEB,Institut Gabriel Ferrater i Soler,Reus,TAR,TAR,1,34,1,0,1,32,2,0,0,34,32,1,0,0,33,34,32,1,33,1,1,1,1,0
"43006681",INS,Centre públic Dep. i CEB,Institut de La Sénia,La Sénia,TEB,TEB,1,17,1,0,1,15,2,0,0,17,15,1,0,0,16,17,0,2,2,1,1,1,1,0
"43006691",INS,Centre públic Dep. i CEB,Institut Priorat,Falset,TAR,TAR,1,23,3,2,5,4,0,24,1,29,4,0,16,0,20,23,20,0,20,3,3,1,1,0
"43006708",INS,Centre públic Dep. i CEB,Institut Joan Segura i Valls,Santa Coloma de Queralt,TAR,TAR,1,7,0,1,1,5,0,0,0,5,5,0,0,0,5,5,5,0,5,1,1,1,1,0
"43006851",ESC,Centre públic Dep. i CEB,Escola Molí de Vent,Torredembarra,TAR,TAR,1,20,0,0,0,20,0,0,0,20,20,0,0,0,20,20,10,0,10,0,0,1,1,0
"43006861",ESC,Centre públic Dep. i CEB,Escola Enxaneta,Valls,TAR,TAR,1,9,2,0,2,7,2,0,0,9,7,0,0,0,7,9,7,0,7,2,2,1,1,0
"43006873",ESC,Centre públic Dep. i CEB,Escola Riumar,Deltebre,TEB,TEB,1,9,0,0,0,5,4,0,0,9,5,4,0,0,9,9,0,5,5,0,0,1,1,0
"43006940",EOI,Centre públic Dep. i CEB,EOI de Tarragona,Tarragona,TAR,TAR,1,100,0,21,21,1,0,0,2,3,1,0,0,2,3,3,1,2,3,21,21,1,1,0
"43006952",INS,Centre públic Dep. i CEB,Institut Torredembarra,Torredembarra,TAR,TAR,1,28,2,0,2,35,0,5,0,40,26,0,0,0,26,28,0,0,0,2,2,1,1,0
"43006964",INS,Centre públic Dep. i CEB,Institut de Deltebre,Deltebre,TEB,TEB,1,27,3,0,3,22,3,0,0,25,22,2,0,0,24,27,4,0,4,3,3,1,1,0
"43006976",INS,Centre públic Dep. i CEB,Institut Candelera,L'Ametlla de Mar,TEB,TEB,1,19,11,4,15,10,2,5,0,17,8,0,0,0,8,19,0,2,2,11,5,1,1,0
"43006988",EE,Centre públic Dep. i CEB,CEE Garbí,El Vendrell,TAR,PEN,1,6,6,0,6,12,0,0,0,12,0,0,0,0,0,6,0,0,0,6,2,1,1,0
"43007038",FP,Centre públic Dep. i CEB,Institut Escola d'Hoteleria i Turisme,Cambrils,TAR,TAR,1,22,0,0,0,0,13,0,0,13,0,13,0,0,13,13,0,0,0,0,0,1,1,0
"43007051",CFA,CFA Departament,CFA Josepa Massanés i Dalmau,Tarragona,TAR,TAR,1,3,0,0,0,0,3,0,0,3,3,0,0,0,3,3,0,0,0,0,0,1,1,0
"43007087",INS,Centre públic Dep. i CEB,Institut Sòl de Riu,Alcanar,TEB,TEB,1,23,1,0,1,21,0,0,0,21,21,0,0,0,21,22,0,0,0,1,1,1,1,0
"43007105",ESC,Centre públic Dep. i CEB,Escola Montsant,Reus,TAR,TAR,1,9,1,3,4,0,9,0,0,9,0,8,0,0,8,9,0,8,8,1,1,1,1,0
"43007117",ESC,Centre públic Dep. i CEB,Escola Pax,Tarragona,TAR,TAR,1,18,0,3,3,16,0,0,4,20,16,0,0,2,18,18,10,4,14,0,0,1,1,0
"43007129",INS,Centre públic Dep. i CEB,Institut Julio Antonio,Móra d'Ebre,TEB,TEB,1,28,1,0,1,27,0,0,0,27,27,0,0,0,27,28,0,0,0,1,1,1,1,0
"43007166",INS,Centre públic Dep. i CEB,Institut Lluís Domènech i Montaner,Reus,TAR,TAR,1,32,1,0,1,30,0,0,0,30,30,0,0,0,30,31,0,0,0,1,1,1,1,0
"43007178",ESC,Centre públic Dep. i CEB,Escola Mowgli,Reus,TAR,TAR,1,11,0,3,3,7,2,0,0,9,7,2,0,0,9,9,7,2,9,2,2,1,1,0
"43007208",INS,Centre públic Dep. i CEB,Institut Berenguer d'Entença,L'Hospitalet de l'Infant (Vandellòs i l'Hospitalet de l'Infant),TAR,TAR,1,22,0,13,13,9,8,1,1,19,9,8,1,1,19,19,0,0,0,3,3,1,1,0
"43007221",INS,Centre públic Dep. i CEB,Institut Els Alfacs,Sant Carles de la Ràpita,TEB,TEB,1,27,1,0,1,16,9,2,3,30,16,9,1,0,26,27,6,0,6,1,1,1,1,0
"43007233",INS,Centre públic Dep. i CEB,Institut de Flix,Flix,TEB,TEB,1,18,2,0,2,17,0,0,0,17,16,0,0,0,16,18,2,0,2,2,2,1,1,0
"43007257",INS,Centre públic Dep. i CEB,Institut Camí de Mar,Calafell,TAR,PEN,1,30,0,0,0,21,6,3,0,30,21,6,3,0,30,30,0,6,6,0,0,1,1,0
"43007373",EE,EE municipals,CEE Alba,Reus,TAR,TAR,0,1,0,0,0,0,0,0,0,0,2,0,0,0,2,2,0,0,0,0,0,0,1,0
"43007385",INS,Centre públic Dep. i CEB,Institut d'Horticultura i Jardineria,Reus,TAR,TAR,1,10,0,0,0,5,2,0,0,7,5,2,0,0,7,7,5,2,7,0,0,1,1,0
"43007543",INS,Centre públic Dep. i CEB,Institut Jaume I,Salou,TAR,TAR,1,46,16,13,29,32,0,0,0,32,30,0,0,0,30,46,30,0,30,16,12,1,1,0
"43007580",INS,Centre públic Dep. i CEB,Institut de L'Arboç,L'Arboç,TAR,PEN,1,37,1,0,1,0,4,0,27,31,0,4,0,27,31,32,0,0,0,1,1,1,1,0
"43007646",INS,Centre públic Dep. i CEB,Institut de Constantí,Constantí,TAR,TAR,1,17,2,0,2,15,15,0,0,30,15,0,0,0,15,17,0,15,15,2,2,1,1,0
"43007658",INS,Centre públic Dep. i CEB,Institut Joan Guinjoan i Gispert,Riudoms,TAR,TAR,1,30,2,0,2,26,0,0,0,26,26,0,0,0,26,28,26,0,26,2,2,1,1,0
"43007661",INS,Centre públic Dep. i CEB,Institut Ramon de la Torre,Torredembarra,TAR,TAR,1,26,1,0,1,25,0,0,0,25,25,0,0,0,25,26,0,0,0,1,1,1,1,0
"43008389",ESC,Centre públic Dep. i CEB,Escola Sant Llatzer,Tortosa,TEB,TEB,1,9,3,0,3,8,0,0,1,9,6,0,0,0,6,9,4,0,4,3,3,1,1,0
"43008390",INS,Centre públic Dep. i CEB,Institut Torreforta,Tarragona,TAR,TAR,1,27,0,21,21,14,0,3,4,21,14,0,3,4,21,21,0,0,0,6,6,1,1,0
"43008407",INS,Centre públic Dep. i CEB,Institut El Morell,El Morell,TAR,TAR,1,24,2,4,6,31,1,0,0,32,22,0,0,0,22,24,2,1,3,2,2,1,1,0
"43008419",INS,Centre públic Dep. i CEB,Institut Camarles,Camarles,TEB,TEB,1,17,0,1,1,15,1,0,0,16,15,1,0,0,16,16,0,1,1,1,1,1,1,0
"43008420",INS,Centre públic Dep. i CEB,Institut Roquetes,Roquetes,TEB,TEB,1,31,1,9,10,0,4,17,5,26,0,4,17,5,26,27,0,1,1,5,5,1,1,0
"43008432",INS,Centre públic Dep. i CEB,Institut Sant Pere i Sant Pau,Sant Pere i Sant Pau (Tarragona),TAR,TAR,1,26,1,0,1,20,0,0,0,20,20,0,0,0,20,21,20,0,20,1,1,1,1,0
"43008444",INS,Centre públic Dep. i CEB,Institut Josep Tapiró,Reus,TAR,TAR,1,29,1,0,1,16,7,1,0,24,16,7,1,0,24,25,0,0,0,1,1,1,1,0
"43008456",INS,Centre públic Dep. i CEB,Institut Les Planes,Santa Bàrbara,TEB,TEB,1,15,3,0,3,0,0,14,0,14,0,0,12,0,12,15,2,0,2,3,3,1,1,0
"43008481",INS,Centre públic Dep. i CEB,Institut Collblanc,La Canonja,TAR,TAR,1,33,1,1,2,23,0,0,0,23,23,0,0,0,23,24,23,0,23,2,2,1,1,0
"43008501",INS,Centre públic Dep. i CEB,Institut Pont del Diable,Sant Salvador (Tarragona),TAR,TAR,1,16,0,0,0,9,3,0,0,12,9,3,0,0,12,12,9,3,12,0,0,1,1,0
"43008511",INS,Centre públic Dep. i CEB,Institut Joan Puig i Ferreter,La Selva del Camp,TAR,TAR,1,20,2,0,2,0,20,0,0,20,0,18,0,0,18,20,0,18,18,2,2,1,1,0
"43008523",INS,Centre públic Dep. i CEB,Institut Vila-seca,Vila-seca de Solcina (Vila-seca),TAR,TAR,1,27,6,16,22,3,1,17,2,23,3,1,17,0,21,27,0,0,0,6,6,1,1,0
"43008535",ESC,Centre públic Dep. i CEB,Escola Solcunit,Cunit,TAR,PEN,1,19,0,0,0,24,2,3,0,29,19,0,0,0,19,19,19,0,19,0,0,1,1,0
"43008547",ESC,Centre públic Dep. i CEB,Escola Cambrils,Cambrils,TAR,TAR,1,18,0,6,6,0,1,17,0,18,0,1,17,0,18,18,18,0,18,0,0,1,1,0
"43008638",INS,Centre públic Dep. i CEB,Institut Antoni Ballester,Mont-roig del Camp,TAR,TAR,1,21,1,20,21,0,0,4,2,6,0,0,4,2,6,7,4,2,6,15,6,1,1,0
"43008729",CFA,CFA Departament,CFA Tarragona,Tarragona,TAR,TAR,1,6,0,1,1,2,1,0,2,5,3,0,0,0,3,3,0,0,0,1,0,1,1,0
"43008754",CFA,CFA Departament,CFA Sebastià Juan Arbó,Amposta,TEB,TEB,1,1,0,0,0,5,0,0,0,5,1,0,0,0,1,1,0,0,0,0,0,1,1,0
"43008778",CFA,CFA Municipals no CEB,CFA Fòrum,Tarragona,TAR,TAR,0,2,0,0,0,0,0,0,0,0,2,0,0,0,2,2,0,0,0,0,0,0,1,0
"43008781",CFA,CFA Municipals no CEB,CFA Rosa dels Vents,Cambrils,TAR,TAR,0,3,0,0,0,0,0,0,0,0,3,0,0,0,3,3,0,0,0,0,0,0,1,0
"43008857",CFA,CFA Departament,CFA Reus,Reus,TAR,TAR,1,5,0,0,0,4,0,3,0,7,3,0,0,0,3,3,0,0,0,0,0,1,1,0
"43008882",CFA,CFA Municipals no CEB,CFA Marta Mata,Reus,TAR,TAR,0,8,0,0,0,0,0,0,0,0,3,0,0,0,3,3,0,0,0,0,0,0,1,0
"43008912",ESC,Centre públic Dep. i CEB,Escola Cinta Curto,Tortosa,TEB,TEB,1,9,0,0,0,9,0,0,0,9,9,0,0,0,9,9,5,0,5,0,0,1,1,0
"43009187",INS,Centre públic Dep. i CEB,Institut Martí l'Humà,Montblanc,TAR,TAR,1,30,0,1,1,25,0,0,0,25,25,0,0,0,25,25,0,0,0,1,1,1,1,0
"43009217",ESC-ZER,Centre públic Dep. i CEB,Escola del Poble Nou del Delta - ZER Mediterrània,El Poblenou del Delta (Amposta),TEB,TEB,1,2,1,0,1,0,1,0,0,1,0,0,2,0,2,3,0,0,0,0,0,1,1,0
"43009230",ESC,Centre públic Dep. i CEB,Escola Tarragona,Tarragona,TAR,TAR,1,16,0,4,4,15,0,0,0,15,15,0,0,0,15,15,15,0,15,1,1,1,1,0
"43009242",ESC,Centre públic Dep. i CEB,Escola L'Antina,Torredembarra,TAR,TAR,1,20,0,12,12,0,5,14,0,19,0,5,14,0,19,19,14,5,19,1,1,1,1,0
"43009369",ESC,Centre públic Dep. i CEB,Escola Saavedra,Tarragona,TAR,TAR,1,9,8,0,8,5,0,0,0,5,1,0,0,0,1,9,0,0,0,8,3,1,1,0
"43009451",ESC,Centre públic Dep. i CEB,Escola Salou,Salou,TAR,TAR,1,21,5,0,5,17,0,0,0,17,16,0,0,0,16,21,6,0,6,5,5,1,1,0
"43009473",APD,APD & FP Municipals no CEB,EA Esardi,Amposta,TEB,TEB,0,2,0,0,0,0,0,0,0,0,2,0,0,0,2,2,0,0,0,0,0,0,1,0
"43009485",APD,APD & FP Municipals no CEB,EA de Reus,Reus,TAR,TAR,0,0,0,0,0,0,0,0,0,0,0,0,0,0,0,0,0,0,0,0,0,0,0,0
"43009497",INS,Centre públic Dep. i CEB,Institut Fonts del Glorieta,Alcover,TAR,TAR,1,15,13,10,23,11,1,1,0,13,2,0,0,0,2,15,2,0,2,13,4,1,1,0
"43009527",APD,APD & FP Municipals no CEB,EA Municipal d'Arts Plàstiques i Disseny Josep Casadó,Móra la Nova,TEB,TEB,0,4,0,0,0,0,0,0,0,0,4,0,0,0,4,4,0,0,0,0,0,0,1,0
"43009710",EOI,Centre públic Dep. i CEB,EOI de Reus,Reus,TAR,TAR,1,32,0,0,0,9,0,0,0,9,9,0,0,0,9,9,0,0,0,0,0,1,1,0
"43009722",INS,Centre públic Dep. i CEB,Institut Cal·lípolis,Tarragona,TAR,TAR,1,52,0,0,0,22,2,0,0,24,22,2,0,0,24,24,22,2,24,0,0,1,1,0
"43009771",CFA,CFA Departament,CFA Tortosa,Tortosa,TEB,TEB,1,3,0,2,2,6,0,0,0,6,3,0,0,0,3,3,0,0,0,0,0,1,1,0
"43009850",INS,Centre públic Dep. i CEB,Institut Ernest Lluch i Martí,Cunit,TAR,PEN,1,36,1,0,1,19,2,2,0,23,19,2,2,0,23,24,1,2,3,1,1,1,1,0
"43009862",EOI,Centre públic Dep. i CEB,EOI de Tortosa,Tortosa,TEB,TEB,1,22,0,0,0,8,0,0,0,8,8,0,0,0,8,8,0,0,0,0,0,1,1,0
"43009886",ESC,Centre públic Dep. i CEB,Escola Josep Veciana,Perafort,TAR,TAR,1,10,1,0,1,10,0,0,0,10,9,0,0,0,9,10,9,0,9,1,1,1,1,0
"43009898",ESC,Centre públic Dep. i CEB,Escola Castell de Calafell,Calafell,TAR,PEN,1,18,0,21,21,0,0,6,13,19,0,0,6,12,18,18,6,12,18,0,0,1,1,0
"43009977",INS,Centre públic Dep. i CEB,Institut d'Altafulla,Altafulla,TAR,TAR,1,25,0,0,0,18,2,0,0,20,18,2,0,0,20,20,0,0,0,0,0,1,1,0
"43010037",EOI,Centre públic Dep. i CEB,EOI del Vendrell,El Vendrell,TAR,PEN,1,20,0,3,3,3,0,1,0,4,3,0,1,0,4,4,0,0,0,3,3,1,1,0
"43010062",CFA,CFA Departament,CFA El Vendrell,El Vendrell,TAR,PEN,1,4,0,1,1,1,3,0,0,4,3,0,0,0,3,3,0,0,0,0,0,1,1,0
"43010074",CFA,CFA Departament,CFA Valls,Valls,TAR,TAR,1,5,0,0,0,0,4,0,0,4,3,0,0,0,3,3,0,0,0,0,0,1,1,0
"43010086",CFA,CFA Departament,CFA Vilaseca,Vila-seca de Solcina (Vila-seca),TAR,TAR,1,1,0,0,0,2,0,1,0,3,1,0,0,0,1,1,0,0,0,0,0,1,1,0
"43010098",ESC,Centre públic Dep. i CEB,Escola La Ginesta,Segur de Calafell (Calafell),TAR,PEN,1,22,1,0,1,18,2,0,0,20,18,2,0,0,20,21,18,2,20,1,1,1,1,0
"43010116",AH,Aules hospitalàries,A. Hospitalària Hospital de Dia,Reus,TAR,TAR,0,1,0,0,0,0,0,0,0,0,0,0,1,0,1,1,0,0,0,0,0,0,0,0
"43010141",ESC,Centre públic Dep. i CEB,Escola Guillem Fortuny,Cambrils,TAR,TAR,1,18,0,4,4,17,1,0,0,18,17,1,0,0,18,18,2,1,3,0,0,1,1,0
"43010153",ESC,Centre públic Dep. i CEB,Escola Vora Mar,Salou,TAR,TAR,1,20,0,0,0,6,13,0,0,19,6,13,0,0,19,19,6,13,19,0,0,1,1,0
"43010165",ESC,Centre públic Dep. i CEB,Escola Marta Mata,El Vendrell,TAR,PEN,1,16,0,2,2,17,0,0,0,17,16,0,0,0,16,16,16,0,16,0,0,1,1,0
"43010189",INS,Centre públic Dep. i CEB,Institut Mediterrània,El Vendrell,TAR,PEN,1,24,2,0,2,19,0,0,0,19,19,0,0,0,19,21,19,0,19,2,2,1,1,0
"43010220",ESC,Centre públic Dep. i CEB,Escola de Maspujols,Maspujols,TAR,TAR,1,9,1,1,2,0,7,0,0,7,0,7,0,0,7,8,0,7,7,2,2,1,1,0
"43010311",CFA,CFA Departament,CFA Ribera d'Ebre,Móra d'Ebre,TEB,TEB,1,2,0,0,0,6,0,0,0,6,2,0,0,0,2,2,0,0,0,0,0,1,1,0
"43010323",CFA,CFA Departament,CFA Montblanc,Montblanc,TAR,TAR,1,1,0,1,1,3,0,0,1,4,1,0,0,0,1,1,0,0,0,0,0,1,1,0
"43010335",INS,Centre públic Dep. i CEB,Institut La Mar de la Frau,Cambrils,TAR,TAR,1,17,0,0,0,18,0,0,0,18,17,0,0,0,17,17,0,17,17,0,0,1,1,0
"43010347",INS,Centre públic Dep. i CEB,Institut Marta Mata,Salou,TAR,TAR,1,24,4,0,4,19,0,0,0,19,19,0,0,0,19,23,0,0,0,4,4,1,1,0
"43010372",INS,Centre públic Dep. i CEB,Institut La Talaia,Segur de Calafell (Calafell),TAR,PEN,1,32,3,4,7,22,0,0,0,22,22,0,0,0,22,25,22,0,22,7,7,1,1,0
"43010396",ESC,Centre públic Dep. i CEB,Escola de Ponent,Tarragona,TAR,TAR,1,11,0,0,0,11,1,0,0,12,11,0,0,0,11,11,11,0,11,0,0,1,1,0
"43010402",ESC,Centre públic Dep. i CEB,Escola El Roquissar,Altafulla,TAR,TAR,1,9,1,5,6,9,0,0,0,9,8,0,0,0,8,9,0,0,0,1,1,1,1,0
"43010414",INS,Centre públic Dep. i CEB,Institut Coster de la Torre,La Bisbal del Penedès,TAR,PEN,1,30,2,0,2,23,0,0,0,23,23,0,0,0,23,25,0,0,0,2,2,1,1,0
"43010487",ESC,Centre públic Dep. i CEB,Escola Marcel·lí Esquius,Miami Platja (Mont-roig del Camp),TAR,TAR,1,10,1,7,8,0,2,4,0,6,0,2,4,0,6,7,0,2,2,4,3,1,1,0
"43010499",CFA,CFA Departament,CFA Pau Casals,El Catllar,TAR,TAR,1,0,0,0,0,0,3,0,0,3,0,0,0,0,0,0,0,0,0,0,0,1,1,0
"43010505",ESC,Centre públic Dep. i CEB,Escola La Vitxeta,Reus,TAR,TAR,1,18,0,8,8,0,0,7,1,8,0,0,7,1,8,8,7,1,8,8,5,1,1,0
"43010529",ESC,Centre públic Dep. i CEB,Escola Cavaller Arnau,Riudoms,TAR,TAR,1,10,1,4,5,1,1,9,0,11,1,1,7,0,9,10,0,0,0,1,1,1,1,0
"43010530",ESC,Centre públic Dep. i CEB,Escola Miramar,Vila-seca de Solcina (Vila-seca),TAR,TAR,1,18,0,0,0,12,6,0,0,18,12,6,0,0,18,18,6,6,12,0,0,1,1,0
"43010578",INS,Centre públic Dep. i CEB,Institut Fontanelles,Les Borges del Camp,TAR,TAR,1,24,1,0,1,26,6,5,2,39,23,0,0,0,23,24,0,8,8,1,1,1,1,0
"43010581",ESC,Centre públic Dep. i CEB,Escola Mas Clariana,Cambrils,TAR,TAR,1,16,0,0,0,18,0,0,0,18,16,0,0,0,16,16,16,0,16,0,0,1,1,0
"43010591",ESC,Centre públic Dep. i CEB,Escola Arquitecte Jujol,Els Pallaresos,TAR,TAR,1,9,0,1,1,10,0,0,0,10,9,0,0,0,9,9,9,0,9,0,0,1,1,0
"43010608",INS,Centre públic Dep. i CEB,Institut Serra de Miramar,Valls,TAR,TAR,1,21,0,0,0,28,0,0,0,28,21,0,0,0,21,21,21,0,21,0,0,1,1,0
"43010621",ESC-ZER,Centre públic Dep. i CEB,Escola Cingle Roig - ZER Baix Camp Nord,Vilaplana,TAR,TAR,1,3,1,0,1,0,0,1,3,4,0,0,1,1,2,3,1,1,2,1,1,1,0,0
"43010669",EOI,Centre públic Dep. i CEB,EOI d'Amposta,Amposta,TEB,TEB,1,19,0,0,0,0,0,3,0,3,0,0,3,0,3,3,0,0,0,0,0,1,1,0
"43010670",EOI,Centre públic Dep. i CEB,EOI de Valls,Valls,TAR,TAR,1,13,0,2,2,6,0,0,0,6,6,0,0,0,6,6,0,0,0,2,2,1,1,0
"43010748",INS,Centre públic Dep. i CEB,Institut Els Pallaresos,Els Pallaresos,TAR,TAR,1,25,5,0,5,6,6,2,6,20,6,6,2,6,20,25,3,0,3,5,5,1,1,0
"43010773",ESC,Centre públic Dep. i CEB,Escola Consol Ferré,Amposta,TEB,TEB,1,31,0,0,0,0,18,0,0,18,0,18,0,0,18,18,0,8,8,0,0,1,1,0
"43010815",ESC,Centre públic Dep. i CEB,Escola Els Cossetans,Cunit,TAR,PEN,1,17,0,0,0,18,0,0,0,18,17,0,0,0,17,17,17,0,17,0,0,1,1,0
"43010839",ESC-ZER,Centre públic Dep. i CEB,Escola Serra Major - ZER L'Aglà,La Vilella Baixa,TAR,TAR,1,2,1,0,1,0,0,1,0,1,0,0,1,0,1,2,1,0,1,1,1,1,0,0
"43010852",INS,Centre públic Dep. i CEB,Institut Roseta Mauri,Reus,TAR,TAR,1,27,5,0,5,0,0,23,0,23,0,0,22,0,22,27,22,0,22,5,5,1,1,0
"43010864",ESC,Centre públic Dep. i CEB,Escola Isabel Besora,Reus,TAR,TAR,1,16,5,2,7,14,0,0,0,14,11,0,0,0,11,16,4,0,4,5,5,1,1,0
"43010888",INS,Centre públic Dep. i CEB,Institut de Tecnificació,Amposta,TEB,TEB,1,24,0,5,5,18,0,0,0,18,18,0,0,0,18,18,0,0,0,5,5,1,1,0
"43010980",EOI,Centre públic Dep. i CEB,EOI Ribera d'Ebre,Móra d'Ebre,TEB,TEB,1,10,0,0,0,6,0,0,0,6,6,0,0,0,6,6,0,0,0,0,0,1,1,0
"43011121",ESC,Centre públic Dep. i CEB,Escola Vilamar,Calafell,TAR,PEN,1,9,1,1,2,0,9,0,0,9,0,8,0,0,8,9,0,8,8,1,1,1,1,0
"43011145",ESC,Centre públic Dep. i CEB,Escola Els Ganxets,Reus,TAR,TAR,1,9,1,0,1,9,0,0,0,9,8,0,0,0,8,9,8,0,8,1,1,1,1,0
"43011170",INS,Centre públic Dep. i CEB,Institut Cristòfol Despuig,Tortosa,TEB,TEB,1,21,1,0,1,20,0,0,0,20,20,0,0,0,20,21,20,0,20,1,1,1,1,0
"43011194",ESC,Centre públic Dep. i CEB,Escola El Cucurull,Roda de Berà,TAR,TAR,1,9,0,2,2,12,0,0,0,12,9,0,0,0,9,9,3,0,3,0,0,1,1,0
"43011200",EOI,Centre públic Dep. i CEB,EOI de Salou,Salou,TAR,TAR,1,16,0,0,0,0,4,0,0,4,0,4,0,0,4,4,0,4,4,0,0,1,1,0
"43011212",ESC,Centre públic Dep. i CEB,Escola La Bòbila,Cambrils,TAR,TAR,1,18,0,0,0,18,0,0,0,18,18,0,0,0,18,18,10,0,10,0,0,1,1,0
"43011418",INS,Centre públic Dep. i CEB,Institut Roda de Berà,Roda de Berà,TAR,TAR,1,13,1,0,1,15,5,0,0,20,12,0,0,0,12,13,12,0,12,1,1,1,1,0
"43011479",INS,Centre públic Dep. i CEB,Institut Tarragona,Tarragona,TAR,TAR,1,24,2,0,2,22,0,0,0,22,22,0,0,0,22,24,0,0,0,2,2,1,1,0
"43011492",ESC,Centre públic Dep. i CEB,Escola La Canaleta,Vila-seca de Solcina (Vila-seca),TAR,TAR,1,19,0,8,8,12,0,0,6,18,12,0,0,6,18,18,12,6,18,1,1,1,1,0
"43011765",CFA,CFA Municipals no CEB,CFA Àgora,Salou,TAR,TAR,0,3,0,0,0,0,0,0,0,0,3,0,0,0,3,3,0,0,0,0,0,0,1,0
"43011935",CFA,CFA Municipals no CEB,CFA M. Dolors Paul,Cunit,TAR,PEN,0,2,0,0,0,0,0,0,0,0,2,0,0,0,2,2,0,0,0,0,0,0,1,0
"43012083",IE,Centre públic Dep. i CEB,Institut Escola Pi del Burgar,Reus,TAR,TAR,1,26,0,3,3,26,0,0,0,26,26,0,0,0,26,26,5,2,7,0,0,1,1,0
"43012095",ESC,Centre públic Dep. i CEB,Escola Joan Miró,Miami Platja (Mont-roig del Camp),TAR,TAR,1,19,0,0,0,1,0,17,2,20,1,0,17,1,19,19,18,0,18,0,0,1,1,0
"43012113",IE,Centre públic Dep. i CEB,Institut Escola Mare de Déu del Portal,Batea,TEB,TEB,1,14,11,3,14,9,0,3,0,12,3,0,0,0,3,14,3,0,3,11,4,1,1,0
"43012289",IE,Centre públic Dep. i CEB,Institut Escola 3 d'Abril,Móra la Nova,TEB,TEB,1,24,10,0,10,1,0,22,0,23,1,0,13,0,14,24,11,1,12,10,7,1,1,0
"43012307",IE,Centre públic Dep. i CEB,Institut Escola Daniel Mangrané,Jesús (Tortosa),TEB,TEB,1,25,30,0,30,8,2,0,0,10,0,0,0,0,0,30,0,0,0,25,7,1,1,0
"43012319",IE,Centre públic Dep. i CEB,Institut Escola El Perelló,El Perelló,TEB,TEB,1,28,5,2,7,0,26,0,0,26,0,23,0,0,23,28,0,8,8,5,5,1,1,0
"43012435",AH,Aules hospitalàries,A. Hospitalària Hospital de Dia de Tortosa,Tortosa,TEB,TEB,0,1,0,0,0,0,0,0,0,0,0,0,1,0,1,1,0,0,0,0,0,0,0,0
"43012769",EE,Centre públic Dep. i CEB,CEE Font del Lleó,Reus,TAR,TAR,1,5,6,0,6,0,0,8,0,8,0,0,0,0,0,6,0,0,0,5,2,1,1,0
"43012812",IE,Centre públic Dep. i CEB,Institut Escola L'Agulla,El Catllar,TAR,TAR,1,21,1,0,1,0,0,0,23,23,0,0,0,20,20,21,0,20,20,1,1,1,1,0
"43012903",ESC-ZER,Centre públic Dep. i CEB,Escola El Bosc - ZER El Francolí,Mont-ral,TAR,TAR,1,1,1,0,1,1,0,0,0,1,0,0,0,0,0,1,0,0,0,1,1,1,0,0
"43012939",INS,Casos especials,Òrgan Gestor del Complex Educatiu de Tarragona,Tarragona,TAR,TAR,1,0,0,0,0,0,14,0,0,14,0,0,0,0,0,0,0,0,0,0,0,1,0,0
"43012976",IE,Centre públic Dep. i CEB,Institut Escola Mediterrani,Bonavista (Tarragona),TAR,TAR,1,13,3,1,4,13,0,0,0,13,10,0,0,0,10,13,5,0,5,3,3,1,1,0
"43012988",INS,Centre públic Dep. i CEB,Institut de Miami,Miami Platja (Mont-roig del Camp),TAR,TAR,1,12,1,0,1,0,15,0,0,15,0,11,0,0,11,12,0,11,11,1,1,1,1,0
"43013002",AH,Aules hospitalàries,A. Hospitalària H.de dia salut mental infanto juvenil deTarragona,Tarragona,TAR,TAR,0,1,0,0,0,0,0,0,0,0,0,0,1,0,1,1,0,0,0,0,0,0,0,0
"43013075",IE,Centre públic Dep. i CEB,Institut Escola Àngel de Tobies,El Vendrell,TAR,PEN,1,24,11,0,11,12,0,6,0,18,12,0,1,0,13,24,6,0,6,11,7,1,1,0
"43013087",IE,Centre públic Dep. i CEB,Institut Escola Corbatera,Cornudella de Montsant,TAR,TAR,1,13,1,0,1,0,0,6,1,7,0,0,6,1,7,8,1,0,1,1,1,1,1,0
"43013099",IE,Centre públic Dep. i CEB,Institut Escola Agustí Barberà,Amposta,TEB,TEB,1,22,15,4,19,6,2,9,2,19,6,1,0,0,7,22,7,0,7,15,6,1,1,0
"43013117",FP,Centre públic Dep. i CEB,Institut d'Est. Profes. Aqüícoles i Ambientals de Catalunya,Sant Carles de la Ràpita,TEB,TEB,1,5,3,0,3,0,0,3,0,3,0,0,2,0,2,5,0,0,0,3,2,1,1,0
"43013129",IE,Centre públic Dep. i CEB,Institut Escola Coma-ruga,El Vendrell,TAR,PEN,1,30,9,2,11,0,17,0,0,17,0,17,0,0,17,26,0,17,17,11,8,1,1,0
"43013130",IE,Centre públic Dep. i CEB,Institut Escola Joan Ardèvol,Cambrils,TAR,TAR,1,22,5,2,7,16,4,0,0,20,16,1,0,0,17,22,6,0,6,5,5,1,1,0
"43013142",IE,Centre públic Dep. i CEB,Institut Escola El Temple,Tortosa,TEB,TEB,1,24,10,0,10,10,12,0,0,22,10,4,0,0,14,24,14,0,14,10,7,1,1,0
"43013191",IE,Centre públic Dep. i CEB,Institut Escola L'Arrabassada,Tarragona,TAR,TAR,0,20,2,0,2,0,0,0,0,0,0,0,0,0,0,2,0,0,0,0,0,1,1,18
