id,nom,municipi,sstt,ssttNou,idResposta,dataResposta,pDepartament,pAltres,pTotal,e75paret,e75rodes,e65paret,e65rodes,eTotal,srFixes,srRodes,srTotal,retirada,armaris
"08000013",Escola Francesc Platón i Sartí,Abrera,BLL,BLL,4230878,01/04/2022,0,0,0,0,0,0,20,20,0,0,0,16,5
"08000049",Escola Fabra,Alella,MVO,MVO,4225112,29/03/2022,0,6,6,17,0,0,0,17,17,0,17,16,4
"08000086",Escola La Forja - ZER Alt Lluçanès,Alpens,CCE,CCE,4229999,31/03/2022,0,0,0,1,1,0,0,2,1,1,2,0,1
"08000098",Escola Bertí,L'Ametlla del Vallès,MVO,MVO,4227853,30/03/2022,2,1,3,4,0,0,0,4,3,1,4,4,0
"08000153",Escola Joan Maragall,Arenys de Mar,MVO,MVO,4223402,28/03/2022,0,0,0,17,1,9,0,27,9,1,10,17,5
"08000165",Escola Sant Martí,Arenys de Munt,MVO,MVO,4218886,25/03/2022,1,1,2,15,1,0,0,16,15,1,16,15,2
"08000189",Escola Bernat de Riudemeia,Argentona,MVO,MVO,4229994,31/03/2022,8,5,13,8,0,1,1,10,0,0,0,7,2
"08000244",Escola Doctor Ferrer,Artés,CCE,CCE,4227588,30/03/2022,0,0,0,16,2,0,0,18,16,2,18,18,4
"08000271",Escola Santa Maria d'Avià,Avià,CCE,CCE,4215491,24/03/2022,0,0,0,10,2,0,0,12,10,2,12,10,3
"08000347",Escola d'Avinyonet del Penedès,Avinyó Nou (Avinyonet del Penedès),BCO,PEN,4213455,23/03/2022,5,6,11,6,0,0,0,6,6,0,6,4,1
"08000359",Escola La Muntanya,Aiguafreda,MVO,MVO,4229938,31/03/2022,0,0,0,5,3,0,3,11,5,6,11,8,3
"08000384",Escola Lola Anglada,Badalona,BCO,BCO,4228959,31/03/2022,0,0,0,1,0,9,2,12,0,0,0,3,4
"08000396",Escola Ventós i Mir,Badalona,BCO,BCO,4214015,23/03/2022,4,1,5,0,0,12,0,12,12,0,12,8,1
"08000402",Escola Feliu i Vegués,Badalona,BCO,BCO,4216360,24/03/2022,1,7,8,7,0,0,0,7,7,0,7,7,1
"08001391",Escola Planas i Casals,Badalona,BCO,BCO,4227861,30/03/2022,0,0,0,7,11,0,0,18,7,11,18,0,2
"08001421",Institut La Pineda,Badalona,BCO,BCO,4225889,29/03/2022,0,0,0,0,10,0,2,12,0,0,0,0,4
"08001431",Institut Isaac Albéniz,Badalona,BCO,BCO,4216259,24/03/2022,0,0,0,22,0,0,0,22,0,0,0,0,0
"08001443",Institut Eugeni d'Ors,Badalona,BCO,BCO,4215627,24/03/2022,0,0,0,14,0,0,12,26,14,12,26,0,2
"08001480",EA Pau Gargallo,Badalona,BCO,BCO,4213674,23/03/2022,0,0,0,6,0,0,0,6,6,0,6,6,3
"08001509",Escola Antoni Botey,Badalona,BCO,BCO,4227415,30/03/2022,1,1,2,18,0,0,0,18,17,1,18,18,3
"08001522",Escola Galceran de Pinós,Bagà,CCE,CCE,4234315,04/04/2022,1,0,1,6,0,0,1,7,3,1,4,10,2
"08001595",Escola Baixeras,Barcelona,CEB,CEB,4222356,28/03/2022,1,3,4,9,0,0,0,9,0,0,0,7,2
"08001601",Escola Parc de la Ciutadella,Barcelona,CEB,CEB,4224686,29/03/2022,1,8,9,1,0,8,0,9,3,0,3,9,1
"08001649",Escola Mossèn Jacint Verdaguer,Barcelona,CEB,CEB,4212958,23/03/2022,3,0,3,18,0,0,0,18,0,0,0,18,2
"08001650",Escola El Polvorí,Barcelona,CEB,CEB,4223504,28/03/2022,2,1,3,6,1,0,0,7,0,1,1,6,1
"08001674",Escola Can Clos,Barcelona,CEB,CEB,4224562,29/03/2022,1,0,1,4,3,0,0,7,4,3,7,0,2
"08001716",Escola Dolors Monserdà-Santapau,Barcelona,CEB,CEB,4230594,31/03/2022,2,0,2,18,0,0,0,18,18,0,18,10,4
"08001731",Escola Poeta Foix,Barcelona,CEB,CEB,4224685,29/03/2022,0,0,0,10,4,0,0,14,10,4,14,15,1
"08001777",Escola Ramon Llull,Barcelona,CEB,CEB,4214708,23/03/2022,0,0,0,20,0,0,0,20,8,0,8,20,3
"08001789",Escola Cervantes,Barcelona,CEB,CEB,4229430,31/03/2022,1,0,1,9,0,0,0,9,9,0,9,9,2
"08001790",Escola Pere Vila,Barcelona,CEB,CEB,4231455,01/04/2022,2,0,2,18,0,0,0,18,6,0,6,18,2
"08001807",Escola de la Concepció,Barcelona,CEB,CEB,4213144,23/03/2022,0,0,0,0,9,0,0,9,0,0,0,8,2
"08001819",Escola Collaso i Gil,Barcelona,CEB,CEB,4213242,23/03/2022,0,0,0,13,0,0,0,13,0,0,0,13,4
"08001820",Escola Milà i Fontanals,Barcelona,CEB,CEB,4227371,30/03/2022,0,0,0,18,3,0,0,21,18,3,21,10,4
"08001832",Escola Castella,Barcelona,CEB,CEB,4231487,01/04/2022,0,0,0,8,1,0,0,9,8,1,9,4,2
"08001856",Escola Drassanes,Barcelona,CEB,CEB,4229029,31/03/2022,4,7,11,0,0,13,1,14,6,1,7,4,2
"08001868",Escola Rubén Darío,Barcelona,CEB,CEB,4226906,30/03/2022,1,0,1,0,1,5,2,8,5,2,7,7,1
"08001911",Escola Els Llorers,Barcelona,CEB,CEB,4223400,28/03/2022,12,8,20,0,1,7,4,12,3,2,5,7,5
"08001923",Escola Diputació,Barcelona,CEB,CEB,4225198,29/03/2022,0,12,12,0,20,0,0,20,17,3,20,14,6
"08001947",Escola Mallorca,Barcelona,CEB,CEB,4230176,31/03/2022,0,0,0,18,0,0,0,18,18,0,18,15,4
"08002009",Escola Francesc Macià,Barcelona,CEB,CEB,4236930,05/04/2022,2,3,5,2,0,7,0,9,9,0,9,9,2
"08002010",Escola Lluís Vives,Barcelona,CEB,CEB,4235282,04/04/2022,5,4,9,9,0,0,0,9,9,0,9,7,2
"08002022",Escola Cal Maiol,Barcelona,CEB,CEB,4229581,31/03/2022,1,0,1,11,0,0,0,11,11,0,11,10,2
"08002058",Escola Pràctiques,Barcelona,CEB,CEB,4214095,23/03/2022,3,0,3,18,0,0,0,18,18,0,18,21,5
"08002061",Escola Jaume I,Barcelona,CEB,CEB,4230688,31/03/2022,1,2,3,14,0,0,4,18,0,3,3,22,4
"08002071",Escola Gayarre,Barcelona,CEB,CEB,4234763,04/04/2022,1,0,1,6,3,0,0,9,6,3,9,4,2
"08002113",Escola Rius i Taulet,Barcelona,CEB,CEB,4235007,04/04/2022,0,2,2,17,0,0,0,17,17,0,17,17,5
"08002174",Escola Baldiri Reixac,Barcelona,CEB,CEB,4225164,29/03/2022,0,0,0,9,0,0,0,9,9,0,9,9,1
"08002186",Escola Mare de Déu de Montserrat,Barcelona,CEB,CEB,4213894,23/03/2022,0,0,0,9,0,0,0,9,6,0,6,9,3
"08002198",Escola La Farigola de Vallcarca,Barcelona,CEB,CEB,4230036,31/03/2022,0,0,0,8,1,0,0,9,3,0,3,9,2
"08002204",Escola Montseny,Barcelona,CEB,CEB,4218888,25/03/2022,0,0,0,6,3,0,0,9,6,3,9,6,3
"08002216",Escola Josep Maria de Sagarra,Barcelona,CEB,CEB,4228098,30/03/2022,0,0,0,9,0,0,0,9,9,0,9,9,2
"08002277",Escola Calderón de la Barca,Barcelona,CEB,CEB,4236347,05/04/2022,1,0,1,18,0,0,0,18,0,0,0,1,4
"08002290",Escola Emili Juncadella,Barcelona,CEB,CEB,4221336,28/03/2022,1,0,1,0,9,0,0,9,0,0,0,0,2
"08002320",Escola Ciutat Comtal,Barcelona,CEB,CEB,4225227,29/03/2022,2,11,13,0,9,0,0,9,0,9,9,0,2
"08002344",Escola El Turó,Barcelona,CEB,CEB,4236921,05/04/2022,1,0,1,0,0,6,2,8,3,0,3,6,2
"08002368",Escola Timbaler del Bruc,Barcelona,CEB,CEB,4237108,05/04/2022,1,0,1,6,1,6,0,13,4,1,5,11,2
"08002393",Escola L'Arc de Sant Martí,Barcelona,CEB,CEB,4228971,31/03/2022,6,9,15,2,0,1,0,3,0,0,0,2,4
"08002411",Escola Baró de Viver,Barcelona,CEB,CEB,4226997,30/03/2022,1,0,1,9,0,0,0,9,9,0,9,7,3
"08002459",Escola Elisenda de Montcada,Barcelona,CEB,CEB,4213998,23/03/2022,10,14,24,7,0,0,0,7,0,0,0,7,4
"08002484",Escola Marta Mata,Barcelona,CEB,CEB,4230046,31/03/2022,1,0,1,0,0,0,8,8,0,8,8,0,2
"08002526",Escola Tibidabo,Barcelona,CEB,CEB,4213813,23/03/2022,0,0,0,9,0,0,0,9,9,0,9,9,2
"08002538",Escola Víctor Català,Barcelona,CEB,CEB,MANUAL,44659,0,1,1,18,0,0,0,18,6,0,6,18,2
"08002551",Escola Molí de Finestrelles,Barcelona,CEB,CEB,4227569,30/03/2022,0,0,0,19,0,0,0,19,19,0,19,19,4
"08002563",Escola La Mar Bella,Barcelona,CEB,CEB,4231763,01/04/2022,1,0,1,0,12,2,2,16,2,14,16,10,3
"08002575",Escola La Pau,Barcelona,CEB,CEB,4222547,28/03/2022,0,0,0,10,0,3,2,15,0,2,2,12,2
"08002587",Escola Concepción Arenal,Barcelona,CEB,CEB,4213096,23/03/2022,1,0,1,0,9,0,0,9,0,9,9,0,2
"08002599",Escola Eduard Marquina,Barcelona,CEB,CEB,4226856,30/03/2022,1,0,1,0,0,0,9,9,0,9,9,1,2
"08002617",Escola Rambleta del Clot,Barcelona,CEB,CEB,4227904,30/03/2022,0,3,3,10,0,0,4,14,5,4,9,10,5
"08002629",Escola Les Acàcies,Barcelona,CEB,CEB,4223399,28/03/2022,0,2,2,18,1,0,0,19,18,1,19,19,4
"08002630",Escola Els Porxos,Barcelona,CEB,CEB,4225687,29/03/2022,1,0,1,7,0,0,2,9,3,2,5,7,1
"08002642",Escola Poblenou,Barcelona,CEB,CEB,4225516,29/03/2022,0,4,4,14,0,0,0,14,10,0,10,14,4
"08002654",Escola Prim,Barcelona,CEB,CEB,4236682,05/04/2022,6,3,9,0,0,0,10,10,0,10,10,4,2
"08002666",CEE Concha Espina,Barcelona,CEB,CEB,4234478,04/04/2022,6,3,9,3,0,0,0,3,0,0,0,2,0
"08002681",Escola Duran i Bas,Barcelona,CEB,CEB,4236524,05/04/2022,0,0,0,17,1,0,0,18,6,1,7,18,4
"08002721",Escola Font d'en Fargas,Barcelona,CEB,CEB,4222358,28/03/2022,2,2,4,19,0,0,0,19,19,0,19,19,4
"08002733",Escola Miralletes,Barcelona,CEB,CEB,4227464,30/03/2022,1,0,1,6,0,0,3,9,6,3,9,7,2
"08002745",Escola El Carmel,Barcelona,CEB,CEB,4222615,28/03/2022,17,0,17,0,0,7,0,7,2,0,2,5,2
"08002770",Escola Àgora,Barcelona,CEB,CEB,4211864,22/03/2022,0,2,2,5,2,2,0,9,2,2,4,5,3
"08002800",Escola Mas Casanovas,Barcelona,CEB,CEB,4233863,04/04/2022,0,1,1,8,1,0,0,9,8,1,9,5,2
"08002873",Escola Bac de Roda,Barcelona,CEB,CEB,4218744,25/03/2022,0,20,20,18,0,0,0,18,0,0,0,18,4
"08002897",Escola Mestre Morera,Barcelona,CEB,CEB,4218240,25/03/2022,3,0,3,5,1,1,0,7,3,0,3,7,2
"08002915",Escola Brasil,Barcelona,CEB,CEB,4225474,29/03/2022,0,0,0,9,0,0,4,13,5,4,9,20,4
"08002927",Escola Joaquim Ruyra,Barcelona,CEB,CEB,4213488,23/03/2022,0,0,0,18,0,0,0,18,6,0,6,8,4
"08002952",Escola Enric Granados,Barcelona,CEB,CEB,4218768,25/03/2022,0,0,0,9,0,0,0,9,4,0,4,9,2
"08002976",Escola Ramon Casas,Barcelona,CEB,CEB,4215019,23/03/2022,1,2,3,11,0,4,0,15,15,0,15,15,4
"08002988",Escola Pare Poveda,Barcelona,CEB,CEB,4230174,31/03/2022,0,0,0,10,0,4,1,15,14,1,15,12,2
"08002991",Escola Cascavell,Sant Adrià de Besòs,BCO,BCO,4227868,30/03/2022,1,0,1,0,1,0,0,1,0,0,0,0,4
"08003491",Escola De Bosc de Montjuïc,Barcelona,CEB,CEB,4227848,30/03/2022,1,0,1,0,9,0,0,9,0,0,0,0,2
"08003695",Escola Bàrkeno,Barcelona,CEB,CEB,4222490,28/03/2022,0,11,11,9,0,0,0,9,9,0,9,9,2
"08004389",Escola Reina Violant,Barcelona,CEB,CEB,4212889,23/03/2022,0,0,0,13,0,0,0,13,13,0,13,13,3
"08007202",Escola Patronat Domènech,Barcelona,CEB,CEB,4226934,30/03/2022,0,0,0,9,0,0,0,9,3,0,3,9,2
"08008449",Escola Turó Blau,Barcelona,CEB,CEB,4216641,24/03/2022,0,0,0,9,0,0,0,9,5,0,5,9,1
"08009171",Escola Casas,Barcelona,CEB,CEB,4227250,30/03/2022,0,0,0,13,3,2,0,18,6,3,9,14,2
"08009776",Escola Arc Iris,Barcelona,CEB,CEB,4227426,30/03/2022,0,0,0,0,0,6,3,9,6,3,9,9,1
"08010146",Escola del Mar,Barcelona,CEB,CEB,4231141,01/04/2022,0,0,0,0,0,0,9,9,0,9,9,0,2
"08010201",Escola Parc del Guinardó,Barcelona,CEB,CEB,4218878,25/03/2022,0,0,0,9,0,3,0,12,3,0,3,11,1
"08010912",Escola Ignasi Iglésias,Barcelona,CEB,CEB,4213254,23/03/2022,7,0,7,7,1,0,0,8,0,0,0,7,2
"08012714",Institut Anna Gironella de Mundet,Barcelona,CEB,CEB,4234981,04/04/2022,0,0,0,28,0,0,0,28,28,0,28,23,28
"08013093",Institut Montjuïc,Barcelona,CEB,CEB,4227219,30/03/2022,1,0,1,10,0,0,0,10,0,0,0,10,4
"08013101",Institut Joan d'Àustria,Barcelona,CEB,CEB,4226264,29/03/2022,0,24,24,18,1,5,0,24,0,0,0,20,0
"08013111",Institut Jaume Balmes,Barcelona,CEB,CEB,4228149,30/03/2022,0,0,0,30,2,0,0,32,30,2,32,30,6
"08013135",Institut Moisès Broggi,Barcelona,CEB,CEB,4227607,30/03/2022,0,0,0,20,5,0,0,25,20,5,25,0,6
"08013147",Institut Sants,Barcelona,CEB,CEB,4227494,30/03/2022,1,0,1,0,38,0,0,38,0,20,20,0,0
"08013159",Institut Infanta Isabel d'Aragó,Barcelona,CEB,CEB,4229425,31/03/2022,0,0,0,25,0,0,0,25,0,0,0,0,0
"08013160",Institut Poeta Maragall,Barcelona,CEB,CEB,4227441,30/03/2022,0,0,0,16,0,1,3,20,0,0,0,17,2
"08013184",Institut Bernat Metge,Barcelona,CEB,CEB,4236852,05/04/2022,0,0,0,0,1,10,0,11,10,1,11,10,0
"08013196",Institut Milà i Fontanals,Barcelona,CEB,CEB,4222745,28/03/2022,0,0,0,19,0,0,0,19,0,0,0,19,10
"08013202",Institut Montserrat,Barcelona,CEB,CEB,4213378,23/03/2022,0,0,0,0,26,0,0,26,0,26,26,1,26
"08013214",Institut Narcís Monturiol,Barcelona,CEB,CEB,4230576,31/03/2022,0,0,0,11,0,0,1,12,0,1,1,9,4
"08013226",Institut Menéndez y Pelayo,Barcelona,CEB,CEB,4225247,29/03/2022,0,0,0,0,6,0,16,22,0,22,22,13,10
"08013238",Institut Verdaguer,Barcelona,CEB,CEB,4221795,28/03/2022,0,0,0,10,0,0,0,10,0,0,0,10,10
"08013275",Institut Escola del Treball,Barcelona,CEB,CEB,4228686,30/03/2022,0,2,2,11,23,0,0,34,11,20,31,13,40
"08013329",EA Llotja,Barcelona,CEB,CEB,4224902,29/03/2022,0,0,0,8,2,0,0,10,8,2,10,6,0
"08013354",CEE Municipal Vil·la Joana,Barcelona,CEB,CEB,4230924,01/04/2022,0,0,0,3,1,1,3,8,4,4,8,4,2
"08013366",Institut Nou Barris,Barcelona,CEB,CEB,4218756,25/03/2022,0,0,0,17,0,0,0,17,2,0,2,10,6
"08013408",Escola Barcelona,Barcelona,CEB,CEB,4218875,25/03/2022,0,0,0,19,0,0,0,19,19,0,19,19,4
"08013411",Escola Poble-sec,Barcelona,CEB,CEB,4222974,28/03/2022,4,0,4,14,3,0,0,17,6,0,6,14,4
"08013457",Escola Pegaso,Barcelona,CEB,CEB,4225423,29/03/2022,1,0,1,14,0,3,1,18,3,0,3,6,4
"08013469",Institut Rambla Prim,Barcelona,CEB,CEB,4211915,22/03/2022,0,0,0,0,9,0,0,9,0,9,9,0,0
"08013470",Institut Barri Besòs,Barcelona,CEB,CEB,4234079,04/04/2022,0,0,0,2,2,10,3,17,12,5,17,0,0
"08013901",CEE La Ginesta,Barcelona,CEB,CEB,4229885,31/03/2022,0,1,1,0,0,7,1,8,0,1,1,0,1
"08014115",Institut Ferran Tallada,Barcelona,CEB,CEB,4229698,31/03/2022,0,0,0,12,0,0,0,12,12,0,12,12,0
"08014188",Institut Josep Serrat i Bonastre,Barcelona,CEB,CEB,4233192,04/04/2022,0,0,0,13,1,0,0,14,0,1,1,0,5
"08014206",Institut Caterina Albert,Barcelona,CEB,CEB,4231070,01/04/2022,1,1,2,0,18,0,0,18,0,18,18,1,0
"08014401",Institut Mare de Déu de la Mercè,Barcelona,CEB,CEB,4230344,31/03/2022,0,0,0,25,3,0,0,28,0,3,3,0,4
"08014589",Escola Sant Cristòfor,Begues,BLL,BLL,4226881,30/03/2022,0,0,0,13,6,0,0,19,13,2,15,11,4
"08014620",Escola Sant Joan,Berga,CCE,CCE,4214577,23/03/2022,4,0,4,13,1,0,0,14,5,0,5,5,4
"08014668",Escola de la Valldan,Berga,CCE,CCE,4229980,31/03/2022,1,0,1,5,0,0,0,5,5,0,5,5,1
"08014681",Escola Santa Eulàlia,Berga,CCE,CCE,4215679,24/03/2022,0,0,0,18,0,0,0,18,18,0,18,0,4
"08014693",Institut Guillem de Berguedà,Berga,CCE,CCE,4229228,31/03/2022,1,5,6,22,0,0,1,23,0,0,0,22,0
"08014747",Escola El Turó,El Rieral de Bigues (Bigues i Riells),MVO,MVO,4227973,30/03/2022,0,0,0,9,2,0,0,11,5,2,7,11,3
"08014796",Escola de Borredà - ZER Berguedà Centre,Borredà,CCE,CCE,4230075,31/03/2022,1,0,1,0,1,0,0,1,0,1,1,0,1
"08014814",Escola El Bruc,El Bruc,CCE,PEN,4215644,24/03/2022,0,1,1,9,2,0,0,11,5,2,7,4,2
"08014841",Escola Les Oliveres - ZER Serra d'Ancosa,Cabrera d'Anoia,CCE,PEN,4231114,01/04/2022,1,0,1,0,6,0,0,6,6,0,6,4,1
"08014905",Escola L'Olivera,Cabrils,MVO,MVO,4222336,28/03/2022,0,4,4,13,1,0,0,14,0,0,0,0,0
"08014929",Escola Alta Segarra,Calaf,CCE,CCE,4214042,23/03/2022,0,0,0,18,0,0,1,19,6,1,7,0,4
"08015004",Escola Sagrada Família,Caldes d'Estrac,MVO,MVO,4229129,31/03/2022,1,0,1,11,0,0,0,11,11,0,11,3,2
"08015077",Escola El Farell,Caldes de Montbui,MVO,MVO,4227978,30/03/2022,1,0,1,16,2,0,0,18,2,0,2,16,4
"08015107",Escola Anton Busquets i Punset - ZER El Moianès Ponent,Calders,CCE,CCE,4230430,31/03/2022,0,1,1,4,0,0,0,4,2,0,2,4,0
"08015119",Escola La Minerva,Calella,MVO,MVO,4211973,22/03/2022,1,0,1,20,0,0,0,20,20,0,20,12,2
"08015144",Escola El Far,Calella,MVO,MVO,4226919,30/03/2022,1,7,8,18,0,0,0,18,18,0,18,18,4
"08015171",Institut Bisbe Sivilla,Calella,MVO,MVO,4228460,30/03/2022,0,0,0,22,0,0,0,22,0,0,0,22,5
"08015193",Escola Sant Marc,Calldetenes,CCE,CCE,4214159,23/03/2022,2,0,2,0,0,6,6,12,6,0,6,0,4
"08015247",Escola Joventut,Callús,CCE,CCE,4215914,24/03/2022,1,0,1,0,0,10,0,10,10,0,10,10,2
"08015259",Escola L'Alzinar - ZER Baix Montseny,Campins,MVO,MVO,4225260,29/03/2022,0,0,0,3,0,0,0,3,3,0,3,0,1
"08015302",Escola Misericòrdia,Canet de Mar,MVO,MVO,4225408,29/03/2022,0,0,0,17,0,0,0,17,17,0,17,0,5
"08015351",Escola Jacint Verdaguer,Sanaüja (Canovelles),MVO,MVO,4221821,28/03/2022,1,0,1,10,0,0,0,10,3,0,3,13,2
"08015375",Escola l'Estelada,Cànoves (Cànoves i Samalús),MVO,MVO,4217825,25/03/2022,1,0,1,8,6,0,0,14,8,6,14,0,2
"08015399",Escola Sant Nicolau,Canyelles,BCO,PEN,4229692,31/03/2022,0,0,0,18,0,0,0,18,18,0,18,18,4
"08015430",Escola Marquès de la Pobla,Capellades,CCE,PEN,4229530,31/03/2022,0,0,0,9,0,0,8,17,9,0,9,0,2
"08015454",Escola Ramon Macip - Dolors Granés,Cardedeu,MVO,MVO,4213627,23/03/2022,1,5,6,10,0,0,0,10,0,0,0,10,1
"08015582",Escola Patrocini,Cardona,CCE,CCE,4231664,01/04/2022,1,0,1,0,2,9,0,11,9,2,11,9,3
"08015612",Escola Joan de Palà - ZER El Cardener,La Coromina (Cardona),CCE,CCE,4216435,24/03/2022,0,0,0,2,0,0,0,2,2,0,2,0,1
"08015648",Escola Serra de Coll-Bas,Carme,CCE,PEN,4222424,28/03/2022,0,0,0,4,1,0,0,5,4,1,5,4,1
"08015651",Escola Princesa Làscaris,Casserres,CCE,CCE,4229657,31/03/2022,0,0,0,0,2,6,0,8,6,2,8,0,3
"08015806",Escola Jaume Balmes,El Borràs (Castellbell i el Vilar),CCE,CCE,4214574,23/03/2022,0,0,0,9,2,0,0,11,9,2,11,11,4
"08015821",Escola Mare de Déu de Montserrat,Castellbisbal,VOC,VOC,4226907,30/03/2022,0,0,0,16,0,1,0,17,0,0,0,17,2
"08015831",Escola La Popa,Castellcir,CCE,CCE,4213956,23/03/2022,2,1,3,1,0,0,0,1,0,0,0,1,1
"08015843",Escola Lluís Vives,Castelldefels,BLL,BLL,4221429,28/03/2022,0,0,0,18,0,0,0,18,18,0,18,18,4
"08015855",Escola Els Pins,Castelldefels,BLL,BLL,4214365,23/03/2022,0,0,0,18,0,0,0,18,18,0,18,18,4
"08015961",Escola Jacint Verdaguer,Castelldefels,BLL,BLL,4214544,23/03/2022,0,0,0,7,2,0,0,9,7,2,9,0,2
"08016033",Escola Montanyans,Sant Marçal (Castellet i la Gornal),BCO,PEN,4213010,23/03/2022,1,1,2,0,7,0,0,7,3,4,7,7,2
"08016082",Escola Sant Roc - ZER Vent d'Avall,Castellfollit de Riubregós,CCE,CCE,4218427,25/03/2022,1,0,1,0,0,0,0,0,0,0,0,0,1
"08016094",Escola Sant Miquel,Castellgalí,CCE,CCE,4217723,25/03/2022,1,2,3,9,0,0,0,9,9,0,9,0,2
"08016136",Escola Les Passeres - ZER Tres Branques,Castellolí,CCE,PEN,4214101,23/03/2022,1,0,1,1,0,4,0,5,5,0,5,4,1
"08016161",Escola El Castellot,La Múnia (Castellví de la Marca),BCO,PEN,4231475,01/04/2022,2,0,2,7,0,0,0,7,7,0,7,7,1
"08016173",Escola Mare de Déu de Montserrat,Castellví de Rosanes,BLL,BLL,4227119,30/03/2022,1,0,1,0,0,8,0,8,4,0,4,6,2
"08016185",Escola Ildefons Cerdà,Centelles,CCE,CCE,4222750,28/03/2022,0,0,0,0,17,0,0,17,0,17,17,0,4
"08016240",Escola Santa Maria de Cervelló,Cervelló,BLL,BLL,4217621,25/03/2022,0,0,0,19,0,0,0,19,19,0,19,19,5
"08016264",Escola El Solell,La Palma de Cervelló,BLL,BLL,4212745,23/03/2022,0,16,16,16,0,0,0,16,16,0,16,16,2
"08016291",Escola Quatre Vents - ZER Vent d'Avall,Copons,CCE,PEN,4234167,04/04/2022,1,0,1,2,0,0,0,2,0,0,0,1,1
"08016331",Escola Jaume Balmes,Corbera de Llobregat,BLL,BLL,4227926,30/03/2022,1,0,1,0,15,0,0,15,0,15,15,15,4
"08016367",Escola Dolors Almeda,Cornellà de Llobregat,BLL,BLL,4231723,01/04/2022,0,0,0,12,6,0,0,18,12,6,18,18,4
"08016380",Escola Anselm Clavé,Cornellà de Llobregat,BLL,BLL,4223234,28/03/2022,0,0,0,2,7,0,0,9,2,7,9,2,2
"08016392",Escola Mossèn Jacint Verdaguer,Cornellà de Llobregat,BLL,BLL,4213628,23/03/2022,3,3,6,5,1,0,0,6,5,1,6,6,2
"08016409",Escola Montserrat,Cornellà de Llobregat,BLL,BLL,4227107,30/03/2022,1,0,1,7,1,0,0,8,7,1,8,1,2
"08016410",Escola Sant Ildefons,Cornellà de Llobregat,BLL,BLL,4229385,31/03/2022,1,0,1,11,0,0,0,11,7,0,7,11,4
"08016422",Escola Abat Oliba,Cornellà de Llobregat,BLL,BLL,4230054,31/03/2022,1,1,2,0,0,5,0,5,4,0,4,0,4
"08016744",Escola Antoni Gaudí,Cornellà de Llobregat,BLL,BLL,4225001,29/03/2022,0,0,0,12,0,0,0,12,3,0,3,12,2
"08016771",Escola Els Pins,Cornellà de Llobregat,BLL,BLL,4218942,25/03/2022,0,0,0,17,2,0,0,19,9,2,11,18,4
"08016781",Institut Esteve Terradas i Illa,Cornellà de Llobregat,BLL,BLL,4229552,31/03/2022,1,19,20,9,9,25,1,44,34,10,44,44,8
"08016793",Institut Francesc Macià,Cornellà de Llobregat,BLL,BLL,4218450,25/03/2022,0,3,3,26,0,0,0,26,26,0,26,26,10
"08016811",Escola Josep Andreu - Charlie Rivel,Cubelles,BCO,PEN,4229445,31/03/2022,0,4,4,23,0,0,0,23,6,0,6,23,7
"08016872",Escola Mare de Déu de la Muntanya,Esparreguera,BLL,BLL,4223273,28/03/2022,1,0,1,4,4,0,0,8,4,4,8,4,2
"08016938",Escola Taquígraf Garriga,Esparreguera,BLL,BLL,4230801,01/04/2022,0,0,0,18,0,0,0,18,10,0,10,18,4
"08016941",Escola Isidre Martí,Esplugues de Llobregat,BLL,BLL,4227217,30/03/2022,2,0,2,0,1,13,0,14,13,1,14,13,2
"08017104",Escola Gras i Soler,Esplugues de Llobregat,BLL,BLL,4229284,31/03/2022,2,0,2,0,9,0,0,9,0,5,5,9,5
"08017116",Escola Matilde Orduña,Esplugues de Llobregat,BLL,BLL,4212168,22/03/2022,2,3,5,0,10,0,0,10,0,10,10,0,3
"08017131",Institut Severo Ochoa,Esplugues de Llobregat,BLL,BLL,4226664,30/03/2022,0,24,24,23,1,0,0,24,1,1,2,23,3
"08017153",Institut Joanot Martorell,Esplugues de Llobregat,BLL,BLL,4213852,23/03/2022,0,0,0,19,0,0,0,19,0,0,0,19,1
"08017232",Escola Agrupació Sant Jordi,Fonollosa,CCE,CCE,4231005,01/04/2022,1,0,1,0,0,9,0,9,0,0,0,9,2
"08017244",Escola Font-rúbia,Guardiola de Font-Rubí (Font-rubí),BCO,PEN,4217597,25/03/2022,3,8,11,4,0,0,1,5,3,0,3,3,2
"08017271",Escola Joan Sanpera i Torras,Corró d'Avall (Les Franqueses del Vallès),MVO,MVO,4213049,23/03/2022,0,3,3,15,0,0,0,15,10,0,10,15,4
"08017311",Escola Puiggraciós,La Garriga,MVO,MVO,4229816,31/03/2022,1,0,1,13,0,6,0,19,0,0,0,2,4
"08017359",Escola Salvador Lluch,Gavà,BLL,BLL,4216650,24/03/2022,1,0,1,17,0,0,0,17,12,0,12,18,4
"08017360",Escola Jacme March,Gavà,BLL,BLL,4213971,23/03/2022,5,2,7,7,0,1,0,8,8,0,8,5,3
"08017505",Escola Juan Salamero,Gavà,BLL,BLL,4227055,30/03/2022,2,0,2,0,2,0,0,2,0,0,0,0,1
"08017530",Institut de Bruguers,Gavà,BLL,BLL,4218701,25/03/2022,5,0,5,6,1,0,0,7,0,0,0,0,0
"08017611",Escola Montcau,Gelida,BCO,PEN,4229467,31/03/2022,0,0,0,17,0,0,0,17,17,0,17,0,0
"08017633",Escola Sant Marc,Els Bassacs (Gironella),CCE,CCE,4224856,29/03/2022,0,4,4,4,3,0,0,7,4,3,7,1,3
"08017645",Escola de Gironella,Gironella,CCE,CCE,4216802,24/03/2022,0,12,12,2,2,3,0,7,5,2,7,4,1
"08017682",Escola Jacint Verdaguer,La Granada,BCO,PEN,4216357,24/03/2022,4,0,4,9,0,0,0,9,5,0,5,0,3
"08017694",Escola Pereanton,Granollers,MVO,MVO,4219086,25/03/2022,1,0,1,12,0,0,0,12,8,0,8,11,2
"08017700",Escola Joan Solans,Granollers,MVO,MVO,4212040,22/03/2022,1,1,2,0,7,0,0,7,0,7,7,7,1
"08017712",Escola Ferrer i Guàrdia,Granollers,MVO,MVO,4232062,01/04/2022,1,0,1,5,2,2,0,9,5,0,5,5,2
"08017918",Escola Granullarius,Granollers,MVO,MVO,4227995,30/03/2022,2,3,5,20,0,0,0,20,6,0,6,0,4
"08017931",Institut Antoni Cumella,Granollers,MVO,MVO,4231023,01/04/2022,0,0,0,4,5,2,0,11,0,5,5,1,5
"08017979",Escola Aqua Alba,Gualba,MVO,MVO,4221205,28/03/2022,0,0,0,2,2,0,0,4,2,0,2,0,2
"08017992",Escola Montserrat,Sant Salvador de Guardiola,CCE,CCE,4231519,01/04/2022,1,0,1,12,0,0,0,12,12,0,12,5,2
"08018005",Escola Sant Llorenç,Guardiola de Berguedà,CCE,CCE,4230765,01/04/2022,2,0,2,0,1,1,0,2,0,0,0,1,1
"08018017",Escola L'Albiol - ZER Alt Berguedà,Sant Julià de Cerdanyola,CCE,CCE,4220778,27/03/2022,1,1,2,0,0,1,1,2,1,1,2,0,1
"08018029",Escola Les Escoles,Gurb,CCE,CCE,4226178,29/03/2022,0,0,0,6,3,12,0,21,18,3,21,8,4
"08018066",Escola Menéndez Pidal,L'Hospitalet de Llobregat,BCO,BCO,4218091,25/03/2022,1,24,25,6,0,8,1,15,2,0,2,11,5
"08018078",Escola Bellvitge,L'Hospitalet de Llobregat,BCO,BCO,4231427,01/04/2022,1,0,1,8,0,1,0,9,9,0,9,9,2
"08018091",Escola Pep Ventura,L'Hospitalet de Llobregat,BCO,BCO,4231217,01/04/2022,2,4,6,11,7,0,0,18,11,7,18,8,6
"08018145",Escola Pau Vila,L'Hospitalet de Llobregat,BCO,BCO,4216665,24/03/2022,2,0,2,9,0,0,0,9,4,0,4,9,2
"08018157",Escola Santiago Ramon y Cajal,L'Hospitalet de Llobregat,BCO,BCO,4215547,24/03/2022,4,0,4,19,0,0,0,19,19,0,19,19,5
"08019149",Escola Bernat Metge,L'Hospitalet de Llobregat,BCO,BCO,4227243,30/03/2022,1,0,1,10,0,0,0,10,10,0,10,2,3
"08019198",Escola Pompeu Fabra,L'Hospitalet de Llobregat,BCO,BCO,4216627,24/03/2022,1,7,8,16,2,0,0,18,0,0,0,17,5
"08019216",Escola Busquets i Punset,L'Hospitalet de Llobregat,BCO,BCO,4228996,31/03/2022,1,1,2,18,1,0,0,19,6,0,6,22,4
"08019231",Escola Milagros Consarnau,L'Hospitalet de Llobregat,BCO,BCO,4229189,31/03/2022,1,2,3,17,1,0,0,18,17,1,18,18,4
"08019241",Escola Frederic Mistral,L'Hospitalet de Llobregat,BCO,BCO,4227558,30/03/2022,0,1,1,18,0,0,0,18,18,0,18,18,4
"08019265",Escola Joaquim Ruyra,L'Hospitalet de Llobregat,BCO,BCO,4218167,25/03/2022,5,4,9,12,4,0,0,16,8,4,12,12,3
"08019277",Escola La Marina,L'Hospitalet de Llobregat,BCO,BCO,4230221,31/03/2022,0,12,12,12,1,1,1,15,5,1,6,11,2
"08019290",Escola Provençana,L'Hospitalet de Llobregat,BCO,BCO,4216634,24/03/2022,0,0,0,9,0,0,0,9,3,0,3,9,2
"08019307",Institut Santa Eulàlia,L'Hospitalet de Llobregat,BCO,BCO,4213549,23/03/2022,1,0,1,16,2,0,0,18,0,0,0,18,0
"08019319",Institut Pedraforca,L'Hospitalet de Llobregat,BCO,BCO,4231252,01/04/2022,0,0,0,0,28,0,0,28,0,29,29,29,5
"08019320",Institut Torras i Bages,L'Hospitalet de Llobregat,BCO,BCO,4231460,01/04/2022,0,0,0,18,1,0,0,19,0,0,0,19,3
"08019371",Institut Llobregat,L'Hospitalet de Llobregat,BCO,BCO,4226412,29/03/2022,0,0,0,6,1,0,0,7,6,1,7,6,0
"08019401",Institut Provençana,L'Hospitalet de Llobregat,BCO,BCO,4218438,25/03/2022,0,0,0,20,0,1,1,22,0,0,0,0,2
"08019411",Institut Bellvitge,L'Hospitalet de Llobregat,BCO,BCO,4228120,30/03/2022,0,3,3,13,1,0,0,14,0,0,0,12,0
"08019435",Escola García i Fossas,Igualada,CCE,PEN,4229319,31/03/2022,0,1,1,11,8,0,0,19,11,8,19,6,2
"08019459",Escola Gabriel Castella i Raich,Igualada,CCE,PEN,4217903,25/03/2022,0,0,0,6,3,0,0,9,6,3,9,10,2
"08019460",Escola Emili Vallès,Igualada,CCE,PEN,4215688,24/03/2022,0,1,1,0,0,8,2,10,8,2,10,2,2
"08019630",Institut Pere Vives i Vich,Igualada,CCE,PEN,4231289,01/04/2022,0,0,0,16,0,0,0,16,0,0,0,12,0
"08019642",Escola Pare Ramon Castelltort i Miralda,Igualada,CCE,PEN,4218799,25/03/2022,0,0,0,14,1,2,1,18,8,1,9,16,3
"08019654",Institut Milà i Fontanals,Igualada,CCE,PEN,4231986,01/04/2022,0,5,5,35,0,0,0,35,0,0,0,35,8
"08019678",Escola Guerau de Jorba,Jorba,CCE,PEN,4230887,01/04/2022,1,0,1,0,0,4,0,4,2,0,2,0,2
"08019691",Escola Vilademàger - ZER Serra d'Ancosa,La Llacuna,CCE,PEN,4215755,24/03/2022,1,0,1,1,1,0,0,2,1,0,1,0,2
"08019711",Escola Sagrada Família,La Llagosta,MVO,MVO,4222019,28/03/2022,1,14,15,7,2,0,0,9,0,0,0,7,2
"08019745",Escola Joan Maragall,La Llagosta,MVO,MVO,4230970,01/04/2022,1,0,1,0,18,0,0,18,0,9,9,2,4
"08019782",Escola Salvador Sanromà,Llinars del Vallès,MVO,MVO,4233350,04/04/2022,0,0,0,18,0,0,0,18,0,0,0,18,1
"08019824",Escola Les Llisses,Lliçà de Vall,MVO,MVO,4225858,29/03/2022,1,0,1,15,0,0,0,15,0,0,0,0,4
"08019861",Escola Gafarró - ZER Alt Lluçanès,Santa Eulàlia de Puig-oriol (Lluçà),CCE,CCE,4227936,30/03/2022,1,0,1,2,0,0,0,2,2,0,2,3,0
"08019873",Escola Mare de Déu de Montserrat,Malgrat de Mar,MVO,MVO,4215485,24/03/2022,1,0,1,0,8,0,0,8,0,8,8,0,2
"08019927",Escola Marià Cubí i Soler,Malgrat de Mar,MVO,MVO,4215061,23/03/2022,1,1,2,25,1,5,0,31,15,1,16,12,4
"08019940",Escola Puig-Agut,Manlleu,CCE,CCE,4222638,28/03/2022,0,0,0,16,0,0,0,16,0,0,0,16,4
"08020012",Escola Muntanya del Drac,Manresa,CCE,CCE,4225862,29/03/2022,2,2,4,6,0,1,0,7,7,0,7,6,2
"08020061",Escola La Renaixença,Manresa,CCE,CCE,4213250,23/03/2022,0,0,0,9,0,6,0,15,4,0,4,7,2
"08020073",Escola Sant Ignasi,Manresa,CCE,CCE,4226875,30/03/2022,0,0,0,18,1,0,0,19,14,0,14,13,4
"08020097",Escola Pare Algué,Manresa,CCE,CCE,4217712,25/03/2022,0,5,5,4,0,0,0,4,4,0,4,4,2
"08020127",Escola Bages,Manresa,CCE,CCE,4231813,01/04/2022,1,0,1,2,16,0,0,18,2,16,18,2,5
"08020462",Institut Lacetània,Manresa,CCE,CCE,4224030,28/03/2022,1,0,1,45,0,0,0,45,0,0,0,45,1
"08020474",Institut Lluís de Peguera,Manresa,CCE,CCE,4221952,28/03/2022,1,0,1,0,0,35,0,35,35,0,35,35,0
"08020498",Escola Els Convents,Martorell,BLL,BLL,4224458,29/03/2022,3,0,3,0,0,0,9,9,0,0,0,0,2
"08020516",CEE El Pontarró,Martorell,BLL,BLL,4211878,22/03/2022,10,1,11,0,10,0,0,10,0,10,10,10,3
"08020607",Escola Juan Ramón Jiménez,Martorell,BLL,BLL,4218792,25/03/2022,0,0,0,17,0,0,0,17,17,0,17,17,4
"08020619",Escola José Echegaray,Martorell,BLL,BLL,4227976,30/03/2022,2,0,2,16,0,0,0,16,16,0,16,16,4
"08020620",Institut Pompeu Fabra,Martorell,BLL,BLL,4229902,31/03/2022,0,0,0,29,2,0,0,31,29,2,31,29,10
"08020656",Escola Simeó Rabasa,Martorelles,MVO,MVO,4216552,24/03/2022,0,0,0,13,2,0,0,15,5,1,6,12,2
"08020701",Escola Comtes de Lacambra,Vinyoles d'Orís (Les Masies de Voltregà),CCE,CCE,4211904,22/03/2022,2,0,2,0,7,0,0,7,0,7,7,0,2
"08020723",Escola Ocata,El Masnou,MVO,MVO,4223534,28/03/2022,0,0,0,5,4,0,0,9,5,4,9,7,4
"08020826",Institut Maremar,El Masnou,MVO,MVO,4213247,23/03/2022,0,0,0,4,1,0,1,6,4,2,6,1,0
"08020838",Institut Mediterrània,El Masnou,MVO,MVO,4231596,01/04/2022,0,0,0,19,0,0,0,19,19,0,19,19,19
"08020841",Escola El Turó,Masquefa,CCE,PEN,4221898,28/03/2022,2,0,2,0,17,0,0,17,0,10,10,0,5
"08020863",Escola Ginesta,Matadepera,VOC,VOC,4221482,28/03/2022,2,2,4,19,0,0,0,19,0,0,0,18,5
"08020905",Escola Angeleta Ferrer,Mataró,MVO,MVO,4228091,30/03/2022,6,3,9,0,5,0,4,9,0,9,9,12,2
"08020917",Escola Josep Manuel Peramàs,Mataró,MVO,MVO,4223294,28/03/2022,1,0,1,18,0,0,0,18,18,0,18,18,4
"08020929",Escola Germanes Bertomeu,Mataró,MVO,MVO,4230514,31/03/2022,1,0,1,15,0,3,0,18,6,0,6,12,4
"08021041",Escola Josep Montserrat,Mataró,MVO,MVO,4216573,24/03/2022,1,0,1,2,0,7,1,10,3,1,4,9,2
"08021260",Institut Alexandre Satorras,Mataró,MVO,MVO,4230806,01/04/2022,0,0,0,39,0,0,0,39,39,0,39,39,0
"08021302",Institut Damià Campeny,Mataró,MVO,MVO,4223029,28/03/2022,0,0,0,20,0,0,0,20,0,0,0,20,0
"08021326",Escola La Fassina,Mediona,BCO,PEN,4213987,23/03/2022,0,0,0,1,0,4,0,5,2,0,2,2,1
"08021351",Escola El Palau,Molins de Rei,BLL,BLL,4218253,25/03/2022,1,0,1,9,0,0,0,9,5,0,5,9,2
"08021363",Escola L'Alzina,Molins de Rei,BLL,BLL,4230090,31/03/2022,0,0,0,7,0,0,2,9,7,2,9,8,4
"08021430",Institut Lluís de Requesens,Molins de Rei,BLL,BLL,4228953,31/03/2022,0,10,10,0,1,0,15,16,0,0,0,15,0
"08021442",Escola Castell Ciuró,Molins de Rei,BLL,BLL,4231842,01/04/2022,3,0,3,16,0,0,0,16,0,0,0,16,4
"08021466",Escola Col·legis Nous,Mollet del Vallès,MVO,MVO,4229381,31/03/2022,0,0,0,9,3,0,0,12,9,3,12,12,2
"08021570",Escola del Bosc,Mollet del Vallès,MVO,MVO,4227873,30/03/2022,1,2,3,9,0,0,0,9,2,0,2,9,2
"08021582",Escola Joan Salvat Papasseit,Mollet del Vallès,MVO,MVO,4211991,22/03/2022,1,1,2,18,2,0,0,20,18,2,20,12,2
"08021594",Institut de Mollet del Vallès,Mollet del Vallès,MVO,MVO,4222478,28/03/2022,0,0,0,20,0,0,2,22,20,2,22,0,22
"08021600",Institut Vicenç Plantada,Mollet del Vallès,MVO,MVO,4212493,22/03/2022,0,0,0,26,0,0,0,26,26,0,26,0,26
"08021685",Escola Font Freda,Montcada i Reixac,VOC,VOC,4231683,01/04/2022,2,1,3,14,0,0,0,14,14,0,14,12,3
"08021764",Escola Mitja Costa,Montcada i Reixac,VOC,VOC,4219526,26/03/2022,0,0,0,9,0,0,0,9,9,0,9,9,2
"08021788",Institut Montserrat Miró i Vila,Montcada i Reixac,VOC,VOC,4229654,31/03/2022,0,0,0,16,2,0,0,18,16,2,18,0,0
"08021880",Escola Salvador Espriu,Montgat,MVO,MVO,4230194,31/03/2022,5,0,5,0,0,11,1,12,11,1,12,12,6
"08021892",Escola Sant Pere,Monistrol de Montserrat,CCE,CCE,4227506,30/03/2022,0,0,0,9,0,0,1,10,3,0,3,9,2
"08021934",Escola L'Esqueix - ZER El Moianès Ponent,Monistrol de Calders,CCE,CCE,4215856,24/03/2022,1,0,1,1,0,0,1,2,1,1,2,0,1
"08021961",Escola El Rocal,Montesquiu,CCE,CCE,4225071,29/03/2022,1,3,4,0,4,0,1,5,4,1,5,0,2
"08021983",Escola Gira-sol - ZER Baix Berguedà,Montmajor,CCE,CCE,4216280,24/03/2022,1,0,1,2,0,0,0,2,2,0,2,0,1
"08022008",Escola Montmany,Figaró-Montmany,MVO,MVO,4233231,04/04/2022,2,0,2,0,2,0,0,2,0,2,2,2,1
"08022011",Escola Pau Casals,Montmeló,MVO,MVO,4228918,31/03/2022,1,0,1,15,0,0,0,15,5,0,5,15,4
"08022045",Escola Sant Jordi,Montmeló,MVO,MVO,4212752,23/03/2022,0,0,0,18,0,0,0,18,0,0,0,18,4
"08022057",Escola Sant Sadurní,Montornès del Vallès,MVO,MVO,4211886,22/03/2022,0,5,5,1,1,4,0,6,5,1,6,5,2
"08022070",Escola Marinada,Montornès del Vallès,MVO,MVO,4229398,31/03/2022,1,0,1,23,2,0,0,25,23,2,25,20,3
"08022082",Escola Puig Drau - ZER Baix Montseny,Montseny,MVO,MVO,4223288,28/03/2022,0,0,0,0,0,0,0,0,0,0,0,0,1
"08022094",Escola Josep Orriols i Roca,Moià,CCE,CCE,4230012,31/03/2022,0,0,0,18,0,0,0,18,18,0,18,18,4
"08022197",Escola Catalunya,Navarcles,CCE,CCE,4216255,24/03/2022,5,17,22,0,0,2,0,2,0,0,0,0,0
"08022331",Escola d'Olvan - ZER Baix Berguedà,Olvan,CCE,CCE,4216323,24/03/2022,1,0,1,2,0,0,2,4,2,2,4,0,1
"08022343",Escola Circell,Moja (Olèrdola),BCO,PEN,4215379,24/03/2022,1,2,3,0,0,10,0,10,0,0,0,10,3
"08022367",Escola Rossend Montané,Sant Pere Molanta (Olèrdola),BCO,PEN,4214434,23/03/2022,1,0,1,9,0,0,0,9,9,0,9,0,2
"08022379",Escola Pont de l'Arcada,Olesa de Bonesvalls,BCO,PEN,4221432,28/03/2022,1,0,1,3,4,0,0,7,0,4,4,2,2
"08022380",Escola Mare de Déu de Montserrat,Olesa de Montserrat,BLL,BLL,4225881,29/03/2022,1,0,1,12,0,0,1,13,12,1,13,14,5
"08022461",Escola Sant Bernat,Olesa de Montserrat,BLL,BLL,4221305,28/03/2022,0,0,0,22,0,0,4,26,22,4,26,20,4
"08022495",Escola Terra Nostra,Olost,CCE,CCE,4223246,28/03/2022,1,1,2,5,0,0,2,7,5,2,7,5,1
"08022549",Escola Llevant - ZER Gavarresa,Oristà,CCE,CCE,4231727,01/04/2022,0,0,0,1,0,0,1,2,1,1,2,2,1
"08022574",Escola Òrrius,Òrrius,MVO,MVO,4212777,23/03/2022,2,1,3,2,0,2,0,4,3,0,3,1,3
"08022586",Escola El Drac,Pacs del Penedès,BCO,PEN,4230346,31/03/2022,1,0,1,0,0,6,0,6,6,0,6,0,2
"08022598",Escola Les Ferreries de Palafolls,Palafolls,MVO,MVO,4216784,24/03/2022,0,0,0,0,19,0,0,19,0,19,19,0,4
"08022616",Escola Josep Maria Folch i Torres,Palau-solità i Plegamans,VOC,VOC,4224977,29/03/2022,0,5,5,5,2,0,0,7,0,0,0,7,3
"08022665",Escola Àngel Guimerà,Pallejà,BLL,BLL,4237312,05/04/2022,0,0,0,4,5,0,0,9,4,5,9,7,2
"08022677",Escola Jacint Verdaguer,Pallejà,BLL,BLL,4212100,22/03/2022,1,0,1,9,0,0,0,9,9,0,9,9,1
"08022689",Escola Pau Vila,El Papiol,BLL,BLL,4218344,25/03/2022,1,1,2,0,0,16,5,21,11,0,11,11,4
"08022690",Escola Lluís Piquer,Parets del Vallès,MVO,MVO,4225747,29/03/2022,1,3,4,18,0,0,0,18,2,0,2,4,4
"08022707",Escola Pompeu Fabra,Parets del Vallès,MVO,MVO,4227429,30/03/2022,1,0,1,7,3,0,0,10,7,3,10,10,3
"08022768",Escola Herois del Bruc,Piera,CCE,PEN,4223274,28/03/2022,0,0,0,14,6,0,0,20,14,6,20,14,6
"08022801",Escola Antoni Doltra,Pineda de Mar,MVO,MVO,4212256,22/03/2022,1,3,4,0,0,4,0,4,1,0,1,14,2
"08022835",Escola Jaume I,Pineda de Mar,MVO,MVO,4223306,28/03/2022,1,0,1,13,0,0,1,14,13,1,14,13,4
"08022847",Escola Sants Abdó i Senén,El Pla del Penedès,BCO,PEN,4228027,30/03/2022,0,1,1,6,3,0,0,9,6,3,9,9,2
"08022859",Escola Maria Borés,La Pobla de Claramunt,CCE,PEN,4216099,24/03/2022,1,0,1,0,0,1,0,1,0,0,0,12,3
"08022860",Escola Lillet a Güell,La Pobla de Lillet,CCE,CCE,4218464,25/03/2022,1,0,1,4,0,0,0,4,4,0,4,0,1
"08022884",Escola Joan Maragall,El Prat de Llobregat,BLL,BLL,4221547,28/03/2022,1,1,2,10,0,0,4,14,10,4,14,10,3
"08022902",Escola del Parc,El Prat de Llobregat,BLL,BLL,4215123,23/03/2022,0,0,0,18,0,0,0,18,6,0,6,16,4
"08022914",Escola Jaume Balmes,El Prat de Llobregat,BLL,BLL,4225131,29/03/2022,3,1,4,21,3,0,0,24,21,3,24,20,4
"08022926",CEE Can Rigol,El Prat de Llobregat,BLL,BLL,4230040,31/03/2022,4,1,5,0,0,18,1,19,18,1,19,16,2
"08022938",Escola Jacint Verdaguer,El Prat de Llobregat,BLL,BLL,4225901,29/03/2022,5,0,5,11,0,0,0,11,11,0,11,11,2
"08023131",Institut Baldiri Guilera,El Prat de Llobregat,BLL,BLL,4228901,31/03/2022,16,0,16,6,0,0,0,6,0,0,0,0,8
"08023141",Escola Mare de Déu del Portal - ZER Vent d'Avall,Els Prats de Rei,CCE,CCE,4230810,01/04/2022,1,3,4,0,0,2,0,2,0,0,0,2,1
"08023207",Escola Lluçanès,Prats de Lluçanès,CCE,CCE,4216324,24/03/2022,0,0,0,9,0,0,0,9,5,0,5,9,2
"08023232",Escola Sant Cristòfol,Premià de Mar,MVO,MVO,4212080,22/03/2022,0,0,0,12,3,0,0,15,0,0,0,15,2
"08023335",Escola Montserrat,Premià de Mar,MVO,MVO,4227605,30/03/2022,3,7,10,5,0,4,1,10,0,1,1,2,3
"08023359",Escola Virolai - ZER Cep de Sis,Puigdàlber,BCO,PEN,4213780,23/03/2022,1,1,2,0,0,3,0,3,1,0,1,3,1
"08023372",Escola Alfred Mata,Puig-reig,CCE,CCE,4213836,23/03/2022,1,1,2,0,4,0,0,4,0,4,4,4,2
"08023426",Escola Gassó i Vidal,Ripollet,VOC,VOC,4223278,28/03/2022,1,0,1,8,1,0,0,9,8,0,8,5,2
"08023542",Escola Tiana de la Riba,Ripollet,VOC,VOC,4221507,28/03/2022,1,0,1,10,0,0,0,10,3,0,3,10,3
"08023554",Escola Josep Maria Ginesta,Ripollet,VOC,VOC,4212012,22/03/2022,1,0,1,18,0,0,0,18,18,0,18,18,2
"08023566",Escola Anselm Clavé,Ripollet,VOC,VOC,4223232,28/03/2022,1,0,1,16,0,0,0,16,4,0,4,10,3
"08023591",Escola Pilar Mestres-Jaume Torrens,La Roca del Vallès,MVO,MVO,4224733,29/03/2022,0,0,0,6,3,0,0,9,0,2,2,4,2
"08023669",Escola Mare de Déu del Sòl del Pont,Roda de Ter,CCE,CCE,4228794,31/03/2022,7,2,9,9,0,0,0,9,9,0,9,8,4
"08023852",Escola Joan Maragall,Rubí,VOC,VOC,4228095,30/03/2022,0,0,0,19,0,1,1,21,20,1,21,21,2
"08023918",Escola Concòrdia,Sabadell,VOC,VOC,4225371,29/03/2022,0,0,0,18,0,0,0,18,18,0,18,18,6
"08023921",Escola Espronceda,Sabadell,VOC,VOC,4230150,31/03/2022,1,0,1,19,0,0,0,19,19,0,19,19,5
"08023931",Escola Enric Casassas,Sabadell,VOC,VOC,4222751,28/03/2022,2,0,2,7,0,0,0,7,7,0,7,7,2
"08023943",Escola Gaudí,Sabadell,VOC,VOC,4213311,23/03/2022,1,0,1,9,0,0,0,9,9,0,9,9,3
"08023955",Escola Cifuentes,Sabadell,VOC,VOC,4215738,24/03/2022,1,0,1,26,1,0,0,27,13,1,14,0,2
"08023979",Escola Joan Montllor,Sabadell,VOC,VOC,4229945,31/03/2022,1,4,5,6,0,0,0,6,6,0,6,4,1
"08023980",Escola Juan Ramón Jiménez,Sabadell,VOC,VOC,4223198,28/03/2022,0,0,0,2,5,0,0,7,0,0,0,0,2
"08024005",Escola Joan Maragall,Sabadell,VOC,VOC,4223355,28/03/2022,0,0,0,5,1,0,0,6,5,1,6,4,4
"08024017",Escola Miquel Carreras,Sabadell,VOC,VOC,4215878,24/03/2022,0,0,0,9,0,0,0,9,9,0,9,9,4
"08024030",Escola Samuntada,Sabadell,VOC,VOC,4216358,24/03/2022,3,5,8,0,0,6,0,6,0,0,0,3,2
"08024042",Escola La Romànica,Sabadell,VOC,VOC,4225355,29/03/2022,1,0,1,17,0,0,0,17,6,0,6,18,4
"08024066",Escola Tarlatana,Sabadell,VOC,VOC,4214132,23/03/2022,1,0,1,1,0,8,1,10,9,1,10,5,2
"08024741",Institut Escola Industrial,Sabadell,VOC,VOC,4231658,01/04/2022,0,0,0,40,2,0,0,42,0,38,38,0,0
"08024765",Institut Arraona,Sabadell,VOC,VOC,4230881,01/04/2022,35,0,35,0,10,0,0,10,0,0,0,9,0
"08024777",Institut Egara,Terrassa,VOC,VOC,4222603,28/03/2022,6,0,6,18,0,0,0,18,18,1,19,15,0
"08024789",CEE Francesc Bellapart,Sabadell,VOC,VOC,4227293,30/03/2022,5,0,5,18,10,5,0,33,15,2,17,15,3
"08024790",Escola Roureda,Sabadell,VOC,VOC,4213097,23/03/2022,0,0,0,17,1,0,0,18,17,0,17,0,6
"08024807",Escola Agnès Armengol,Sabadell,VOC,VOC,4229475,31/03/2022,1,3,4,0,0,10,0,10,5,0,5,10,6
"08024819",Escola Calvet d'Estrella,Sabadell,VOC,VOC,4223651,28/03/2022,1,0,1,9,0,0,0,9,9,0,9,9,2
"08024820",Escola Pau Casals,Sabadell,VOC,VOC,4215480,24/03/2022,1,0,1,17,0,0,0,17,9,0,9,17,4
"08024832",Escola Floresta,Sabadell,VOC,VOC,4238666,06/04/2022,1,4,5,9,0,0,0,9,5,0,5,6,1
"08024844",Escola Torreguitart,Sabadell,VOC,VOC,4234106,04/04/2022,1,0,1,8,1,0,0,9,8,1,9,9,1
"08024856",Escola Font Rosella,Sabadell,VOC,VOC,4225230,29/03/2022,2,0,2,0,21,0,2,23,0,23,23,0,4
"08024871",Institut Pau Vila,Sabadell,VOC,VOC,4222520,28/03/2022,1,2,3,28,0,0,0,28,28,0,28,0,10
"08024881",Institut Ferran Casablancas,Sabadell,VOC,VOC,4216292,24/03/2022,0,0,0,0,34,0,0,34,0,34,34,15,34
"08024893",Institut Castellarnau,Sabadell,VOC,VOC,4229969,31/03/2022,0,0,0,16,4,1,2,23,17,6,23,2,2
"08024972",Escola Torres Amat,Sallent,CCE,CCE,4216570,24/03/2022,0,0,0,18,0,0,0,18,18,0,18,0,2
"08025058",Escola Riu d'Or,Santpedor,CCE,CCE,4229050,31/03/2022,1,7,8,8,2,0,0,10,8,2,10,8,2
"08025071",Escola Dones d'Aigua,Sant Iscle de Vallalta,MVO,MVO,4213208,23/03/2022,1,0,1,0,0,0,1,1,0,1,1,9,2
"08025083",Escola Pompeu Fabra,Sant Adrià de Besòs,BCO,BCO,4226836,30/03/2022,1,0,1,20,0,0,0,20,0,0,0,2,3
"08025241",Escola Joan Maragall,Sant Andreu de la Barca,BLL,BLL,4225698,29/03/2022,1,1,2,7,2,0,0,9,5,2,7,7,2
"08025265",Escola Àngel Guimerà,Sant Andreu de la Barca,BLL,BLL,4212014,22/03/2022,0,0,0,4,0,0,0,4,4,0,4,0,0
"08025319",Escola Joan Casas,Sant Antoni de Vilamajor,MVO,MVO,4215137,23/03/2022,0,0,0,4,0,0,0,4,4,0,4,4,4
"08025320",Escola La Monjoia,Sant Bartomeu del Grau,CCE,CCE,4216656,24/03/2022,1,1,2,4,0,0,1,5,4,1,5,4,1
"08025344",Escola Amat Verdú,Sant Boi de Llobregat,BLL,BLL,4231042,01/04/2022,1,0,1,0,11,0,0,11,0,11,11,0,3
"08025526",Escola Ciutat Cooperativa,Sant Boi de Llobregat,BLL,BLL,4211858,22/03/2022,0,0,0,9,0,0,0,9,5,0,5,9,2
"08025587",Escola Casablanca,Sant Boi de Llobregat,BLL,BLL,4212107,22/03/2022,4,0,4,18,0,0,0,18,8,0,8,16,5
"08025599",Escola Marianao,Sant Boi de Llobregat,BLL,BLL,4218279,25/03/2022,3,0,3,4,0,0,7,11,4,7,11,10,1
"08025605",Institut Camps Blancs,Sant Boi de Llobregat,BLL,BLL,4234775,04/04/2022,0,0,0,0,45,0,0,45,0,45,45,0,0
"08025642",Escola Josep Maria Ciurana,Sant Boi de Llobregat,BLL,BLL,4218781,25/03/2022,1,0,1,5,11,0,0,16,5,11,16,5,5
"08025654",Institut Joaquim Rubió i Ors,Sant Boi de Llobregat,BLL,BLL,4222472,28/03/2022,3,0,3,24,0,0,0,24,0,0,0,24,0
"08025666",Escola Aurora - ZER Alt Lluçanès,Sant Boi de Lluçanès,CCE,CCE,4231227,01/04/2022,1,0,1,0,0,0,1,1,0,0,0,0,0
"08025812",Escola Sant Climent,Sant Climent de Llobregat,BLL,BLL,4225190,29/03/2022,0,0,0,18,0,0,0,18,10,0,10,18,4
"08025824",Escola La Floresta,La Floresta (Sant Cugat del Vallès),VOC,VOC,4223365,28/03/2022,0,0,0,8,0,0,1,9,8,1,9,9,2
"08025927",Escola Pi d'en Xandri,Sant Cugat del Vallès,VOC,VOC,4227305,30/03/2022,5,15,20,19,0,0,0,19,19,0,19,11,4
"08026026",Escola Pins del Vallès,Sant Cugat del Vallès,VOC,VOC,4215994,24/03/2022,1,1,2,18,1,0,0,19,18,1,19,15,3
"08026087",Escola Jaume Ferran i Clua,Valldoreix (Sant Cugat del Vallès),VOC,VOC,4221455,28/03/2022,1,0,1,16,0,0,1,17,16,1,17,16,4
"08026099",Escola Les Vinyes,Sant Cugat Sesgarrigues,BCO,PEN,4223342,28/03/2022,1,2,3,0,0,3,1,4,3,1,4,2,1
"08026117",Escola Vallmanya,Sant Esteve de Palautordera,MVO,MVO,4214131,23/03/2022,0,0,0,16,0,0,0,16,8,0,8,16,4
"08026130",Escola La Roureda,Sant Esteve Sesrovires,BLL,BLL,4225799,29/03/2022,0,0,0,14,0,0,1,15,14,1,15,15,2
"08026154",Escola Joaquim Abril,Sant Fost de Campsentelles,MVO,MVO,4231413,01/04/2022,1,0,1,11,1,0,0,12,4,0,4,16,4
"08026208",Escola Jaume Balmes,Sant Feliu de Codines,MVO,MVO,4231828,01/04/2022,2,0,2,15,2,0,0,17,6,2,8,7,4
"08026211",Escola Nadal,Sant Feliu de Llobregat,BLL,BLL,4231012,01/04/2022,1,1,2,17,0,0,0,17,8,0,8,17,3
"08026221",Escola Falguera,Sant Feliu de Llobregat,BLL,BLL,4213158,23/03/2022,1,0,1,9,0,0,0,9,5,0,5,0,1
"08026373",Escola Josep Monmany Amat,Sant Feliu de Llobregat,BLL,BLL,4213719,23/03/2022,1,0,1,12,1,0,0,13,12,1,13,9,4
"08026385",Escola Arquitecte Gaudí,Sant Feliu de Llobregat,BLL,BLL,4231496,01/04/2022,2,0,2,6,0,0,1,7,3,0,3,8,2
"08026397",Institut Olorda,Sant Feliu de Llobregat,BLL,BLL,4229009,31/03/2022,0,0,0,25,0,0,0,25,0,0,0,25,13
"08026415",Escola Els Roures - ZER Gavarresa,Sant Feliu Sasserra,CCE,CCE,4230885,01/04/2022,0,0,0,0,0,0,0,0,0,0,0,0,1
"08026464",Escola Monsenyor Gibert,Sant Fruitós de Bages,CCE,CCE,4211875,22/03/2022,0,0,0,18,0,0,0,18,6,0,6,18,4
"08026476",Escola Francesc Macià,Vilassar de Dalt,MVO,MVO,4229950,31/03/2022,1,0,1,17,0,0,0,17,0,0,0,10,2
"08026567",Escola Sant Francesc d'Assís,Sant Joan Despí,BLL,BLL,4213980,23/03/2022,0,0,0,22,2,2,0,26,24,2,26,24,2
"08026661",Escola Pau Casals,Sant Joan Despí,BLL,BLL,4223446,28/03/2022,1,0,1,17,0,0,0,17,8,0,8,18,4
"08026671",Escola Joan Perich i Valls,Sant Joan Despí,BLL,BLL,4227955,30/03/2022,1,0,1,14,1,0,0,15,14,1,15,13,2
"08026683",Institut Francesc Ferrer i Guàrdia,Sant Joan Despí,BLL,BLL,4229251,31/03/2022,0,0,0,27,3,0,0,30,27,3,30,0,8
"08026725",Escola Joncadella,Sant Joan de Vilatorrada,CCE,CCE,4231158,01/04/2022,0,9,9,10,0,0,0,10,10,0,10,8,4
"08026749",Escola Pérez Sala,Vilassar de Mar,MVO,MVO,4215934,24/03/2022,1,4,5,15,0,0,0,15,15,0,15,15,4
"08026786",Escola Bellpuig,Sant Julià de Vilatorta,CCE,CCE,4237247,05/04/2022,1,0,1,9,0,0,0,9,9,0,9,9,2
"08026816",Escola Montserrat,Sant Just Desvern,BLL,BLL,4229092,31/03/2022,1,0,1,18,0,0,0,18,18,0,18,4,4
"08026889",Escola Vinyes Verdes,La Beguda Alta (Masquefa),CCE,PEN,4223000,28/03/2022,1,3,4,6,0,0,0,6,0,0,0,6,2
"08026907",Escola Pau Casals,Sant Llorenç d'Hortons,BCO,PEN,4218742,25/03/2022,1,0,1,0,1,8,0,9,5,0,5,7,1
"08026919",Escola Josep Gras,Sant Llorenç Savall,VOC,VOC,4212010,22/03/2022,0,0,0,8,1,0,0,9,8,1,9,8,2
"08026956",Escola Cérvola Blanca,Sant Martí de Tous,CCE,PEN,4223376,28/03/2022,0,0,0,0,1,7,0,8,7,0,7,0,6
"08027018",Escola Jaume Balmes,Sant Martí Sarroca,BCO,PEN,4231024,01/04/2022,1,0,1,14,0,0,0,14,14,0,14,14,5
"08027021",Escola Font de l'Anoia - ZER Vent d'Avall,Sant Martí Sesgueioles,CCE,CCE,4217287,24/03/2022,3,0,3,2,0,0,0,2,2,0,2,1,1
"08027110",Escola El Pi,Sant Pere de Ribes,BCO,PEN,4227466,30/03/2022,0,2,2,0,0,9,0,9,9,0,9,7,2
"08027134",Escola Les Roquetes,Les Roquetes (Sant Pere de Ribes),BCO,PEN,4223094,28/03/2022,3,5,8,21,2,0,0,23,21,2,23,3,3
"08027146",Escola Sant Jeroni,Sant Pere de Riudebitlles,BCO,PEN,4218819,25/03/2022,0,0,0,0,10,0,0,10,0,4,4,0,2
"08027183",Escola Torre Roja,Sant Pere de Vilamajor,MVO,MVO,4231276,01/04/2022,0,0,0,7,8,1,0,16,3,6,9,8,2
"08027225",Escola Sant Pau,Sant Pol de Mar,MVO,MVO,4228121,30/03/2022,0,0,0,20,0,0,0,20,6,0,6,20,4
"08027249",Escola Segimon Comas,Sant Quirze de Besora,CCE,CCE,4229847,31/03/2022,1,0,1,0,10,0,0,10,0,10,10,9,3
"08027432",Escola Wagner,Santa Coloma de Gramenet,BCO,BCO,4217988,25/03/2022,1,0,1,0,4,0,4,8,0,8,8,0,1
"08027456",Escola Ferran de Sagarra,Santa Coloma de Gramenet,BCO,BCO,4213657,23/03/2022,1,7,8,19,0,0,0,19,19,0,19,19,4
"08027471",Escola Sant Just,Santa Coloma de Gramenet,BCO,BCO,4223478,28/03/2022,1,0,1,17,0,0,0,17,0,0,0,17,2
"08027511",Escola Torre Balldovina,Santa Coloma de Gramenet,BCO,BCO,4222237,28/03/2022,1,0,1,18,0,0,0,18,6,0,6,18,2
"08027870",Escola Les Palmeres,Santa Coloma de Gramenet,BCO,BCO,4228221,30/03/2022,14,1,15,14,0,0,0,14,14,0,14,7,4
"08027973",Escola Beethoven,Santa Coloma de Gramenet,BCO,BCO,4229561,31/03/2022,0,0,0,9,0,0,0,9,9,0,9,9,2
"08027985",Escola Jaume Salvatella,Santa Coloma de Gramenet,BCO,BCO,4227424,30/03/2022,0,0,0,18,0,0,0,18,18,0,18,18,4
"08028035",Escola Ausiàs March,Santa Coloma de Gramenet,BCO,BCO,4229634,31/03/2022,1,0,1,4,0,0,0,4,0,0,0,2,0
"08028047",Institut Puig Castellar,Santa Coloma de Gramenet,BCO,BCO,4231855,01/04/2022,0,0,0,29,0,0,0,29,29,0,29,29,22
"08028059",Escola Jacint Verdaguer,Santa Eugènia de Berga,CCE,CCE,4218821,25/03/2022,1,0,1,9,0,2,0,11,11,0,11,11,2
"08028072",Escola El Roure Gros,Santa Eulàlia de Riuprimer,CCE,CCE,4231364,01/04/2022,1,0,1,0,0,0,0,0,0,0,0,0,1
"08028102",Escola Ronçana,El Rieral (Santa Eulàlia de Ronçana),MVO,MVO,4227033,30/03/2022,1,0,1,5,2,0,0,7,1,2,3,5,3
"08028151",Escola Les Moreres - ZER Cep de Sis,Santa Fe del Penedès,BCO,PEN,4229727,31/03/2022,1,1,2,0,0,1,1,2,1,1,2,2,1
"08028163",Escola Montbou,Santa Margarida de Montbui,CCE,PEN,4229571,31/03/2022,1,0,1,7,1,0,0,8,7,1,8,4,1
"08028217",Escola Doctor Samaranch i Fina,Els Monjos (Santa Margarida i els Monjos),BCO,PEN,4225727,29/03/2022,1,0,1,18,0,0,0,18,18,0,18,18,4
"08028229",Escola Elisa Badia,Barberà del Vallès,VOC,VOC,4222375,28/03/2022,4,0,4,13,1,0,0,14,5,1,6,14,4
"08028333",Escola El Cabrerès,L'Esquirol,CCE,CCE,4227467,30/03/2022,0,0,0,9,0,0,0,9,9,0,9,9,2
"08028345",Escola Les Mimoses,Santa Maria de Martorelles,MVO,MVO,4231484,01/04/2022,0,1,1,5,0,2,0,7,3,0,3,7,1
"08028382",Escola Sesmon d'Oló,Santa Maria d'Oló,CCE,CCE,4213248,23/03/2022,1,0,1,0,0,1,0,1,1,0,1,0,1
"08028424",Escola Fontmartina,Santa Maria de Palautordera,MVO,MVO,4213386,23/03/2022,1,0,1,14,1,0,0,15,14,1,15,14,3
"08028436",Escola La Florida,Santa Perpètua de Mogoda,VOC,VOC,4213180,23/03/2022,0,0,0,18,0,0,0,18,12,0,12,18,2
"08028497",Escola Santa Perpètua,Santa Perpètua de Mogoda,VOC,VOC,4230813,01/04/2022,1,0,1,16,0,0,0,16,6,0,6,16,2
"08028515",Escola Santa Susanna,Santa Susanna,MVO,MVO,4213604,44643,0,0,0,0,9,0,0,9,0,9,9,0,1
"08028576",Escola Sant Vicenç,Sant Vicenç de Castellet,CCE,CCE,4230987,01/04/2022,0,0,0,16,0,4,0,20,0,6,6,16,4
"08028588",Escola Sant Jordi,Sant Vicenç dels Horts,BLL,BLL,4227960,30/03/2022,1,0,1,0,8,0,0,8,0,8,8,9,2
"08028591",Escola La Vinyala,Sant Vicenç dels Horts,BLL,BLL,4231263,01/04/2022,2,0,2,0,10,2,0,12,2,10,12,4,4
"08028667",Escola Joan Juncadella,Sant Vicenç dels Horts,BLL,BLL,4215840,24/03/2022,0,1,1,16,0,0,0,16,10,0,10,16,1
"08028709",Escola Lloriana,Sant Vicenç de Torelló,CCE,CCE,4233133,04/04/2022,1,0,1,9,1,0,0,10,9,1,10,9,0
"08028746",Escola Sant Martí,Cerdanyola del Vallès,VOC,VOC,4213327,23/03/2022,1,0,1,6,0,0,2,8,3,2,5,0,2
"08028758",Escola Les Fontetes,Cerdanyola del Vallès,VOC,VOC,4218366,25/03/2022,1,0,1,8,0,0,0,8,8,0,8,10,2
"08028783",Escola Serraparera,Cerdanyola del Vallès,VOC,VOC,4216059,24/03/2022,1,0,1,21,2,0,0,23,21,2,23,22,4
"08028904",Escola Carles Buïgas,Cerdanyola del Vallès,VOC,VOC,4213926,23/03/2022,1,0,1,8,0,0,1,9,8,1,9,4,3
"08028916",Escola Las Seguidillas,Badia del Vallès,VOC,VOC,4224540,29/03/2022,1,0,1,0,19,0,0,19,0,19,19,0,5
"08028928",Escola La Jota,Badia del Vallès,VOC,VOC,4225534,29/03/2022,1,0,1,18,0,0,0,18,10,0,10,18,4
"08028941",Escola La Sardana,Badia del Vallès,VOC,VOC,4231746,01/04/2022,1,0,1,13,0,0,0,13,7,6,13,12,4
"08028990",Escola Can Sorts,Sentmenat,VOC,VOC,4212893,23/03/2022,1,0,1,25,0,0,1,26,25,1,26,24,6
"08029015",Escola Sant Salvador,Sant Jordi de Cercs (Cercs),CCE,CCE,4227401,30/03/2022,0,0,0,6,0,0,0,6,6,0,6,0,2
"08029027",Escola Farigola,Seva,CCE,CCE,4223086,28/03/2022,1,0,1,9,0,0,0,9,9,0,9,8,1
"08029088",Escola Miquel Utrillo,Sitges,BCO,PEN,4211868,22/03/2022,0,2,2,9,0,10,0,19,10,0,10,18,6
"08029143",Escola Subirats - ZER Subirats,Lavern (Subirats),BCO,PEN,4223507,28/03/2022,1,0,1,0,0,3,0,3,3,0,3,3,3
"08029155",Escola El Montcau - ZER Subirats,Ordal (Subirats),BCO,PEN,4229168,31/03/2022,0,0,0,5,0,0,0,5,3,0,3,5,1
"08029192",Escola Sant Jordi,Sant Pau d'Ordal (Subirats),BCO,PEN,4218396,25/03/2022,1,3,4,6,0,3,1,10,9,1,10,6,2
"08029209",Escola Salipota,Súria,CCE,CCE,4228294,30/03/2022,1,0,1,6,2,0,0,8,2,2,4,1,1
"08029222",Escola Francesc Macià,Súria,CCE,CCE,4231806,01/04/2022,0,0,0,0,9,0,0,9,0,9,9,0,3
"08029283",Escola El Gurri - ZER Guilleries,El Gurri (Taradell),CCE,CCE,4216421,24/03/2022,0,2,2,1,0,0,0,1,0,0,0,0,1
"08029301",Escola Les Pinediques,Taradell,CCE,CCE,4231453,01/04/2022,0,0,0,12,0,2,4,18,14,4,18,13,4
"08029350",Escola França,Terrassa,VOC,VOC,4213160,23/03/2022,0,0,0,21,2,2,2,27,21,2,23,0,5
"08029374",Escola Bisbat d'Egara,Terrassa,VOC,VOC,4220465,27/03/2022,0,0,0,32,0,9,0,41,41,0,41,37,7
"08029386",Escola Ramón y Cajal,Terrassa,VOC,VOC,4226935,30/03/2022,5,0,5,7,0,18,0,25,22,0,22,10,5
"08029507",Escola Isaac Peral,Terrassa,VOC,VOC,4227518,30/03/2022,1,0,1,6,0,0,0,6,3,0,3,9,4
"08030200",Escola Marià Galí Guix,Terrassa,VOC,VOC,4225145,29/03/2022,1,0,1,9,0,0,0,9,9,0,9,9,2
"08030212",Escola Josep Ventalló i Vintró,Terrassa,VOC,VOC,4226767,30/03/2022,1,3,4,11,1,0,0,12,4,0,4,11,2
"08030248",Escola Pau Vila i Dinarès,Terrassa,VOC,VOC,4227187,30/03/2022,1,1,2,22,3,2,0,27,15,3,18,18,5
"08030285",Escola Auró,Terrassa,VOC,VOC,4213005,23/03/2022,2,2,4,0,0,10,0,10,5,0,5,10,4
"08030297",Escola Salvador Vinyals i Galí,Terrassa,VOC,VOC,4213661,23/03/2022,1,2,3,7,0,0,0,7,7,0,7,7,1
"08030315",Escola Joan XXIII,Terrassa,VOC,VOC,4222859,28/03/2022,1,3,4,18,0,0,1,19,18,1,19,18,5
"08030339",Institut de Terrassa,Terrassa,VOC,VOC,4222051,28/03/2022,1,20,21,54,1,0,0,55,54,1,55,54,2
"08030340",Institut Investigador Blanxart,Terrassa,VOC,VOC,4216138,24/03/2022,1,0,1,1,5,0,0,6,0,5,5,0,3
"08030364",Escola El Cim,Teià,MVO,MVO,4231626,01/04/2022,0,0,0,19,0,0,0,19,19,0,19,19,4
"08030388",Escola Lola Anglada,Tiana,MVO,MVO,4228907,31/03/2022,0,0,0,0,23,0,0,23,0,23,23,0,4
"08030421",Escola L'Era de Dalt,Tona,CCE,CCE,4217565,25/03/2022,0,0,0,18,0,0,0,18,18,0,18,18,6
"08030467",Escola Ignasi Iglesias,Tordera,MVO,MVO,4227700,30/03/2022,1,0,1,28,2,0,0,30,28,2,30,28,6
"08030510",Escola Doctor Fortià i Solà,Torelló,CCE,CCE,4213408,23/03/2022,6,0,6,0,0,18,0,18,0,0,0,16,3
"08030522",Escola Vall del Ges,Torelló,CCE,CCE,4212957,23/03/2022,0,4,4,5,1,0,0,6,5,1,6,3,2
"08030583",Escola La Torre,La Torre Alta (La Torre de Claramunt),CCE,PEN,4217705,25/03/2022,0,0,0,7,1,0,0,8,7,1,8,0,2
"08030595",Escola Torrescasana,Vilanova d'Espoia (La Torre de Claramunt),CCE,PEN,4215533,24/03/2022,0,6,6,3,0,0,0,3,0,0,0,6,0
"08030613",Escola J.J. Ràfols,Torrelavit,BCO,PEN,4215559,24/03/2022,0,1,1,8,0,0,0,8,8,0,8,8,2
"08030637",Escola Guerau de Peguera,Torrelles de Foix,BCO,PEN,4226976,30/03/2022,0,0,0,7,2,0,0,9,2,7,9,7,2
"08030662",Escola Serralavella,Ullastrell,VOC,VOC,4231075,01/04/2022,0,0,0,15,0,0,0,15,15,0,15,5,3
"08030686",Escola Pau Casals,Vacarisses,VOC,VOC,4223275,28/03/2022,1,0,1,17,0,0,0,17,17,0,17,17,5
"08030698",Escola Josep Masclans,Vallbona d'Anoia,CCE,PEN,4218853,25/03/2022,0,0,0,0,0,0,5,5,0,5,5,4,1
"08030728",Escola Serrat Voltor - ZER Alt Berguedà,Vallcebre,CCE,CCE,4218602,25/03/2022,1,0,1,0,0,0,1,1,0,1,1,0,1
"08030789",Escola Pompeu Fabra,Vallirana,BLL,BLL,4226775,30/03/2022,0,0,0,0,5,0,5,10,0,10,10,0,3
"08030819",Escola Sentfores,Vic,CCE,CCE,4215918,24/03/2022,1,6,7,0,0,2,1,3,2,1,3,0,2
"08031009",Escola Doctor Joaquim Salarich,Vic,CCE,CCE,4224713,29/03/2022,0,4,4,15,1,0,0,16,0,0,0,16,4
"08031022",Institut de Vic,Vic,CCE,CCE,4227423,30/03/2022,3,0,3,5,1,42,0,48,1,0,1,0,28
"08031034",Institut Jaume Callís,Vic,CCE,CCE,4219612,26/03/2022,3,4,7,24,0,0,0,24,24,0,24,24,24
"08031046",Escola Serra de Picamill - ZER Berguedà Centre,Vilada,CCE,CCE,4212888,23/03/2022,1,0,1,0,0,0,0,0,0,0,0,0,0
"08031061",Escola Rosella,Viladecavalls,VOC,VOC,4229602,31/03/2022,1,1,2,24,0,0,0,24,0,0,0,0,4
"08031083",Escola Àngela Roca,Viladecans,BLL,BLL,4230249,31/03/2022,2,0,2,10,0,0,0,10,0,0,0,15,3
"08031101",Escola Montserratina,Viladecans,BLL,BLL,4212038,22/03/2022,0,1,1,12,4,0,2,18,4,6,10,16,4
"08031204",Escola El Garrofer,Viladecans,BLL,BLL,4229096,31/03/2022,1,0,1,16,2,0,0,18,10,2,12,18,4
"08031228",Institut Torre Roja,Viladecans,BLL,BLL,4231714,01/04/2022,0,5,5,5,13,10,8,36,0,1,1,25,4
"08031277",Escola Joan Maragall,Vilanova del Camí,CCE,PEN,4213462,23/03/2022,0,0,0,18,1,0,0,19,10,0,10,19,5
"08031290",Escola Les Roques,Vilanova de Sau,CCE,CCE,4224618,29/03/2022,0,0,0,2,1,0,0,3,0,0,0,0,1
"08031319",Escola Llebeig,Vilobí del Penedès,BCO,PEN,4214567,23/03/2022,1,0,1,8,1,0,0,9,8,1,9,5,2
"08031320",Escola Estalella i Graells,Vilafranca del Penedès,BCO,PEN,4216312,24/03/2022,0,20,20,0,1,4,1,6,0,0,0,5,4
"08031332",Escola Josep Baltà i Elias,Vilafranca del Penedès,BCO,PEN,4222806,28/03/2022,1,13,14,2,0,12,0,14,0,0,0,10,3
"08031459",Institut Eugeni d'Ors,Vilafranca del Penedès,BCO,PEN,4232046,01/04/2022,0,1,1,30,1,0,0,31,16,1,17,0,0
"08031460",Escola Trentapasses,Vilalba Sasserra,MVO,MVO,4212006,22/03/2022,1,0,1,0,0,0,1,1,0,0,0,9,1
"08031472",Escola Pompeu Fabra,Vilanova i la Geltrú,BCO,PEN,4226813,30/03/2022,4,0,4,0,18,0,0,18,0,18,18,0,2
"08031484",Escola Ginesta,Vilanova i la Geltrú,BCO,PEN,4231346,01/04/2022,0,0,0,15,0,0,0,15,15,0,15,10,3
"08031666",Escola Canigó,Vilanova i la Geltrú,BCO,PEN,4230063,31/03/2022,15,4,19,0,0,16,2,18,4,2,6,10,4
"08031681",Institut Francesc Xavier Lluch i Rafecas,Vilanova i la Geltrú,BCO,PEN,4228626,30/03/2022,1,0,1,0,2,28,0,30,28,2,30,0,7
"08031711",Institut Manuel de Cabanyes,Vilanova i la Geltrú,BCO,PEN,4230802,01/04/2022,0,0,0,19,2,4,4,29,23,6,29,6,12
"08031757",Institut Forat del Vent,Cerdanyola del Vallès,VOC,VOC,4217741,25/03/2022,0,0,0,21,2,0,0,23,21,2,23,23,0
"08031770",Institut Can Jofresa,Terrassa,VOC,VOC,4232100,01/04/2022,1,0,1,21,0,0,0,21,0,0,0,21,0
"08031794",Escola Palma de Mallorca,Barcelona,CEB,CEB,4223675,28/03/2022,1,0,1,9,0,0,0,9,5,0,5,9,2
"08031800",Escola Pau Casals,Barcelona,CEB,CEB,4229249,31/03/2022,0,0,0,9,0,0,0,9,3,0,3,9,2
"08031812",Institut Valldemossa,Barcelona,CEB,CEB,4225962,29/03/2022,0,1,1,12,4,0,0,16,2,0,2,10,0
"08031836",Institut Illa dels Banyols,El Prat de Llobregat,BLL,BLL,4216060,24/03/2022,0,0,0,0,36,0,0,36,10,26,36,4,0
"08031861",Institut Leonardo da Vinci,Sant Cugat del Vallès,VOC,VOC,4218197,25/03/2022,0,0,0,6,2,0,0,8,6,2,8,0,4
"08031873",Institut Arnau Cadell,Sant Cugat del Vallès,VOC,VOC,4229720,31/03/2022,1,0,1,0,0,27,0,27,27,0,27,27,0
"08032300",Escola Fray Luis de León,Santa Coloma de Gramenet,BCO,BCO,4213958,23/03/2022,1,0,1,17,1,0,0,18,5,1,6,12,7
"08032312",Escola Miguel de Unamuno,Santa Coloma de Gramenet,BCO,BCO,4225019,29/03/2022,5,0,5,18,0,0,0,18,18,0,18,0,4
"08032348",Escola 25 de Setembre,Rubí,VOC,VOC,4213315,23/03/2022,0,0,0,26,1,0,0,27,9,0,9,21,2
"08032351",Escola Pau Casals,Rubí,VOC,VOC,4224712,29/03/2022,1,9,10,1,0,15,0,16,3,0,3,16,4
"08032385",Institut Mitjans Audiovisuals,Barcelona,CEB,CEB,4219073,25/03/2022,0,0,0,0,4,0,0,4,0,0,0,0,0
"08032476",Escola Prat de la Riba,Esplugues de Llobregat,BLL,BLL,4221474,28/03/2022,5,2,7,2,0,0,1,3,0,0,0,0,4
"08032491",Escola Sant Vicenç,Mollet del Vallès,MVO,MVO,4216660,24/03/2022,1,0,1,15,0,0,0,15,0,0,0,10,4
"08032521",Escola Vall de Palau,Sant Andreu de la Barca,BLL,BLL,4221560,28/03/2022,0,4,4,14,4,0,0,18,14,4,18,14,4
"08032580",Escola Canigó,Sant Just Desvern,BLL,BLL,4228873,31/03/2022,0,0,0,19,0,0,0,19,7,0,7,19,4
"08032592",Escola Sant Jordi,Sant Vicenç de Montalt,MVO,MVO,4214616,23/03/2022,1,2,3,7,0,0,1,8,0,0,0,5,2
"08032634",Escola Ferrer i Guàrdia,Barcelona,CEB,CEB,4213905,23/03/2022,2,17,19,0,0,4,1,5,4,0,4,0,4
"08032658",Escola L'Eramprunyà,Gavà,BLL,BLL,4230225,31/03/2022,0,0,0,18,0,0,0,18,6,0,6,18,4
"08032713",Escola Sant Jordi,Mollet del Vallès,MVO,MVO,4234210,04/04/2022,0,2,2,17,0,0,0,17,0,0,0,17,6
"08032725",Escola Honorable Josep Tarradellas,El Prat de Llobregat,BLL,BLL,4218511,25/03/2022,1,0,1,18,2,0,0,20,0,2,2,18,6
"08032737",Escola Can Rull,Sabadell,VOC,VOC,4218783,25/03/2022,1,0,1,20,0,0,0,20,20,0,20,20,4
"08032750",Escola Pau Casals,Viladecans,BLL,BLL,4218101,25/03/2022,0,0,0,0,18,0,0,18,0,18,18,0,4
"08032762",Escola Doctor Trueta,Viladecans,BLL,BLL,4218801,25/03/2022,0,0,0,18,0,0,0,18,18,0,18,18,4
"08033341",Escola Banús,Santa Coloma de Gramenet,BCO,BCO,4228089,30/03/2022,1,1,2,7,0,0,0,7,7,0,7,7,1
"08033407",Escola Purificació Salas i Xandri,Sant Quirze del Vallès,VOC,VOC,4237089,05/04/2022,10,0,10,6,0,1,0,7,0,0,0,5,2
"08033468",Escola La Salut,Collbató,BLL,BLL,4217918,25/03/2022,0,0,0,10,1,0,0,11,10,1,11,9,3
"08033501",Escola Antoni Brusi,Barcelona,CEB,CEB,4233207,04/04/2022,0,0,0,16,3,0,0,19,16,3,19,16,4
"08033523",Escola La Muntanyeta,Barcelona,CEB,CEB,4230831,01/04/2022,0,0,0,8,1,0,0,9,8,1,9,6,2
"08033535",Escola Joan Maragall,Esplugues de Llobregat,BLL,BLL,4225398,29/03/2022,1,0,1,23,0,0,0,23,23,0,23,12,5
"08033560",Escola Màrius Torres,L'Hospitalet de Llobregat,BCO,BCO,4230007,31/03/2022,1,0,1,19,2,0,0,21,19,2,21,19,2
"08033602",Escola Can Serra,Barberà del Vallès,VOC,VOC,4212874,23/03/2022,0,0,0,19,0,0,0,19,10,0,10,10,5
"08033869",Institut Pau Casals,Badalona,BCO,BCO,4223379,28/03/2022,0,19,19,12,0,0,8,20,12,8,20,12,2
"08033894",Institut Teresa Pàmies,Barcelona,CEB,CEB,4216202,24/03/2022,0,0,0,0,32,0,0,32,0,0,0,0,21
"08033900",Institut Joan Miró,Cornellà de Llobregat,BLL,BLL,4223579,28/03/2022,2,0,2,20,0,0,0,20,0,0,0,12,0
"08033912",Institut Mercè Rodoreda,L'Hospitalet de Llobregat,BCO,BCO,4212840,23/03/2022,0,0,0,21,1,0,0,22,21,1,22,22,4
"08033924",Institut Pius Font i Quer,Manresa,CCE,CCE,4222458,28/03/2022,1,0,1,26,0,0,10,36,26,10,36,26,25
"08033948",Escola Enric Tatché i Pol,Ripollet,VOC,VOC,4230172,31/03/2022,0,0,0,13,6,0,0,19,13,6,19,0,5
"08033961",Institut Rafael Casanova,Sant Boi de Llobregat,BLL,BLL,4215556,24/03/2022,0,0,0,25,0,0,0,25,25,0,25,25,25
"08033973",Institut Jaume Salvador i Pedrol,Sant Joan Despí,BLL,BLL,4228871,31/03/2022,0,0,0,39,2,1,4,46,40,6,46,42,22
"08033985",Institut de Sant Just Desvern,Sant Just Desvern,BLL,BLL,4227355,30/03/2022,0,0,0,21,0,0,0,21,0,0,0,21,0
"08033997",Escola Primavera,Santa Coloma de Gramenet,BCO,BCO,4225470,29/03/2022,1,0,1,8,0,0,0,8,8,0,8,18,2
"08034001",Institut Terra Roja,Santa Coloma de Gramenet,BCO,BCO,4221822,28/03/2022,0,2,2,21,0,0,0,21,0,0,0,21,0
"08034011",Institut Frederic Mompou,Sant Vicenç dels Horts,BLL,BLL,4227341,30/03/2022,0,0,0,18,0,4,0,22,0,0,0,22,16
"08034035",Institut Federica Montseny,Badia del Vallès,VOC,VOC,4230844,01/04/2022,1,0,1,17,0,0,0,17,17,0,17,0,6
"08034059",Institut Nicolau Copèrnic,Terrassa,VOC,VOC,4215003,23/03/2022,1,2,3,26,2,0,0,28,0,0,0,0,0
"08034060",Escola Mossèn Cinto Verdaguer,Rubí,VOC,VOC,4231804,01/04/2022,17,3,20,20,1,4,0,25,20,1,21,20,4
"08034084",Escola Can Roca,Castelldefels,BLL,BLL,4218349,25/03/2022,0,0,0,18,1,0,0,19,18,1,19,18,4
"08034096",Escola Antoni Gaudí,Castelldefels,BLL,BLL,4213593,23/03/2022,0,0,0,17,1,0,0,18,17,1,18,18,4
"08034102",Escola Josep Maria Madorell,Molins de Rei,BLL,BLL,4215882,24/03/2022,1,0,1,11,0,0,0,11,11,0,11,11,4
"08034126",Escola Pau Boada,Vilafranca del Penedès,BCO,PEN,4218063,25/03/2022,2,1,3,6,0,5,0,11,0,0,0,11,5
"08034138",Institut Poblenou,Barcelona,CEB,CEB,4230362,31/03/2022,0,0,0,11,0,0,0,11,0,0,0,11,3
"08034187",Institut Domènec Perramon,Arenys de Munt,MVO,MVO,4223214,28/03/2022,0,0,0,12,15,0,0,27,0,0,0,2,2
"08034205",Institut La Guineueta,Barcelona,CEB,CEB,4229842,31/03/2022,0,0,0,0,37,0,0,37,0,37,37,0,2
"08034217",Institut Bernat el Ferrer,Molins de Rei,BLL,BLL,4225353,29/03/2022,0,1,1,36,0,0,0,36,36,0,36,33,10
"08034229",Escola Bonavista,Castellar del Vallès,VOC,VOC,4223316,28/03/2022,1,0,1,9,0,0,0,9,9,0,9,9,2
"08034242",Escola Pablo Neruda,L'Hospitalet de Llobregat,BCO,BCO,4218337,25/03/2022,1,0,1,9,0,0,0,9,3,0,3,9,2
"08034266",Escola Joan Maragall,L'Hospitalet de Llobregat,BCO,BCO,4213299,23/03/2022,1,11,12,0,4,0,5,9,0,9,9,0,2
"08034278",Escola Vicente Aleixandre,Martorell,BLL,BLL,4223285,28/03/2022,2,0,2,14,0,0,0,14,14,0,14,14,4
"08034321",Escola Torre Llauder,Mataró,MVO,MVO,4223695,28/03/2022,1,0,1,6,4,0,0,10,3,3,6,6,2
"08034333",Escola La Llàntia,Mataró,MVO,MVO,4218010,25/03/2022,1,3,4,14,2,4,0,20,14,2,16,14,2
"08034357",Escola Vista Alegre,Mataró,MVO,MVO,4216181,24/03/2022,1,3,4,0,0,6,0,6,0,0,0,6,2
"08034382",Escola Ramon Llull,Rubí,VOC,VOC,4229683,31/03/2022,1,0,1,25,1,0,0,26,25,1,26,23,6
"08034400",Escola Antoni Gaudí,Sant Boi de Llobregat,BLL,BLL,4218037,25/03/2022,1,0,1,9,0,0,0,9,9,0,9,9,2
"08034412",Escola Can Massallera,Sant Boi de Llobregat,BLL,BLL,4214027,23/03/2022,1,1,2,7,4,0,0,11,7,4,11,8,2
"08034448",Escola Santa Eulàlia,Les Roquetes (Sant Pere de Ribes),BCO,PEN,4216348,24/03/2022,1,12,13,11,1,0,0,12,11,1,12,11,0
"08034461",Escola Bernat de Mogoda,Santa Perpètua de Mogoda,VOC,VOC,4214047,23/03/2022,1,1,2,14,0,0,0,14,14,0,14,14,4
"08034485",Escola Joan Marquès i Casals,Terrassa,VOC,VOC,4229982,31/03/2022,1,0,1,16,2,0,0,18,16,2,18,0,11
"08034497",Escola L'Aragai,Vilanova i la Geltrú,BCO,PEN,4230106,31/03/2022,0,0,0,11,0,0,0,11,11,0,11,5,4
"08034527",Escola Ramon Muntaner,L'Hospitalet de Llobregat,BCO,BCO,4217816,25/03/2022,1,0,1,9,0,0,0,9,5,0,5,2,2
"08034564",Institut Les Corts,Barcelona,CEB,CEB,4231736,01/04/2022,0,0,0,20,2,0,0,22,20,2,22,20,22
"08034576",Institut Joan Salvat i Papasseit,Barcelona,CEB,CEB,4222679,28/03/2022,0,0,0,10,0,0,0,10,0,0,0,0,0
"08034591",Institut Joan Oliver,Sabadell,VOC,VOC,4216519,24/03/2022,1,2,3,15,0,0,0,15,0,0,0,15,0
"08034606",Institut Baix Montseny,Sant Celoni,MVO,MVO,4231605,01/04/2022,0,0,0,4,5,0,0,9,4,5,9,4,0
"08034621",Institut de Sales,Viladecans,BLL,BLL,4213759,23/03/2022,1,17,18,1,5,4,0,10,4,6,10,6,3
"08034643",Institut Les Vinyes,Santa Coloma de Gramenet,BCO,BCO,4225325,29/03/2022,0,0,0,29,2,0,1,32,29,3,32,29,0
"08034667",Escola Esteve Barrachina,Sitges,BCO,PEN,4225126,29/03/2022,0,0,0,18,0,0,0,18,6,0,6,22,4
"08034709",Institut Narcís Monturiol,Barcelona,CEB,CEB,4212051,22/03/2022,0,0,0,1,1,0,0,2,1,1,2,1,0
"08034734",Escola Camí del Mig,Mataró,MVO,MVO,4225467,29/03/2022,1,1,2,18,0,0,1,19,7,1,8,19,5
"08034746",Escola Rocafonda,Mataró,MVO,MVO,4218268,25/03/2022,1,0,1,18,0,0,0,18,18,0,18,18,4
"08034783",Escola Elvira Cuyàs,Montcada i Reixac,VOC,VOC,4213961,23/03/2022,0,0,0,18,1,0,0,19,18,1,19,18,4
"08034795",Escola Heurom - ZER Alt Lluçanès,Perafita,CCE,CCE,4215131,23/03/2022,2,0,2,0,0,1,0,1,1,0,1,2,1
"08034837",Escola Bernat Desclot,L'Hospitalet de Llobregat,BCO,BCO,4230001,31/03/2022,0,1,1,9,0,0,9,18,9,0,9,9,2
"08034850",Escola Pau Casals,L'Hospitalet de Llobregat,BCO,BCO,4223372,28/03/2022,2,0,2,16,2,0,0,18,16,2,18,20,5
"08034862",Escola Ausiàs March,L'Hospitalet de Llobregat,BCO,BCO,4229838,31/03/2022,0,0,0,10,0,0,0,10,10,0,10,10,1
"08034904",Escola Emili Carles i Tolrà,Castellar del Vallès,VOC,VOC,4225174,29/03/2022,1,0,1,5,0,0,3,8,3,0,3,6,2
"08034965",Escola Margarida Xirgu,Badalona,BCO,BCO,4222619,28/03/2022,10,11,21,18,0,0,0,18,18,0,18,18,4
"08034989",Escola Catalunya,Sant Adrià de Besòs,BCO,BCO,4227839,30/03/2022,2,0,2,17,0,0,0,17,17,0,17,17,4
"08034990",Escola Parellada,Sant Boi de Llobregat,BLL,BLL,4230067,31/03/2022,11,0,11,6,0,0,0,6,6,0,6,6,8
"08035003",EA de Vic,Vic,CCE,CCE,4217829,25/03/2022,0,0,0,8,3,0,0,11,0,0,0,0,3
"08035039",Institut Bonanova,Barcelona,CEB,CEB,4233792,04/04/2022,0,0,0,0,5,0,0,5,0,0,0,0,0
"08035143",Institut Miquel Martí i Pol,Cornellà de Llobregat,BLL,BLL,4234521,04/04/2022,0,4,4,27,15,0,0,42,27,15,42,27,5
"08035155",Institut Els Tres Turons,Arenys de Mar,MVO,MVO,4215939,24/03/2022,0,0,0,32,0,0,0,32,0,0,0,30,0
"08035167",Institut Barcelona-Congrés,Barcelona,CEB,CEB,4236646,05/04/2022,0,0,0,12,4,0,0,16,0,0,0,16,0
"08035209",Institut Pablo R. Picasso,Barcelona,CEB,CEB,4236890,05/04/2022,0,0,0,14,2,0,0,16,6,0,6,14,4
"08035222",Institut Manuel Blancafort,La Garriga,MVO,MVO,4229073,31/03/2022,0,0,0,12,0,0,6,18,12,6,18,12,1
"08035234",Institut Vil·la Romana,La Garriga,MVO,MVO,4229873,31/03/2022,2,0,2,0,2,0,0,2,0,2,2,0,0
"08035246",Institut Gelida,Gelida,BCO,PEN,4229111,31/03/2022,0,1,1,1,14,0,0,15,0,14,14,1,8
"08035258",Institut Apel·les Mestres,L'Hospitalet de Llobregat,BCO,BCO,4231308,01/04/2022,1,0,1,0,30,0,0,30,0,30,30,0,6
"08035283",Escola Reixac,Montcada i Reixac,VOC,VOC,4229183,31/03/2022,1,0,1,11,1,6,0,18,17,1,18,17,4
"08035295",Institut Palau Ausit,Ripollet,VOC,VOC,4224809,29/03/2022,0,0,0,25,1,4,0,30,9,1,10,30,8
"08035301",Institut Duc de Montblanc,Rubí,VOC,VOC,4214266,23/03/2022,36,0,36,2,1,0,0,3,0,0,0,2,0
"08035313",Institut Quercus,Sant Joan de Vilatorrada,CCE,CCE,4225692,29/03/2022,29,5,34,0,2,4,2,8,4,4,8,4,0
"08035325",Institut Torrent de les Bruixes,Santa Coloma de Gramenet,BCO,BCO,4216429,24/03/2022,1,2,3,0,0,16,0,16,16,0,16,16,0
"08035349",Institut La Romànica,Barberà del Vallès,VOC,VOC,4229818,31/03/2022,2,0,2,0,0,37,0,37,0,0,0,0,0
"08035350",Escola Sant Josep,Sant Vicenç dels Horts,BLL,BLL,4218015,25/03/2022,0,0,0,16,0,0,0,16,16,0,16,16,4
"08035362",Institut Alt Penedès,Vilafranca del Penedès,BCO,PEN,4231008,01/04/2022,0,0,0,20,5,0,4,29,20,9,29,8,6
"08035398",Escola Miguel Hernández,Badalona,BCO,BCO,4227862,30/03/2022,1,0,1,0,3,0,1,4,0,0,0,0,4
"08035404",Escola Joan Miró,Badalona,BCO,BCO,4213911,23/03/2022,1,1,2,9,0,0,0,9,0,0,0,9,2
"08035416",Escola Josep Boada,Badalona,BCO,BCO,4225387,29/03/2022,1,0,1,0,12,0,6,18,0,18,18,16,2
"08035428",Escola La Farigola del Clot,Barcelona,CEB,CEB,4231423,01/04/2022,1,0,1,16,2,0,0,18,16,2,18,16,5
"08035431",Escola Bogatell,Barcelona,CEB,CEB,4229690,31/03/2022,0,0,0,14,4,0,0,18,14,4,18,13,4
"08035441",Escola Catalònia,Barcelona,CEB,CEB,4225781,29/03/2022,0,0,0,18,0,0,0,18,12,0,12,18,4
"08035453",Escola Tomàs Moro,Barcelona,CEB,CEB,4235026,04/04/2022,2,0,2,0,0,2,0,2,2,0,2,0,2
"08035465",Escola Mare Nostrum,Barcelona,CEB,CEB,4229348,31/03/2022,1,0,1,0,0,17,0,17,0,0,0,5,4
"08035477",Escola Santiago Rusiñol,Barcelona,CEB,CEB,4211857,22/03/2022,0,0,0,0,18,0,0,18,0,18,18,8,3
"08035519",Escola Antoni Gaudí,Santa Coloma de Gramenet,BCO,BCO,4222971,28/03/2022,1,0,1,5,12,0,0,17,5,12,17,5,4
"08035544",CEE Josep Pla,Barcelona,CEB,CEB,4229318,31/03/2022,5,0,5,9,0,0,0,9,0,0,0,10,3
"08035623",CEE Jeroni de Moragas,Cerdanyola del Vallès,VOC,VOC,4222044,28/03/2022,3,2,5,4,1,0,0,5,4,1,5,4,0
"08035684",Escola Marià Manent,Premià de Dalt,MVO,MVO,4230995,01/04/2022,1,1,2,18,0,0,0,18,18,0,18,18,4
"08035696",Escola Sant Julià,Sabadell,VOC,VOC,4214497,23/03/2022,1,3,4,10,2,0,0,12,10,2,12,12,4
"08035854",Escola Llorens i Artigas,Badalona,BCO,BCO,4212973,23/03/2022,0,1,1,18,0,0,0,18,18,0,18,18,4
"08035878",Escola Pere de Tera,Badalona,BCO,BCO,4213552,23/03/2022,1,0,1,0,16,0,0,16,0,16,16,8,3
"08035881",Escola L'Areny,Cornellà de Llobregat,BLL,BLL,4213937,23/03/2022,0,0,0,16,4,0,0,20,0,0,0,16,6
"08035945",Escola La Carpa,L'Hospitalet de Llobregat,BCO,BCO,4229037,31/03/2022,1,0,1,27,0,0,0,27,0,0,0,21,6
"08035957",Escola Can Deu,Sabadell,VOC,VOC,4229626,31/03/2022,1,0,1,0,10,0,0,10,0,10,10,10,5
"08035969",Escola Joaquim Blume,Sabadell,VOC,VOC,4211869,22/03/2022,1,4,5,0,0,15,0,15,6,0,6,12,4
"08035994",Escola Salvador Espriu,Sant Feliu de Llobregat,BLL,BLL,4223382,28/03/2022,0,2,2,21,0,0,0,21,0,2,2,21,1
"08036007",Escola Pau Vila,Sant Feliu de Llobregat,BLL,BLL,4218784,25/03/2022,1,0,1,16,2,0,0,18,7,0,7,18,2
"08036044",Escola Pau Vila,Esparreguera,BLL,BLL,4230024,31/03/2022,1,20,21,17,1,0,0,18,5,1,6,13,4
"08036056",Escola Folch i Torres,Esplugues de Llobregat,BLL,BLL,4230390,31/03/2022,1,5,6,15,3,0,0,18,15,3,18,17,4
"08036101",Escola Sagrada Família,Santa Coloma de Gramenet,BCO,BCO,4222624,28/03/2022,1,0,1,18,0,0,0,18,18,0,18,18,4
"08036111",Escola Mas i Perera,Vilafranca del Penedès,BCO,PEN,4226020,29/03/2022,1,3,4,0,0,18,0,18,18,0,18,18,6
"08036135",Escola Joan Coret,Badalona,BCO,BCO,4229693,31/03/2022,0,6,6,15,1,1,0,17,15,1,16,15,2
"08036147",Escola Pau Picasso,Badalona,BCO,BCO,4223309,28/03/2022,2,1,3,20,1,0,0,21,10,1,11,20,3
"08036330",Institut J.V. Foix,Rubí,VOC,VOC,4218671,25/03/2022,2,0,2,17,2,0,0,19,10,3,13,10,0
"08036342",Escola Joan Llongueras,Badalona,BCO,BCO,4214475,23/03/2022,2,0,2,9,0,0,0,9,9,0,9,9,2
"08036366",Escola Lola Anglada,L'Hospitalet de Llobregat,BCO,BCO,4229646,31/03/2022,1,2,3,8,1,0,0,9,2,0,2,9,2
"08036378",Escola Charlie Rivel,L'Hospitalet de Llobregat,BCO,BCO,4218092,25/03/2022,0,0,0,9,0,0,0,9,5,0,5,0,2
"08036391",Institut Arquitecte Manuel Raspall,Cardedeu,MVO,MVO,4231362,01/04/2022,0,0,0,20,0,0,0,20,20,0,20,20,0
"08036411",Escola Saltells,Cerdanyola del Vallès,VOC,VOC,4213025,23/03/2022,0,0,0,9,0,0,4,13,5,4,9,0,4
"08037152",Institut Joan Oró,Martorell,BLL,BLL,4228922,31/03/2022,0,0,0,60,5,0,0,65,60,5,65,0,42
"08037176",Institut La Bastida,Santa Coloma de Gramenet,BCO,BCO,4238301,06/04/2022,1,0,1,23,0,0,0,23,0,0,0,23,10
"08037206",Institut Lluís Companys,Ripollet,VOC,VOC,4227584,30/03/2022,0,0,0,20,0,8,0,28,6,0,6,20,0
"08037292",CEE Centre de Formació i Treball Flor de Maig,Cerdanyola del Vallès,VOC,VOC,4214188,23/03/2022,8,0,8,6,0,0,0,6,6,0,6,3,2
"08037504",Escola Montnegre,La Batllòria (Sant Celoni),MVO,MVO,4225441,29/03/2022,1,1,2,0,6,0,0,6,0,3,3,0,2
"08037528",Escola Sant Domènec,La Ràpita (Santa Margarida i els Monjos),BCO,PEN,4228022,30/03/2022,2,0,2,9,0,0,0,9,9,0,9,9,2
"08037814",Escola Alexandre Galí,Barcelona,CEB,CEB,4231651,01/04/2022,3,3,6,11,0,3,0,14,3,0,3,16,4
"08037841",Escola Splai,Barcelona,CEB,CEB,4214145,23/03/2022,1,0,1,0,2,0,4,6,0,6,6,0,2
"08037863",Escola Seat,Barcelona,CEB,CEB,4211871,22/03/2022,10,2,12,6,0,0,0,6,6,0,6,6,2
"08037875",Escola Rafael Casanova,Badalona,BCO,BCO,4231408,01/04/2022,1,0,1,15,0,0,0,15,15,0,15,7,3
"08037887",Escola Baldiri Reixac,Badalona,BCO,BCO,4213596,23/03/2022,1,0,1,11,0,0,0,11,6,0,6,8,2
"08037899",Escola Folch i Torres,Badalona,BCO,BCO,4214127,23/03/2022,1,0,1,9,0,0,0,9,9,0,9,9,2
"08037917",Escola Joan Miró,Can Diviu (Canovelles),MVO,MVO,4213988,23/03/2022,0,0,0,0,9,0,0,9,0,0,0,0,2
"08037929",Escola Torre Barona,Castelldefels,BLL,BLL,4230900,01/04/2022,0,0,0,19,1,1,0,21,20,1,21,19,6
"08037930",Escola Margalló,Castelldefels,BLL,BLL,4231384,01/04/2022,1,0,1,14,1,2,0,17,16,1,17,14,5
"08037966",Escola Ignasi Iglésias,Cornellà de Llobregat,BLL,BLL,4231430,01/04/2022,10,0,10,13,0,0,3,16,0,0,0,12,5
"08037978",Escola Suris,Cornellà de Llobregat,BLL,BLL,4213784,23/03/2022,0,0,0,18,4,0,0,22,18,4,22,25,3
"08037981",Escola de L'Estany - ZER El Moianès Llevant,L'Estany,CCE,CCE,4225584,29/03/2022,2,0,2,2,1,0,0,3,2,1,3,4,1
"08037991",Escola Marcel·lí Moragas,Gavà,BLL,BLL,4234533,04/04/2022,1,0,1,15,1,0,0,16,15,1,16,0,0
"08038004",Escola Josep Janés,L'Hospitalet de Llobregat,BCO,BCO,4216299,24/03/2022,0,0,0,3,0,0,0,3,3,0,3,3,3
"08038031",Escola Rosa Sensat,El Masnou,MVO,MVO,4227860,30/03/2022,0,2,2,1,1,8,0,10,3,1,4,8,1
"08038041",Escola Federico García Lorca,Mollet del Vallès,MVO,MVO,4226867,30/03/2022,1,2,3,3,0,0,0,3,0,0,0,3,2
"08038065",Escola Montseny,Mollet del Vallès,MVO,MVO,4228930,31/03/2022,0,0,0,21,0,1,4,26,6,4,10,24,4
"08038077",Escola Can Parera,Montornès del Vallès,MVO,MVO,4231334,01/04/2022,1,0,1,15,0,0,0,15,4,0,4,15,4
"08038089",Escola Sant Esteve - ZER El Cardener,Valls de Torroella (Sant Mateu de Bages),CCE,CCE,4227732,30/03/2022,0,0,0,1,1,0,0,2,0,0,0,0,0
"08038090",Escola Sant Jaume,El Prat de Llobregat,BLL,BLL,4225522,29/03/2022,0,6,6,15,2,1,0,18,16,2,18,2,5
"08038156",Escola Escursell i Bartalot,Ripollet,VOC,VOC,4212016,22/03/2022,1,0,1,0,0,22,0,22,22,0,22,0,4
"08038168",Escola La Torreta,La Torreta (La Roca del Vallès),MVO,MVO,4213935,23/03/2022,2,2,4,8,0,0,0,8,0,0,0,5,9
"08038171",Escola Montessori,Rubí,VOC,VOC,4231647,01/04/2022,1,0,1,17,0,0,1,18,17,1,18,18,4
"08038181",Escola Serra i Húnter,Manresa,CCE,CCE,4228003,30/03/2022,0,6,6,0,14,0,0,14,0,14,14,0,4
"08038201",Escola La Baumeta - ZER Els Castells,Santa Maria de Besora,CCE,CCE,4229458,31/03/2022,1,1,2,0,0,0,0,0,0,0,0,0,1
"08038211",Escola José Juan Ortiz,Sant Andreu de la Barca,BLL,BLL,4212369,22/03/2022,0,0,0,22,0,0,0,22,22,0,22,16,4
"08038223",Escola Benviure,Sant Boi de Llobregat,BLL,BLL,4217823,25/03/2022,1,1,2,19,3,0,0,22,19,3,22,20,4
"08038247",Escola Pompeu Fabra,Vilanova del Camí,CCE,PEN,4212851,23/03/2022,0,0,0,18,2,0,0,20,10,0,10,10,4
"08038259",Escola Antoni Tàpies,Sant Boi de Llobregat,BLL,BLL,4211884,22/03/2022,1,2,3,16,0,0,0,16,6,0,6,16,4
"08038260",Escola Joan Maragall,Sant Cugat del Vallès,VOC,VOC,4239852,07/04/2022,1,0,1,2,2,6,9,19,8,11,19,1,8
"08038272",Escola García Lorca,Santa Margarida de Montbui,CCE,PEN,4217977,25/03/2022,0,0,0,18,0,0,0,18,18,0,18,18,4
"08038284",Escola La Guàrdia,Sant Vicenç dels Horts,BLL,BLL,4227952,30/03/2022,1,0,1,11,1,0,0,12,10,1,11,10,1
"08038314",Escola Mare de Déu de Montserrat,Terrassa,VOC,VOC,4216368,24/03/2022,1,0,1,8,0,0,1,9,0,0,0,0,0
"08038326",Escola El Vallès,Terrassa,VOC,VOC,4214617,23/03/2022,2,0,2,7,0,0,0,7,0,4,4,11,4
"08038351",Escola Xarau,Cerdanyola del Vallès,VOC,VOC,4227134,30/03/2022,1,0,1,10,0,0,0,10,3,0,3,8,3
"08038533",EA Massana,Barcelona,CEB,CEB,4229565,31/03/2022,0,0,0,3,4,0,0,7,0,2,2,0,2
"08038570",EOI de Barcelona,Barcelona,CEB,CEB,4226914,30/03/2022,0,0,0,46,10,0,0,56,0,10,10,25,0
"08038582",Escola Catalunya,Sabadell,VOC,VOC,4233760,04/04/2022,1,0,1,18,0,0,0,18,10,0,10,18,4
"08039057",Institut L'Alzina,Barcelona,CEB,CEB,4222033,28/03/2022,0,0,0,16,2,0,0,18,16,2,18,27,4
"08039069",Institut Margarida Xirgu,L'Hospitalet de Llobregat,BCO,BCO,4217554,25/03/2022,1,0,1,15,5,0,0,20,0,5,5,15,10
"08039203",Institut Agustí Serra i Fontanet,Sabadell,VOC,VOC,4227432,30/03/2022,2,0,2,33,0,0,0,33,33,0,33,1,1
"08039264",Escola Mestres Munguet-Cortés,Vilanova del Vallès,MVO,MVO,4213649,23/03/2022,1,2,3,17,0,0,0,17,0,0,0,24,4
"08039288",Escola Renaixença,Sant Pere Sacarrera i Urbanització Font (Mediona),BCO,PEN,4213788,23/03/2022,1,0,1,0,4,0,0,4,0,4,4,1,1
"08039291",Escola Cristòfor Mestre,Vilafranca del Penedès,BCO,PEN,4227294,30/03/2022,1,1,2,19,0,0,0,19,6,0,6,19,5
"08039306",Escola Els Pins - ZER El Moianès Ponent,Cabrianes (Sallent),CCE,CCE,4212864,23/03/2022,1,0,1,0,0,0,0,0,0,0,0,0,1
"08039318",Escola Puigberenguer,Manresa,CCE,CCE,4216762,24/03/2022,5,0,5,13,0,0,0,13,8,0,8,13,2
"08039343",Escola Josep Ferrà i Esteva,Olesa de Montserrat,BLL,BLL,4230860,01/04/2022,4,21,25,12,0,0,0,12,12,0,12,12,4
"08039355",Escola Ramon Llull,El Prat de Llobregat,BLL,BLL,4223299,28/03/2022,0,0,0,0,18,0,0,18,0,0,0,0,4
"08039367",Escola Josep Pla,Sant Andreu de la Barca,BLL,BLL,4213205,23/03/2022,1,0,1,18,0,0,0,18,0,0,0,18,4
"08039379",Escola Rafael Casanova,Sant Boi de Llobregat,BLL,BLL,4214064,23/03/2022,4,6,10,15,4,0,0,19,0,4,4,15,3
"08039380",Escola Germans Amat i Targa,Viladecans,BLL,BLL,4225462,29/03/2022,0,0,0,5,12,0,0,17,5,12,17,6,4
"08039434",Escola Doctor Ferran i Clua,Barcelona,CEB,CEB,4219008,25/03/2022,2,0,2,19,0,0,0,19,19,0,19,19,4
"08039471",Escola Mercè Rodoreda,Barcelona,CEB,CEB,4230101,31/03/2022,0,0,0,18,0,0,0,18,18,0,18,18,4
"08039483",Escola Els Horts,Barcelona,CEB,CEB,4214488,23/03/2022,4,0,4,9,0,0,0,9,0,0,0,4,3
"08039495",Escola La Palmera,Barcelona,CEB,CEB,4227851,30/03/2022,1,0,1,15,0,0,2,17,15,2,17,15,9
"08039525",Escola La Sedeta,Barcelona,CEB,CEB,4230139,31/03/2022,0,0,0,6,0,3,0,9,9,0,9,9,2
"08039537",Escola Torrent d'en Melis,Barcelona,CEB,CEB,4223557,28/03/2022,0,5,5,0,16,0,0,16,0,16,16,13,4
"08039562",Escola Prat de la Manta,L'Hospitalet de Llobregat,BCO,BCO,4229342,31/03/2022,1,0,1,10,0,0,0,10,10,0,10,3,2
"08039574",Escola Pau Sans,L'Hospitalet de Llobregat,BCO,BCO,4211919,22/03/2022,0,0,0,8,1,0,0,9,2,1,3,9,2
"08039586",Escola L'Arjau,Vilanova i la Geltrú,BCO,PEN,4216230,24/03/2022,0,0,0,15,3,0,0,18,15,3,18,15,4
"08039598",Escola Sant Miquel del Cros,Argentona,MVO,MVO,4227503,30/03/2022,1,3,4,7,0,0,0,7,0,0,0,5,1
"08039604",Escola Francesc Ferrer i Guàrdia,El Masnou,MVO,MVO,4213213,23/03/2022,1,0,1,2,0,0,0,2,6,0,6,8,2
"08039616",Escola Camí del Cros,Mataró,MVO,MVO,4216176,24/03/2022,1,3,4,15,0,0,0,15,15,0,15,15,4
"08039628",Escola Pompeu Fabra,Manlleu,CCE,CCE,4217881,25/03/2022,0,2,2,14,0,4,0,18,18,0,18,18,4
"08039631",Escola L'Agullola,Rupit (Rupit i Pruit),CCE,CCE,4216067,24/03/2022,1,0,1,0,0,0,1,1,0,0,0,0,4
"08039641",Escola Pablo Picasso,Barberà del Vallès,VOC,VOC,4223438,28/03/2022,0,0,0,13,2,0,0,15,5,2,7,11,5
"08039653",Escola Agustí Bartra,Terrassa,VOC,VOC,4230728,31/03/2022,2,0,2,0,1,0,18,19,0,10,10,0,4
"08039665",Escola Lanaspa-Giralt,Terrassa,VOC,VOC,4230254,31/03/2022,2,1,3,8,2,0,0,10,3,0,3,0,3
"08039677",Escola Congost,Can Castells (Canovelles),MVO,MVO,4229090,31/03/2022,1,1,2,10,3,4,0,17,14,3,17,14,2
"08039690",Escola Germans Corbella,Cardedeu,MVO,MVO,4229035,31/03/2022,2,2,4,14,1,3,1,19,0,2,2,17,4
"08039707",Escola Tagamanent,La Garriga,MVO,MVO,4212035,22/03/2022,0,0,0,12,1,0,0,13,12,1,13,10,2
"08039719",Escola Les Planes,La Llagosta,MVO,MVO,4227319,30/03/2022,1,3,4,17,0,0,0,17,5,0,5,15,4
"08039744",Escola del Pont Trencat - ZER Baix Montseny,Santa Maria de Palautordera,MVO,MVO,4213930,23/03/2022,0,0,0,4,0,0,0,4,4,0,4,0,1
"08039835",Escola de les Aigües,Barcelona,CEB,CEB,4230175,31/03/2022,1,0,1,19,0,0,0,19,19,0,19,19,2
"08039896",Escola Bellaterra,Cerdanyola del Vallès,VOC,VOC,4226975,30/03/2022,0,0,0,0,0,16,2,18,0,0,0,0,4
"08040047",CEE Josep Sol i Rodríguez,Santa Coloma de Gramenet,BCO,BCO,4227998,30/03/2022,11,3,14,0,0,15,3,18,12,3,15,14,1
"08040059",Escola Joan Salvat i Papasseit,Santa Coloma de Gramenet,BCO,BCO,4231212,01/04/2022,1,0,1,23,4,0,0,27,23,4,27,22,4
"08040060",Escola del Mar,Vilassar de Mar,MVO,MVO,4218227,25/03/2022,0,3,3,0,15,0,0,15,0,10,10,10,5
"08040138",Institut La Sedeta,Barcelona,CEB,CEB,4218405,25/03/2022,3,0,3,12,0,0,0,12,0,0,0,12,12
"08040141",Institut Icària,Barcelona,CEB,CEB,4231520,01/04/2022,0,0,0,23,0,0,0,23,0,0,0,23,1
"08040333",Escola Bernat Metge,El Prat de Llobregat,BLL,BLL,4215852,24/03/2022,1,0,1,8,1,0,0,9,3,0,3,8,2
"08040345",Escola Mercè Rodoreda,Badalona,BCO,BCO,4218891,25/03/2022,0,0,0,7,2,0,0,9,2,1,3,9,2
"08040357",CEE Folch i Camarasa,Barcelona,CEB,CEB,4230089,31/03/2022,1,0,1,1,0,3,0,4,1,0,1,2,0
"08040382",Escola Mercè Rodoreda,Santa Coloma de Gramenet,BCO,BCO,4212978,23/03/2022,1,5,6,0,0,3,3,6,0,0,0,0,2
"08040400",Escola Amadeu Vives,Sabadell,VOC,VOC,4212015,22/03/2022,0,0,0,0,12,6,2,20,18,2,20,18,4
"08040412",Escola El Margalló,Vilanova i la Geltrú,BCO,PEN,4228691,30/03/2022,0,0,0,13,0,0,0,13,7,1,8,13,2
"08040527",Institut La Llauna,Badalona,BCO,BCO,4226981,30/03/2022,2,0,2,20,2,0,0,22,0,0,0,11,1
"08040539",Institut Les Marines,Castelldefels,BLL,BLL,4223071,28/03/2022,1,1,2,20,0,0,0,20,20,0,20,20,0
"08040540",Institut El Cairat,Esparreguera,BLL,BLL,4218071,25/03/2022,0,0,0,23,0,0,0,23,0,0,0,23,6
"08040552",Institut Antoni Pous i Argila,Manlleu,CCE,CCE,4213189,23/03/2022,18,9,27,12,0,5,0,17,0,0,0,17,0
"08040564",Institut Jaume Almera,Vilassar de Dalt,MVO,MVO,4233414,04/04/2022,0,0,0,17,0,0,0,17,0,0,0,4,21
"08040618",Escola Can Vidalet,Esplugues de Llobregat,BLL,BLL,4225456,29/03/2022,0,0,0,9,0,0,0,9,0,0,0,9,2
"08040849",Institut Fort Pius,Barcelona,CEB,CEB,4238500,06/04/2022,19,0,19,12,0,0,2,14,0,2,2,12,14
"08041131",Escola Sant Antoni,Sant Vicenç dels Horts,BLL,BLL,4228009,30/03/2022,0,0,0,6,3,3,3,15,10,4,14,11,4
"08041167",Escola Josep Carner,Badalona,BCO,BCO,4229341,31/03/2022,2,1,3,18,0,0,0,18,18,0,18,18,4
"08041179",Escola Mestre Enric Gibert i Camins,Barcelona,CEB,CEB,4231621,01/04/2022,0,7,7,19,0,0,0,19,0,0,0,19,6
"08041180",Escola Rosselló Pòrcel,Santa Coloma de Gramenet,BCO,BCO,4231208,01/04/2022,1,0,1,4,0,4,0,8,8,0,8,2,1
"08041210",Escola del Bosc,Barberà del Vallès,VOC,VOC,4216743,24/03/2022,1,1,2,0,17,0,0,17,0,9,9,17,3
"08041222",Escola Can Cladellas,Palau-solità i Plegamans,VOC,VOC,4213440,23/03/2022,1,0,1,20,0,2,0,22,0,0,0,20,4
"08041234",Escola Collserola,Sant Cugat del Vallès,VOC,VOC,4222349,28/03/2022,2,0,2,0,0,15,2,17,0,0,0,0,2
"08041246",Escola Francesc Aldea i Pérez,Terrassa,VOC,VOC,4234241,04/04/2022,0,0,0,11,0,1,2,14,11,2,13,11,2
"08041374",Institut La Mallola,Esplugues de Llobregat,BLL,BLL,4230203,31/03/2022,3,10,13,8,0,0,0,8,0,0,0,8,0
"08041519",Institut Martí Dot,Sant Feliu de Llobregat,BLL,BLL,4229408,31/03/2022,0,0,0,30,6,0,0,36,0,6,6,18,32
"08041556",Escola Montseny,Sant Just Desvern,BLL,BLL,4227665,30/03/2022,1,0,1,10,0,0,0,10,5,0,5,10,2
"08041568",Escola Jungfrau,Badalona,BCO,BCO,4230025,31/03/2022,1,0,1,19,0,0,0,19,6,0,6,19,4
"08041571",Escola Artur Martorell,Badalona,BCO,BCO,4217612,25/03/2022,1,1,2,10,0,0,0,10,10,0,10,10,2
"08041581",Escola Gitanjali,Badalona,BCO,BCO,4216166,24/03/2022,1,0,1,9,0,0,0,9,9,0,9,9,2
"08041601",Escola Torre de la Llebre,Rubí,VOC,VOC,4214482,23/03/2022,1,0,1,9,0,0,0,9,0,0,0,9,3
"08041611",Escola Joanot Alisanda,Sabadell,VOC,VOC,4225943,29/03/2022,2,5,7,4,3,11,0,18,15,3,18,18,4
"08041647",Escola Ponent,Granollers,MVO,MVO,4223223,28/03/2022,1,0,1,18,0,0,0,18,18,0,18,1,3
"08041659",Escola Mestres Montaña,Granollers,MVO,MVO,4222933,28/03/2022,1,0,1,0,18,0,0,18,0,18,18,0,4
"08041660",Escola Pont de la Cadena,Molins de Rei,BLL,BLL,4216174,24/03/2022,0,1,1,8,1,0,0,9,8,1,9,8,2
"08041672",Escola Creu Alta,Sabadell,VOC,VOC,4223381,28/03/2022,1,0,1,10,0,0,0,10,10,0,10,0,2
"08041684",Escola Espai 3,Sant Joan Despí,BLL,BLL,4215486,24/03/2022,0,2,2,18,0,0,0,18,0,0,0,16,4
"08041696",Escola Vaixell Burriac,Vilassar de Mar,MVO,MVO,4225728,29/03/2022,1,1,2,16,2,0,0,18,16,2,18,16,4
"08041714",Escola Les Basseroles,Sant Miquel (Seva),CCE,CCE,4231044,01/04/2022,0,0,0,1,0,1,5,7,2,5,7,0,2
"08041726",Escola Roc Blanc,Viladecavalls,VOC,VOC,4222508,28/03/2022,1,2,3,12,0,0,0,12,12,0,12,5,4
"08041751",Escola La Caixa,Barcelona,CEB,CEB,4218924,25/03/2022,0,0,0,10,2,0,0,12,3,2,5,4,2
"08041866",Institut El Calamot,Gavà,BLL,BLL,4231349,01/04/2022,0,0,0,32,4,0,0,36,0,0,0,36,9
"08041911",Escola Els Pins,Barcelona,CEB,CEB,4234561,04/04/2022,0,0,0,2,1,0,2,5,2,3,5,0,3
"08041933",Institut Rubió i Tudurí,Barcelona,CEB,CEB,4223468,28/03/2022,0,0,0,0,0,0,0,0,0,0,0,0,1
"08041969",Escola Pau Vila,Barcelona,CEB,CEB,4211997,22/03/2022,0,0,0,4,0,7,0,11,11,0,11,7,1
"08041970",Escola Tres Pins,Barcelona,CEB,CEB,4221572,28/03/2022,1,3,4,6,4,0,0,10,6,4,10,11,2
"08042019",Institut Badalona VII,Badalona,BCO,BCO,4232006,01/04/2022,0,0,0,0,18,0,2,20,1,0,1,0,0
"08042020",Institut Vallès,Sabadell,VOC,VOC,4236439,05/04/2022,3,0,3,24,0,0,0,24,24,0,24,0,0
"08042044",Institut Mig-Món,Súria,CCE,CCE,4225323,29/03/2022,0,0,0,1,16,0,0,17,1,16,17,0,4
"08042056",Institut Can Puig,Sant Pere de Ribes,BCO,PEN,4213678,23/03/2022,1,0,1,0,24,0,0,24,0,24,24,0,0
"08042093",Institut Vinyes Velles,Montornès del Vallès,MVO,MVO,4222436,28/03/2022,1,0,1,22,0,0,0,22,22,0,22,22,22
"08042101",Institut Manuel Vázquez Montalbán,Sant Adrià de Besòs,BCO,BCO,4230200,31/03/2022,0,0,0,16,0,0,2,18,16,2,18,0,0
"08042287",Escola Salvador Espriu,Granollers,MVO,MVO,4226770,30/03/2022,1,4,5,18,0,0,0,18,6,0,6,16,5
"08042299",Escola Sant Miquel,Cornellà de Llobregat,BLL,BLL,4223374,28/03/2022,0,0,0,18,2,0,0,20,18,0,18,18,3
"08042305",Escola Joan Miró,Barcelona,CEB,CEB,4223524,28/03/2022,2,0,2,18,0,0,0,18,18,0,18,19,5
"08042329",Escola Els Xiprers,Barcelona,CEB,CEB,4230329,31/03/2022,0,0,0,5,0,4,0,9,1,0,1,9,2
"08042330",Institut Sant Ramon,Cardona,CCE,CCE,4227252,30/03/2022,0,8,8,4,2,0,0,6,2,0,2,0,0
"08042342",Institut de Badia del Vallès,Badia del Vallès,VOC,VOC,4230992,01/04/2022,0,0,0,23,2,0,0,25,23,2,25,23,4
"08042354",EA La Industrial,Barcelona,CEB,CEB,4238463,06/04/2022,0,0,0,7,8,0,0,15,7,8,15,0,1
"08042573",Institut Lluïsa Cura,Barcelona,CEB,CEB,4235210,04/04/2022,0,0,0,2,0,7,0,9,0,0,0,8,4
"08042585",CEE Pont del Dragó,Barcelona,CEB,CEB,4227383,30/03/2022,0,0,0,2,2,0,0,4,2,2,4,2,0
"08042780",Escola Josep Maria Jujol,Barcelona,CEB,CEB,4237095,05/04/2022,0,0,0,17,2,0,0,19,17,2,19,0,5
"08042792",Escola Damià Mateu,Llinars del Vallès,MVO,MVO,4218307,25/03/2022,0,0,0,10,0,0,0,10,10,0,10,10,2
"08042809",Escola Galileo Galilei,El Prat de Llobregat,BLL,BLL,4227947,30/03/2022,1,1,2,18,0,0,0,18,18,0,18,18,5
"08042810",Escola Charles Darwin,El Prat de Llobregat,BLL,BLL,4215776,24/03/2022,1,0,1,19,0,0,0,19,6,0,6,19,5
"08042834",Escola Can Palmer,Viladecans,BLL,BLL,4218851,25/03/2022,1,0,1,0,11,0,1,12,0,0,0,2,4
"08042846",CFA Cornellà de Llobregat,Cornellà de Llobregat,BLL,BLL,4225169,29/03/2022,0,8,8,5,0,0,0,5,5,0,5,5,1
"08042858",CFA Els Tarongers,Mataró,MVO,MVO,4230420,31/03/2022,0,1,1,4,0,0,0,4,0,0,0,4,1
"08042861",Escola Lola Anglada,Esplugues de Llobregat,BLL,BLL,4218605,25/03/2022,0,2,2,0,0,0,2,2,0,0,0,9,2
"08042871",Escola Patufet Sant Jordi-Francesc Batallé i Ara,L'Hospitalet de Llobregat,BCO,BCO,4221418,28/03/2022,0,0,0,18,0,0,0,18,18,0,18,10,4
"08042883",Escola Sant Josep - El Pi,L'Hospitalet de Llobregat,BCO,BCO,4215471,24/03/2022,0,2,2,9,0,0,0,9,5,0,5,10,2
"08042895",Escola Schola,Rubí,VOC,VOC,4218219,25/03/2022,1,0,1,8,0,0,0,8,5,0,5,8,2
"08043103",Escola Antoni Balmanya,Barcelona,CEB,CEB,4224783,29/03/2022,0,0,0,17,1,0,0,18,2,1,3,15,4
"08043115",Escola Provençals,Barcelona,CEB,CEB,4217660,25/03/2022,1,18,19,16,0,0,0,16,0,0,0,16,4
"08043255",Escola Ítaca,Barcelona,CEB,CEB,4227487,30/03/2022,0,0,0,18,0,0,0,18,0,0,0,18,5
"08043267",Escola Pau Casals-Gràcia,Barcelona,CEB,CEB,4228452,30/03/2022,1,0,1,26,0,6,0,32,26,0,26,26,4
"08043279",Escola Pompeu Fabra,Barcelona,CEB,CEB,4223253,28/03/2022,1,0,1,9,0,0,0,9,9,0,9,9,2
"08043292",Escola Tabor,Barcelona,CEB,CEB,4217713,25/03/2022,0,0,0,19,0,0,0,19,15,0,15,19,5
"08043310",Escola Edumar,Castelldefels,BLL,BLL,4215829,24/03/2022,1,0,1,15,3,0,0,18,5,3,8,18,4
"08043334",Escola Alexandre Galí,Cornellà de Llobregat,BLL,BLL,4224963,29/03/2022,1,0,1,7,2,0,0,9,7,2,9,0,2
"08043346",Escola Montserrat,Esparreguera,BLL,BLL,4220847,27/03/2022,0,0,0,9,0,0,0,9,9,0,9,9,3
"08043361",Escola El Turó,Montcada i Reixac,VOC,VOC,4216696,24/03/2022,0,0,0,0,9,0,0,9,0,0,0,0,2
"08043371",Escola La Lió,Premià de Mar,MVO,MVO,4227956,30/03/2022,0,0,0,4,2,2,1,9,5,0,5,7,2
"08043383",Escola Nostra Llar,Sabadell,VOC,VOC,4227893,30/03/2022,0,0,0,18,1,0,0,19,18,1,19,18,6
"08043395",Institut Alexandre de Riquer,Calaf,CCE,CCE,4231572,01/04/2022,0,1,1,11,0,0,0,11,11,0,11,11,0
"08043401",Escola Barrufet,Sant Boi de Llobregat,BLL,BLL,4226769,30/03/2022,1,0,1,14,0,0,0,14,0,0,0,14,4
"08043437",Escola Font de l'Alba,Terrassa,VOC,VOC,4229882,31/03/2022,1,0,1,9,2,0,0,11,9,2,11,9,4
"08043462",Institut Ernest Lluch,Barcelona,CEB,CEB,4229734,31/03/2022,0,0,0,12,12,0,0,24,12,12,24,0,8
"08043474",Escola L'Estel,Barcelona,CEB,CEB,4213027,23/03/2022,0,0,0,9,1,0,0,10,9,1,10,10,1
"08043486",Institut Manolo Hugué,Caldes de Montbui,MVO,MVO,4215647,24/03/2022,2,2,4,27,2,0,0,29,0,2,2,15,0
"08043504",Institut Pere Calders,Cerdanyola del Vallès,VOC,VOC,4229850,31/03/2022,0,0,0,2,3,18,0,23,0,0,0,3,3
"08043516",Institut Santa Eulàlia,Terrassa,VOC,VOC,4232009,01/04/2022,2,0,2,12,12,3,0,27,0,0,0,17,0
"08043589",Institut Salvador Dalí,El Prat de Llobregat,BLL,BLL,4225374,29/03/2022,0,0,0,21,1,0,0,22,0,0,0,26,26
"08043644",Institut Carles Vallbona,Granollers,MVO,MVO,4231382,01/04/2022,2,0,2,20,6,0,0,26,0,0,0,20,6
"08043656",Institut Marina,La Llagosta,MVO,MVO,4230583,31/03/2022,3,0,3,11,20,0,0,31,0,0,0,3,3
"08043668",Institut L'Estatut,Rubí,VOC,VOC,4230596,31/03/2022,1,0,1,22,0,0,0,22,22,0,22,22,1
"08043671",Institut El Palau,Sant Andreu de la Barca,BLL,BLL,4226792,30/03/2022,0,0,0,30,0,0,0,30,0,0,0,15,3
"08043681",Institut Marianao,Sant Boi de Llobregat,BLL,BLL,4227553,30/03/2022,0,0,0,25,2,0,0,27,0,2,2,13,3
"08043693",Institut Joaquim Mir,Vilanova i la Geltrú,BCO,PEN,4229669,31/03/2022,0,0,0,34,0,0,0,34,0,0,0,34,0
"08043747",Escola Baloo,Barcelona,CEB,CEB,4236625,05/04/2022,0,0,0,0,0,7,0,7,2,0,2,7,0
"08043760",Escola Colònia Güell,La Colònia Güell (Santa Coloma de Cervelló),BLL,BLL,4235784,05/04/2022,18,0,18,0,0,1,0,1,1,0,1,5,1
"08043784",Escola Àngels Garriga,Barcelona,CEB,CEB,4227883,30/03/2022,1,0,1,5,0,1,0,6,3,0,3,4,2
"08043796",Escola Barrufet,Barcelona,CEB,CEB,4230227,31/03/2022,2,0,2,18,0,0,0,18,6,0,6,18,4
"08043814",Escola Carlit,Barcelona,CEB,CEB,4223129,28/03/2022,0,0,0,0,9,0,0,9,0,9,9,7,3
"08043838",Escola Turó del Cargol,Barcelona,CEB,CEB,4235033,04/04/2022,0,0,0,7,0,0,2,9,8,2,10,7,2
"08043841",Escola Lavínia,Barcelona,CEB,CEB,4222228,28/03/2022,0,0,0,9,0,0,0,9,7,0,7,9,2
"08043851",Escola Nabí,Barcelona,CEB,CEB,4224991,29/03/2022,0,1,1,9,0,0,0,9,9,0,9,2,2
"08043863",Escola Orlandai,Barcelona,CEB,CEB,4229870,31/03/2022,0,0,0,8,1,0,0,9,5,0,5,9,2
"08043875",Escola Pit-Roig,Barcelona,CEB,CEB,4236491,05/04/2022,0,0,0,7,0,0,2,9,0,2,2,7,2
"08043887",Escola Sagrada Família,Barcelona,CEB,CEB,4229125,31/03/2022,1,0,1,17,0,1,0,18,8,0,8,18,4
"08043899",Escola Tàber,Barcelona,CEB,CEB,4230082,31/03/2022,0,0,0,18,0,0,0,18,10,0,10,18,4
"08043905",Escola El Dofí,Premià de Mar,MVO,MVO,4223414,28/03/2022,0,4,4,0,0,6,1,7,4,0,4,7,5
"08043917",Escola Cossetània,Vilanova i la Geltrú,BCO,PEN,4216172,24/03/2022,0,2,2,9,0,0,0,9,2,0,2,9,3
"08043929",Escola Llebetx,Vilanova i la Geltrú,BCO,PEN,4222037,28/03/2022,0,1,1,9,0,0,0,9,0,0,0,9,1
"08043930",Escola Marinada,El Masnou,MVO,MVO,4218105,25/03/2022,0,0,0,9,0,0,0,9,9,0,9,9,1
"08043942",Escola Montbui,Caldes de Montbui,MVO,MVO,4225915,29/03/2022,1,1,2,22,3,5,1,31,14,4,18,20,5
"08043954",Escola Ribatallada,Sabadell,VOC,VOC,4224800,29/03/2022,0,0,0,6,1,0,0,7,3,1,4,6,1
"08043966",Escola Heura,Barcelona,CEB,CEB,4211988,22/03/2022,1,0,1,0,0,7,3,10,7,3,10,10,1
"08043978",Institut Daniel Blanxart i Pedrals,Olesa de Montserrat,BLL,BLL,4238791,06/04/2022,4,0,4,25,0,5,0,30,0,0,0,25,2
"08043981",Institut Joan Ramon Benaprès,Sitges,BCO,PEN,4228740,31/03/2022,0,0,0,34,2,0,0,36,0,0,0,32,0
"08044016",Escola Flama,Sant Fruitós de Bages,CCE,CCE,4227438,30/03/2022,1,1,2,16,0,0,0,16,10,0,10,0,4
"08044028",CEE Horitzó,Pineda de Mar,MVO,MVO,4227524,30/03/2022,11,0,11,1,1,7,0,9,7,0,7,6,3
"08044053",Institut Salvador Seguí,Barcelona,CEB,CEB,4230185,31/03/2022,0,0,0,12,6,0,0,18,12,6,18,12,18
"08044077",EA Josep Serra i Abella,L'Hospitalet de Llobregat,BCO,BCO,4239092,06/04/2022,0,0,0,18,0,0,0,18,18,0,18,0,0
"08044120",CFA Freire,Barcelona,CEB,CEB,4224059,28/03/2022,0,0,0,3,1,0,5,9,3,6,9,3,1
"08044156",EA Deià,Barcelona,CEB,CEB,4213547,23/03/2022,0,0,0,8,0,0,0,8,0,0,0,8,0
"08044168",Institut Pla de les Moreres,Vilanova del Camí,CCE,PEN,4212282,22/03/2022,0,0,0,29,0,0,0,29,29,0,29,0,5
"08044201",Escola Dovella,Barcelona,CEB,CEB,4230134,31/03/2022,0,2,2,3,6,1,0,10,4,6,10,6,2
"08044223",CEE L'Estel- Can Bori,L'Hospitalet de Llobregat,BCO,BCO,4230144,31/03/2022,11,0,11,10,0,0,0,10,10,0,10,8,0
"08044247",Escola Estel,Molins de Rei,BLL,BLL,4218789,25/03/2022,1,0,1,5,4,0,0,9,5,4,9,5,2
"08044296",Escola Salvador Espriu,Badalona,BCO,BCO,4215470,24/03/2022,0,0,0,18,0,0,0,18,18,0,18,10,2
"08044302",Escola Joan Abelló,Mollet del Vallès,MVO,MVO,4231676,01/04/2022,0,0,0,16,2,0,0,18,8,0,8,16,4
"08044314",Escola Andreu Castells,Sabadell,VOC,VOC,4214338,23/03/2022,0,0,0,0,9,0,0,9,0,0,0,0,7
"08044430",Escola La Garalda,Pallejà,BLL,BLL,4218776,25/03/2022,0,12,12,16,0,0,0,16,16,0,16,16,6
"08044454",Escola Pilarín Bayés,Les Fonts (Sant Quirze del Vallès),VOC,VOC,4234300,04/04/2022,1,0,1,18,0,0,0,18,18,0,18,8,2
"08044508",Escola Ítaca,Badalona,BCO,BCO,4239376,07/04/2022,1,0,1,1,12,0,0,13,1,5,6,13,1
"08044511",EOI Barcelona-Vall d'Hebron,Barcelona,CEB,CEB,4229755,31/03/2022,0,0,0,22,3,0,0,25,7,3,10,22,0
"08044521",Escola Els Pinetons,La Garriga,MVO,MVO,4229611,31/03/2022,0,13,13,12,0,0,0,12,6,3,9,11,4
"08044533",Institut La Ferreria,Montcada i Reixac,VOC,VOC,4220799,27/03/2022,0,0,0,24,4,3,0,31,0,0,0,13,0
"08044545",Escola Collbaix,Sant Joan de Vilatorrada,CCE,CCE,4234925,04/04/2022,1,0,1,0,0,0,9,9,0,9,9,2,3
"08044569",Institut Pere Barnils,Centelles,CCE,CCE,4230115,31/03/2022,1,0,1,25,2,0,0,27,25,2,27,25,12
"08044570",Institut Vall d'Arús,Vallirana,BLL,BLL,4214074,23/03/2022,0,3,3,24,4,0,0,28,24,4,28,28,0
"08044582",EOI de L'Hospitalet de Llobregat,L'Hospitalet de Llobregat,BCO,BCO,4225232,29/03/2022,0,0,0,0,14,0,5,19,0,19,19,0,0
"08044594",Institut Giola,Llinars del Vallès,MVO,MVO,4224679,29/03/2022,0,0,0,4,0,28,4,36,8,0,8,32,0
"08044600",Institut Moianès,Moià,CCE,CCE,4225412,29/03/2022,0,0,0,18,1,0,0,19,0,0,0,18,0
"08044612",Institut Torre de Malla,Parets del Vallès,MVO,MVO,4228618,30/03/2022,0,0,0,20,5,0,0,25,0,0,0,0,10
"08044624",Institut Sabadell,Sabadell,VOC,VOC,4215434,24/03/2022,0,0,0,27,1,0,0,28,0,0,0,0,3
"08044636",EOI de Sabadell,Sabadell,VOC,VOC,4228640,30/03/2022,0,0,0,0,26,0,0,26,0,4,4,0,1
"08044648",Escola La Roda,Terrassa,VOC,VOC,4223043,28/03/2022,1,1,2,8,6,0,0,14,8,6,14,8,4
"08044715",Institut Jaume Mimó,Cerdanyola del Vallès,VOC,VOC,4225986,29/03/2022,14,8,22,7,0,0,0,7,0,0,0,0,8
"08044910",Escola El Turonet,Sant Quirze del Vallès,VOC,VOC,4213331,23/03/2022,1,0,1,10,1,0,0,11,10,1,11,11,2
"08044922",Institut Dr. Puigvert,Barcelona,CEB,CEB,4230509,31/03/2022,0,0,0,21,2,0,0,23,21,2,23,0,0
"08044934",Institut Escola d'Hoteleria i Turisme de Barcelona,Barcelona,CEB,CEB,4226054,29/03/2022,0,0,0,12,5,0,0,17,0,3,3,0,5
"08044958",Institut Josep Pla,Barcelona,CEB,CEB,4227298,30/03/2022,0,0,0,16,0,0,0,16,0,0,0,16,0
"08044971",Institut Pere Fontdevila,Gironella,CCE,CCE,4231809,01/04/2022,1,2,3,13,0,0,0,13,0,0,0,13,0
"08044983",Institut Lluís Companys,Tordera,MVO,MVO,4217783,25/03/2022,5,9,14,18,0,0,0,18,0,0,0,18,0
"08044995",Institut Barres i Ones,Badalona,BCO,BCO,4229114,31/03/2022,0,0,0,20,3,0,0,23,20,3,23,20,4
"08045011",Institut Torre del Palau,Terrassa,VOC,VOC,4222341,28/03/2022,0,0,0,25,1,0,0,26,1,1,2,20,0
"08045021",Institut Estela Ibèrica,Santa Perpètua de Mogoda,VOC,VOC,4227152,30/03/2022,0,0,0,0,24,0,1,25,1,1,2,24,0
"08045033",Escola Montpalau,Pineda de Mar,MVO,MVO,4222725,28/03/2022,1,2,3,1,0,2,0,3,0,0,0,9,1
"08045045",Escola Mediterrània,Pineda de Mar,MVO,MVO,4213164,23/03/2022,0,0,0,9,0,0,0,9,9,0,9,9,2
"08045057",Escola El Sagrer,Barcelona,CEB,CEB,4228086,30/03/2022,0,1,1,17,1,0,0,18,17,1,18,17,4
"08045070",Institut Europa,L'Hospitalet de Llobregat,BCO,BCO,4216415,24/03/2022,0,0,0,0,10,0,0,10,0,10,10,9,0
"08045203",Institut Obert de Catalunya,Barcelona,BCO,CEB,4215166,23/03/2022,0,0,0,5,0,11,0,16,4,0,4,5,0
"08045227",CEE Les Aigües,Mataró,MVO,MVO,4227477,30/03/2022,11,8,19,0,0,5,0,5,0,0,0,1,1
"08045306",Institut Ramon Casas i Carbó,Palau-solità i Plegamans,VOC,VOC,4224776,29/03/2022,0,0,0,28,0,0,0,28,0,0,0,0,0
"08045471",Institut Pompeu Fabra,Badalona,BCO,BCO,4229292,31/03/2022,0,0,0,30,0,0,0,30,30,0,30,30,8
"08045483",Institut Vila de Gràcia,Barcelona,CEB,CEB,4228042,30/03/2022,0,0,0,14,0,0,0,14,0,0,0,14,11
"08045513",Institut Flos i Calcat,Barcelona,CEB,CEB,4222058,28/03/2022,2,0,2,11,2,2,0,15,0,0,0,15,1
"08045525",Institut Manuel Carrasco i Formiguera,Barcelona,CEB,CEB,4227233,30/03/2022,0,0,0,13,1,0,0,14,13,1,14,13,14
"08045537",Institut Josep Lluís Sert,Castelldefels,BLL,BLL,4229580,31/03/2022,0,1,1,22,0,0,0,22,0,0,0,10,2
"08045549",Institut Banús,Cerdanyola del Vallès,VOC,VOC,4214180,23/03/2022,0,0,0,10,11,0,0,21,10,11,21,0,4
"08045562",Institut Can Planas,Barberà del Vallès,VOC,VOC,4215429,24/03/2022,0,0,0,25,0,0,0,25,25,0,25,0,0
"08045574",Escola Serra de Marina,Santa Coloma de Gramenet,BCO,BCO,4212842,23/03/2022,1,0,1,18,0,0,0,18,10,0,10,18,6
"08045586",Escola Les Pruneres,Martorelles,MVO,MVO,4218475,25/03/2022,1,0,1,7,0,0,0,7,3,0,3,0,4
"08045598",Escola Mil·lenari,Cardedeu,MVO,MVO,4228048,30/03/2022,0,0,0,14,0,1,2,17,2,0,2,0,4
"08045604",Institut Enric Borràs,Badalona,BCO,BCO,4236099,05/04/2022,0,0,0,27,0,0,0,27,0,0,0,0,7
"08045628",Institut Celestí Bellera,Granollers,MVO,MVO,4229471,31/03/2022,0,0,0,20,0,0,0,20,20,0,20,0,0
"08045641",Institut Lluís Domènech i Montaner,Canet de Mar,MVO,MVO,4218149,25/03/2022,0,0,0,27,0,0,0,27,27,0,27,27,0
"08045653",Institut Dolors Mallafrè i Ros,Vilanova i la Geltrú,BCO,PEN,4228991,31/03/2022,0,0,0,26,2,0,0,28,26,0,26,26,0
"08045665",Institut Ramon Turró i Darder,Malgrat de Mar,MVO,MVO,4213171,23/03/2022,0,0,0,26,1,0,0,27,0,0,0,26,3
"08045677",Institut Thalassa,Montgat,MVO,MVO,4231670,01/04/2022,1,0,1,0,19,0,0,19,0,19,19,18,0
"08045689",Institut Voltrera,Abrera,BLL,BLL,4231285,01/04/2022,1,0,1,19,4,0,0,23,0,0,0,23,10
"08045859",Institut de Corbera de Llobregat,Corbera de Llobregat,BLL,BLL,4231740,01/04/2022,1,0,1,18,0,0,0,18,18,0,18,18,14
"08045860",Institut Miramar,Viladecans,BLL,BLL,4221545,28/03/2022,0,0,0,0,33,0,0,33,0,0,0,0,24
"08046281",Escola Estel-Guinardó,Barcelona,CEB,CEB,4213743,23/03/2022,0,0,0,9,1,0,0,10,9,1,10,9,2
"08046293",Escola Cavall Bernat,Barcelona,CEB,CEB,4229824,31/03/2022,1,0,1,2,0,0,0,2,2,0,2,3,2
"08046581",Institut Lluís Vives,Barcelona,CEB,CEB,4236200,05/04/2022,0,0,0,9,3,0,0,12,0,3,3,9,0
"08046608",Institut Príncep de Viana,Barcelona,CEB,CEB,4217832,25/03/2022,2,0,2,0,19,0,0,19,0,0,0,0,0
"08046645",Institut Molí de la Vila,Capellades,CCE,PEN,4225500,29/03/2022,0,1,1,20,0,0,0,20,0,0,0,20,2
"08046657",Institut Joaquim Blume,Esplugues de Llobregat,BLL,BLL,4218315,25/03/2022,0,0,0,0,10,0,5,15,0,0,0,15,6
"08046669",Institut Ribot i Serra,Sabadell,VOC,VOC,4226032,29/03/2022,0,0,0,21,5,4,0,30,0,0,0,30,4
"08046670",Institut Angeleta Ferrer i Sensat,Sant Cugat del Vallès,VOC,VOC,4228278,30/03/2022,0,1,1,24,0,0,0,24,0,0,0,0,24
"08046682",Institut de Castellar,Castellar del Vallès,VOC,VOC,4221399,28/03/2022,0,0,0,30,0,0,0,30,0,0,0,0,0
"08046694",Institut Centre d'Alt Rendiment Esportiu,Sant Cugat del Vallès,VOC,VOC,4231512,01/04/2022,0,0,0,12,0,0,0,12,0,0,0,0,2
"08046724",Institut Montserrat Roig,Terrassa,VOC,VOC,4231743,01/04/2022,0,0,0,27,3,0,0,30,0,3,3,30,2
"08046736",Institut Milà i Fontanals,Vilafranca del Penedès,BCO,PEN,4222608,28/03/2022,0,12,12,20,2,0,0,22,0,2,2,22,1
"08046748",Institut Thos i Codina,Mataró,MVO,MVO,4237244,05/04/2022,1,0,1,0,0,4,4,8,0,4,4,0,0
"08046751",Institut Ventura Gassol,Badalona,BCO,BCO,4230041,31/03/2022,0,0,0,20,0,0,0,20,0,0,0,16,0
"08046761",Institut Guillem Catà,Manresa,CCE,CCE,4227074,30/03/2022,3,0,3,21,12,0,0,33,0,2,2,0,28
"08046785",Institut d'Alella,Alella,MVO,MVO,4213040,23/03/2022,2,0,2,23,3,0,0,26,23,3,26,23,3
"08046797",Institut Laia l'Arquera,Mataró,MVO,MVO,4215474,24/03/2022,27,1,28,14,0,0,0,14,14,0,14,13,0
"08046803",Institut Vilatzara,Vilassar de Mar,MVO,MVO,4225512,29/03/2022,35,0,35,0,10,0,0,10,0,10,10,0,0
"08046840",Institut Castellet,Sant Vicenç de Castellet,CCE,CCE,4231903,01/04/2022,0,0,0,6,1,10,7,24,0,0,0,5,3
"08046852",Institut Llavaneres,Sant Andreu de Llavaneres,MVO,MVO,4225221,29/03/2022,0,0,0,19,0,0,0,19,19,0,19,19,19
"08046864",Institut Bellulla,Bellulla (Canovelles),MVO,MVO,4218011,25/03/2022,0,1,1,29,0,0,0,29,0,0,0,29,0
"08046876",Institut Miquel Bosch i Jover,Artés,CCE,CCE,4216441,24/03/2022,0,0,0,6,9,0,0,15,0,0,0,0,0
"08047364",Institut Joan Mercader,Igualada,CCE,PEN,4229617,31/03/2022,1,16,17,19,1,0,4,24,19,5,24,21,25
"08047376",Institut Llobregat,Sallent,CCE,CCE,4217509,25/03/2022,10,0,10,7,5,0,0,12,0,0,0,11,0
"08047421",Institut Montserrat Roig,Barcelona,CEB,CEB,4229748,31/03/2022,0,0,0,14,2,0,0,16,0,0,0,14,4
"08047431",Institut XXV Olimpíada,Barcelona,CEB,CEB,4227641,30/03/2022,0,0,0,16,4,0,0,20,0,0,0,13,1
"08047467",Institut Alexandre Galí,Les Roquetes (Sant Pere de Ribes),BCO,PEN,4218203,25/03/2022,0,0,0,23,0,0,0,23,23,0,23,0,0
"08047479",Institut Alba del Vallès,Sant Fost de Campsentelles,MVO,MVO,4229918,31/03/2022,1,0,1,0,2,0,3,5,5,0,5,5,1
"08047480",Institut Mediterrània,Castelldefels,BLL,BLL,4230750,01/04/2022,0,0,0,29,0,1,0,30,4,0,4,29,20
"08047492",Institut Ribera Baixa,El Prat de Llobregat,BLL,BLL,4234689,04/04/2022,0,0,0,0,0,0,0,0,0,0,0,0,3
"08047509",Institut Ítaca,Sant Boi de Llobregat,BLL,BLL,4229214,31/03/2022,2,0,2,0,0,8,0,8,0,0,0,0,0
"08047583",Institut Sant Quirze del Vallès,Sant Quirze del Vallès,VOC,VOC,4224805,29/03/2022,0,32,32,2,0,4,1,7,6,1,7,6,0
"08047820",Institut Guinovarda,Piera,CCE,PEN,4231055,01/04/2022,3,0,3,19,1,5,0,25,0,0,0,25,0
"08047832",Institut Joan Coromines,Pineda de Mar,MVO,MVO,4230882,01/04/2022,0,0,0,22,0,0,0,22,4,0,4,22,1
"08051240",Escola Mediterrània,Cornellà de Llobregat,BLL,BLL,4228016,30/03/2022,0,0,0,25,0,1,2,28,7,2,9,26,4
"08051264",Institut Eduard Fontserè,L'Hospitalet de Llobregat,BCO,BCO,4226998,30/03/2022,1,0,1,0,0,14,0,14,0,0,0,14,8
"08051306",Escola Abat Marcet,Terrassa,VOC,VOC,4223302,28/03/2022,1,0,1,19,0,0,0,19,19,0,19,19,3
"08051318",Escola Sant Llorenç del Munt,Terrassa,VOC,VOC,4218156,25/03/2022,1,0,1,19,0,0,0,19,12,0,12,0,4
"08051471",Escola Josep Maria Folch i Torres,L'Hospitalet de Llobregat,BCO,BCO,4214216,23/03/2022,2,0,2,14,0,0,2,16,6,2,8,14,4
"08052165",Escola Octavio Paz,Barcelona,CEB,CEB,4227316,30/03/2022,0,4,4,2,2,1,0,5,3,2,5,2,2
"08052207",Institut de Puig-reig,Puig-reig,CCE,CCE,4229707,31/03/2022,0,0,0,13,0,0,0,13,0,0,0,13,0
"08052581",Institut Miquel Tarradell,Barcelona,CEB,CEB,4231687,01/04/2022,0,0,0,16,0,0,0,16,0,0,0,16,4
"08052608",Institut Pau Claris,Barcelona,CEB,CEB,4222778,28/03/2022,0,14,14,14,0,0,0,14,0,0,0,14,0
"08052621",Escola Pau Romeva,Barcelona,CEB,CEB,4224942,29/03/2022,2,0,2,0,18,0,0,18,0,18,18,0,4
"08052657",Escola Fort Pienc,Barcelona,CEB,CEB,4217640,25/03/2022,2,0,2,13,3,0,0,16,0,0,0,16,4
"08052669",Escola Ferran Sunyer,Barcelona,CEB,CEB,4226870,30/03/2022,3,2,5,3,0,0,0,3,0,0,0,0,4
"08052670",Escola Auró,Barcelona,CEB,CEB,4230921,01/04/2022,2,0,2,15,0,0,2,17,4,2,6,13,5
"08052700",Institut Vall d'Hebron,Barcelona,CEB,CEB,4230917,01/04/2022,0,0,0,41,0,0,0,41,0,0,0,41,0
"08052724",Institut Francisco de Goya,Barcelona,CEB,CEB,4229165,31/03/2022,0,0,0,16,0,0,0,16,0,0,0,16,2
"08052761",Institut Josep Comas i Solà,Barcelona,CEB,CEB,4238719,06/04/2022,0,0,0,0,0,0,0,0,0,0,0,0,0
"08052785",Escola Vila Olímpica,Barcelona,CEB,CEB,4227333,30/03/2022,8,9,17,2,0,0,1,3,0,1,1,2,6
"08052797",Institut Salvador Espriu,Barcelona,CEB,CEB,4231380,01/04/2022,1,0,1,20,1,0,0,21,0,1,1,20,7
"08052827",Institut Lluís Domènech i Montaner,Barcelona,CEB,CEB,4224889,29/03/2022,0,0,0,14,2,0,0,16,14,2,16,0,3
"08052839",Institut Consell de Cent,Barcelona,CEB,CEB,4225526,29/03/2022,3,0,3,10,0,0,0,10,0,0,0,10,2
"08052876",Institut d'Argentona,Argentona,MVO,MVO,4229527,31/03/2022,0,0,0,27,0,0,0,27,0,0,0,27,13
"08052888",Institut Júlia Minguell,Badalona,BCO,BCO,4216263,24/03/2022,24,1,25,9,0,0,0,9,0,0,0,28,0
"08052891",Institut L'Alt Berguedà,Bagà,CCE,CCE,4230294,31/03/2022,0,0,0,23,0,0,0,23,0,0,0,23,1
"08052906",Institut Lauro,Bellavista (Les Franqueses del Vallès),MVO,MVO,4232378,02/04/2022,1,0,1,9,2,0,0,11,9,2,11,11,10
"08052918",Institut Bisbe Berenguer,L'Hospitalet de Llobregat,BCO,BCO,4216428,24/03/2022,0,0,0,16,1,0,0,17,16,1,17,0,2
"08052921",Institut Eugeni d'Ors,L'Hospitalet de Llobregat,BCO,BCO,4231043,01/04/2022,0,0,0,14,0,0,0,14,0,0,0,14,0
"08052931",EOI del Maresme,Mataró,MVO,MVO,4231358 (Modificat per evalisa),01/04/2022,0,0,0,4,11,0,1,16,0,0,0,0,0
"08052955",Institut de Lliçà,Lliçà d'Amunt,MVO,MVO,4230823,01/04/2022,0,0,0,23,0,4,0,27,27,0,27,0,3
"08052979",Institut Josep Puig i Cadafalch,Mataró,MVO,MVO,4215354,24/03/2022,0,0,0,25,2,0,0,27,25,2,27,25,1
"08052980",Institut Montmeló,Montmeló,MVO,MVO,4227335,30/03/2022,0,0,0,20,2,0,0,22,20,2,22,3,6
"08052992",Institut Euclides,Pineda de Mar,MVO,MVO,4216195,24/03/2022,0,0,0,19,0,0,0,19,19,0,19,19,0
"08053005",Institut Castell de Quer,Prats de Lluçanès,CCE,CCE,4216392,24/03/2022,1,0,1,0,11,0,0,11,0,11,11,0,0
"08053017",Institut Valerià Pujol i Bosch,Premià de Dalt,MVO,MVO,4229764,31/03/2022,1,13,14,12,0,0,0,12,12,0,12,12,2
"08053029",EOI Badalona,Badalona,BCO,BCO,4232014,01/04/2022,0,0,0,16,1,3,0,20,2,0,2,0,0
"08053030",Institut de la Roca del Vallès,La Roca del Vallès,MVO,MVO,4220959,27/03/2022,0,1,1,0,19,0,0,19,0,0,0,3,19
"08053042",Institut Miquel Martí i Pol,Roda de Ter,CCE,CCE,4225077,29/03/2022,1,0,1,20,3,0,1,24,0,4,4,20,10
"08053054",Institut Gerbert d'Aurillac,Sant Fruitós de Bages,CCE,CCE,4213822,23/03/2022,1,0,1,2,0,0,0,2,2,0,2,0,0
"08053078",Institut Numància,Santa Coloma de Gramenet,BCO,BCO,4229765,31/03/2022,0,0,0,20,0,0,0,20,5,0,5,10,10
"08053091",Institut El Foix,Els Monjos (Santa Margarida i els Monjos),BCO,PEN,4218368,25/03/2022,1,0,1,21,0,0,0,21,21,0,21,21,0
"08053108",Institut Reguissol,Santa Maria de Palautordera,MVO,MVO,4216019,24/03/2022,0,0,0,8,0,3,0,11,0,0,0,11,0
"08053111",Institut d'Auro,Santpedor,CCE,CCE,4225849,29/03/2022,1,0,1,19,0,0,0,19,19,0,19,0,0
"08053121",Institut Taradell,Taradell,CCE,CCE,4218174,25/03/2022,0,1,1,1,0,0,0,1,19,0,19,19,20
"08053145",Institut Castellbisbal,Castellbisbal,VOC,VOC,4231244,01/04/2022,0,0,0,12,14,0,0,26,12,0,12,26,0
"08053157",Institut Gorgs,Cerdanyola del Vallès,VOC,VOC,4212139,22/03/2022,0,0,0,16,1,0,0,17,16,1,17,17,0
"08053169",Institut Matadepera,Matadepera,VOC,VOC,4226817,30/03/2022,0,0,0,1,2,15,16,34,16,18,34,0,0
"08053170",Institut Polinyà,Polinyà,VOC,VOC,4215799,24/03/2022,5,0,5,0,22,0,0,22,0,22,22,7,10
"08053182",Institut La Serreta,Rubí,VOC,VOC,4218575,25/03/2022,0,0,0,32,2,0,0,34,0,0,0,2,12
"08053194",EOI de Terrassa,Terrassa,VOC,VOC,4213291,23/03/2022,0,0,0,0,20,0,0,20,0,20,20,4,0
"08053200",Institut Miquel Crusafont i Pairó,Sabadell,VOC,VOC,4213056,23/03/2022,1,2,3,15,0,0,0,15,0,0,0,15,5
"08053212",Institut Jonqueres,Sabadell,VOC,VOC,4216390,24/03/2022,1,2,3,15,0,3,0,18,0,0,0,18,3
"08053224",Institut Les Termes,Sabadell,VOC,VOC,4237728,06/04/2022,0,0,0,20,0,0,0,20,20,0,20,20,4
"08053236",Institut Rovira-Forns,Santa Perpètua de Mogoda,VOC,VOC,4225020,29/03/2022,1,0,1,11,2,2,0,15,0,2,2,5,0
"08053248",Institut de Sentmenat,Sentmenat,VOC,VOC,4222388,28/03/2022,2,0,2,0,16,0,0,16,0,2,2,16,0
"08053251",Institut Cavall Bernat,Terrassa,VOC,VOC,4227903,30/03/2022,0,0,0,21,5,4,0,30,0,5,5,8,0
"08053261",Institut de Viladecavalls,Viladecavalls,VOC,VOC,4221186,28/03/2022,1,0,1,0,1,6,5,12,6,6,12,6,0
"08053285",Institut El Castell,Esparreguera,BLL,BLL,4229927,31/03/2022,3,0,3,22,0,2,1,25,25,0,25,22,0
"08053297",Institut de Pallejà,Pallejà,BLL,BLL,4215797,24/03/2022,0,2,2,3,1,3,0,7,0,0,0,4,0
"08053315",Institut Montserrat Roig,Sant Andreu de la Barca,BLL,BLL,4214595,23/03/2022,1,0,1,32,4,0,0,36,0,0,0,36,27
"08053340",Institut Gabriela Mistral,Sant Vicenç dels Horts,BLL,BLL,4230969,01/04/2022,2,5,7,30,2,0,0,32,0,2,2,27,15
"08053352",Institut Montbui,Santa Margarida de Montbui,CCE,PEN,4217987,25/03/2022,6,1,7,22,2,0,0,24,0,2,2,22,23
"08053364",Institut Josep Mestres i Busquets,Viladecans,BLL,BLL,4225448,29/03/2022,2,34,36,6,0,0,0,6,0,0,0,6,0
"08053391",Escola Lledoner,Granollers,MVO,MVO,4226271,29/03/2022,5,0,5,13,0,0,0,13,13,0,13,10,2
"08053406",Escola Can Besora,Mollet del Vallès,MVO,MVO,4229997,31/03/2022,18,0,18,5,0,0,0,5,5,0,5,0,3
"08053421",Escola Aloc,Pineda de Mar,MVO,MVO,4225207,29/03/2022,1,0,1,0,15,0,0,15,0,7,7,4,4
"08053431",Escola El Roure,Pontons,BCO,PEN,4227784,30/03/2022,0,1,1,0,0,0,0,0,0,0,0,0,1
"08053443",EOI Santa Coloma,Santa Coloma de Gramenet,BCO,BCO,4212201,22/03/2022,0,0,0,17,0,0,0,17,0,0,0,0,0
"08053455",Escola Les Aigües,Cardedeu,MVO,MVO,4224493,29/03/2022,0,0,0,23,3,0,0,26,23,3,26,23,4
"08053467",Escola Palau,Palau-solità i Plegamans,VOC,VOC,4217381,24/03/2022,1,0,1,16,2,0,0,18,16,2,18,0,4
"08053492",Escola Teresa Claramunt,Sabadell,VOC,VOC,4229296,31/03/2022,1,0,1,17,0,0,0,17,17,0,17,17,5
"08053510",Escola Puig d'Agulles,Corbera de Llobregat,BLL,BLL,4230074,31/03/2022,1,1,2,10,4,0,0,14,10,4,14,10,4
"08053522",Escola La Ginesta,Vallirana,BLL,BLL,4223272,28/03/2022,1,0,1,12,2,0,0,14,5,2,7,11,2
"08053571",Inst-Esc Art. Oriol Martorell,Barcelona,CEB,CEB,4235909,05/04/2022,14,1,15,47,9,0,0,56,5,0,5,14,0
"08053583",Escola Maria Ossó,Sitges,BCO,PEN,4230129,31/03/2022,0,2,2,0,19,0,0,19,0,10,10,13,4
"08053601",Escola Lola Anglada,Martorell,BLL,BLL,4218526,25/03/2022,0,0,0,18,1,0,0,19,18,1,19,20,4
"08053650",Escola Turó de Guiera,Cerdanyola del Vallès,VOC,VOC,4227015,30/03/2022,0,0,0,18,0,0,0,18,18,0,18,18,4
"08054022",Escola Marinada,Barcelona,CEB,CEB,4222867,28/03/2022,1,3,4,5,0,0,0,5,5,0,5,8,2
"08054034",Institut Gallecs,Mollet del Vallès,MVO,MVO,4229252,31/03/2022,0,10,10,34,0,0,0,34,0,0,0,33,0
"08054058",Escola Torre de la Miranda,Cornellà de Llobregat,BLL,BLL,4223362,28/03/2022,1,0,1,13,0,4,2,19,17,2,19,15,3
"08054061",Escola Montbaig,Sant Boi de Llobregat,BLL,BLL,4213477,23/03/2022,1,0,1,6,1,2,0,9,2,0,2,6,2
"08054113",Escola Anxaneta,Mataró,MVO,MVO,4214055,23/03/2022,0,2,2,0,21,0,0,21,0,0,0,0,2
"08054174",Institut La Ribera,Montcada i Reixac,VOC,VOC,4227642,30/03/2022,0,0,0,24,4,0,1,29,0,1,1,10,1
"08054186",Institut Can Mas,Ripollet,VOC,VOC,4222064,28/03/2022,5,0,5,19,0,0,0,19,0,0,0,0,3
"08054198",Institut Estany de la Ricarda,El Prat de Llobregat,BLL,BLL,4222773,28/03/2022,0,0,0,16,1,0,0,17,0,0,0,16,0
"08054228",Institut Dolors Aleu,Barcelona,CEB,CEB,4229553,31/03/2022,0,26,26,3,8,0,0,11,3,8,11,11,0
"08054241",Institut Eugeni Xammar,L'Ametlla del Vallès,MVO,MVO,4218892,25/03/2022,0,0,0,16,0,0,0,16,0,0,0,10,0
"08054277",Institut de Tona,Tona,CCE,CCE,4229912,31/03/2022,1,0,1,23,0,0,0,23,0,0,0,20,8
"08054344",EOI Esplugues,Esplugues de Llobregat,BLL,BLL,4230328,31/03/2022,0,1,1,11,0,0,0,11,0,0,0,11,0
"08054368",CEE Ca n'Oriol,Rubí,VOC,VOC,4231754,01/04/2022,4,0,4,14,0,0,0,14,14,0,14,14,1
"08054401",Institut El Sui,Cardedeu,MVO,MVO,4213751,23/03/2022,1,0,1,3,20,0,0,23,0,0,0,0,0
"08054411",Escola Vallgorguina,Vallgorguina,MVO,MVO,4211905,22/03/2022,0,5,5,3,2,0,0,5,3,2,5,2,1
"08054824",Escola Mestre Pla,Castellar del Vallès,VOC,VOC,4212024,22/03/2022,1,0,1,9,1,0,0,10,9,1,10,0,2
"08054848",Institut Bosc de Montjuïc,Barcelona,CEB,CEB,4231053,01/04/2022,0,0,0,0,0,1,3,4,0,0,0,0,7
"08054873",Institut Joaquima Pla i Farreras,Sant Cugat del Vallès,VOC,VOC,4229200,31/03/2022,0,1,1,20,1,1,0,22,0,0,0,18,2
"08054903",Escola Mediterrània,Barcelona,CEB,CEB,4224851,29/03/2022,1,0,1,7,0,0,2,9,5,0,5,3,2
"08055002",CFA Barri Gòtic,Barcelona,CEB,CEB,4227899,30/03/2022,2,0,2,4,1,0,0,5,0,0,0,4,0
"08055041",CFA Canovelles,La Barriada Nova (Canovelles),MVO,MVO,4223160,28/03/2022,0,0,0,0,0,1,0,1,1,0,1,0,1
"08055051",CFA Castelldefels,Castelldefels,BLL,BLL,4225223,29/03/2022,0,0,0,4,0,1,0,5,0,0,0,2,0
"08055063",CFA Canyelles,Barcelona,CEB,CEB,4226939,30/03/2022,6,0,6,6,0,0,0,6,6,0,6,6,0
"08055075",CFA Torre Romeu,Sabadell,VOC,VOC,4225695,29/03/2022,0,0,0,1,4,0,0,5,1,4,5,4,1
"08055105",Escola Arraona,Sabadell,VOC,VOC,4226823,30/03/2022,1,0,1,13,0,0,0,13,0,0,0,0,6
"08055385",CFA Mollet del Vallès,Mollet del Vallès,MVO,MVO,4231273,01/04/2022,0,2,2,3,0,0,0,3,1,0,1,2,1
"08055397",CFA Jaume Tuset,Ripollet,VOC,VOC,4230255,31/03/2022,0,0,0,0,0,0,0,0,0,0,0,0,0
"08055403",CFA Sant Roc,Badalona,BCO,BCO,4212124,22/03/2022,0,3,3,1,1,0,0,2,1,1,2,2,1
"08055439",CFA Mestre Esteve,Sant Feliu de Llobregat,BLL,BLL,4223720,28/03/2022,0,1,1,7,2,0,0,9,0,0,0,5,0
"08055440",CFA Garrosa,Sant Vicenç dels Horts,BLL,BLL,4222947,28/03/2022,0,0,0,2,1,2,0,5,0,1,1,4,2
"08055683",CFA Manuel Sacristán,Barcelona,CEB,CEB,4223024,28/03/2022,0,0,0,7,0,1,0,8,0,0,0,8,0
"08055695",CFA Rafael Farré,Molins de Rei,BLL,BLL,4216674,24/03/2022,0,0,0,7,2,1,0,10,0,0,0,0,0
"08055713",CFA Sant Cugat del Vallès,Sant Cugat del Vallès,VOC,VOC,4222820,28/03/2022,0,0,0,4,0,0,1,5,0,1,1,1,1
"08055889",Escola Miquel Martí i Pol,Sabadell,VOC,VOC,4217644,25/03/2022,1,0,1,19,0,0,0,19,19,0,19,19,4
"08055890",Escola Sobirans,Arenys de Munt,MVO,MVO,4221349,28/03/2022,1,1,2,0,0,9,1,10,9,1,10,0,4
"08055932",Escola Torrent de Can Carabassa,Barcelona,CEB,CEB,4223543,28/03/2022,1,14,15,3,0,8,0,11,6,0,6,11,2
"08055944",Institut Rubió i Ors,L'Hospitalet de Llobregat,BCO,BCO,4229477,31/03/2022,1,0,1,14,0,0,0,14,14,0,14,0,0
"08056109",Institut Can Vilumara,L'Hospitalet de Llobregat,BCO,BCO,4230945,01/04/2022,0,0,0,14,4,6,0,24,20,4,24,0,0
"08056560",CFA Barberà,Barberà del Vallès,VOC,VOC,4217726,25/03/2022,0,0,0,4,0,1,1,6,0,0,0,0,0
"08056572",CFA Terra Baixa,El Prat de Llobregat,BLL,BLL,4214642,23/03/2022,0,0,0,3,1,0,0,4,3,1,4,3,0
"08056584",CFA L'Alzina de Cerdanyola,Cerdanyola del Vallès,VOC,VOC,4218004,25/03/2022,0,0,0,0,0,0,0,0,0,0,0,0,1
"08056614",Escola Cirera,Mataró,MVO,MVO,4221204,28/03/2022,1,0,1,5,11,0,0,16,5,11,16,0,2
"08056985",Institut Ramon Berenguer IV,Santa Coloma de Gramenet,BCO,BCO,4224960,29/03/2022,0,0,0,5,1,0,0,6,0,0,0,0,6
"08056997",CFA La Concòrdia,Sabadell,VOC,VOC,4218159,25/03/2022,0,5,5,12,0,0,0,12,12,0,12,0,2
"08057001",CFA La Creu de Barberà,Sabadell,VOC,VOC,4231446,01/04/2022,0,0,0,0,0,0,3,3,0,3,3,0,1
"08057011",CFA Can Rull,Sabadell,VOC,VOC,4225037,29/03/2022,0,0,0,0,0,0,7,7,0,7,7,0,2
"08057096",Escola Guillem de Mont-rodon,Vic,CCE,CCE,4218909,25/03/2022,0,0,0,19,0,0,0,19,19,0,19,19,4
"08057102",Escola Andersen,Vic,CCE,CCE,4214351,23/03/2022,8,1,9,13,0,0,0,13,0,0,0,13,0
"08057163",CFA Teresa Mañé,Vilanova i la Geltrú,BCO,PEN,4214523,23/03/2022,0,0,0,1,0,6,0,7,7,0,7,7,1
"08057229",Escola Els Arenys,Castellbisbal,VOC,VOC,4224831,29/03/2022,1,1,2,11,0,0,0,11,5,0,5,11,2
"08057230",Institut Cubelles,Cubelles,BCO,PEN,4229933,31/03/2022,0,7,7,0,19,0,0,19,0,0,0,10,3
"08057242",Escola Serena Vall,Sant Andreu de Llavaneres,MVO,MVO,4213769,23/03/2022,0,0,0,18,0,0,0,18,10,0,10,18,4
"08057254",Institut Pere Ribot,Vilassar de Mar,MVO,MVO,4218193,25/03/2022,0,0,0,16,0,0,0,16,16,0,16,16,3
"08057266",Escola Els Cingles,L'Ametlla del Vallès,MVO,MVO,4227065,30/03/2022,0,4,4,12,0,1,1,14,7,1,8,13,2
"08057540",Institut Joan Brossa,Barcelona,CEB,CEB,4229343,31/03/2022,0,0,0,4,4,0,0,8,0,1,1,0,0
"08057667",CFA Trinitat Vella,Barcelona,CEB,CEB,4217032,24/03/2022,0,0,0,4,0,0,1,5,4,1,5,0,0
"08057679",CFA Bellvitge-Gornal,L'Hospitalet de Llobregat,BCO,BCO,4230078,31/03/2022,0,0,0,9,1,0,0,10,9,1,10,7,1
"08057734",Escola Antoni Gaudí,Santa Margarida de Montbui,CCE,PEN,4214463,23/03/2022,2,2,4,0,16,0,0,16,0,16,16,0,4
"08057874",CFA Catalònia,L'Hospitalet de Llobregat,BCO,BCO,4217966,25/03/2022,0,0,0,7,1,2,0,10,1,1,2,9,1
"08057965",CFA Can Serra,L'Hospitalet de Llobregat,BCO,BCO,4213402,23/03/2022,0,0,0,6,0,0,0,6,6,0,6,6,0
"08058209",CFA Sant Boi,Sant Boi de Llobregat,BLL,BLL,4217600,25/03/2022,0,0,0,7,0,0,0,7,0,0,0,6,0
"08058210",CFA Badia del Vallès,Badia del Vallès,VOC,VOC,4224484,29/03/2022,0,0,0,2,1,0,0,3,0,0,0,0,0
"08058362",Escola Riera de Ribes,Sant Pere de Ribes,BCO,PEN,4230903,01/04/2022,0,0,0,0,0,9,9,18,9,9,18,0,4
"08058374",Escola Els Alocs,Vilassar de Mar,MVO,MVO,4231189,01/04/2022,1,1,2,0,1,3,0,4,0,1,1,2,2
"08058404",Institut Cirviànum de Torelló,Torelló,CCE,CCE,4229020,31/03/2022,1,29,30,13,4,0,0,17,0,2,2,12,13
"08058416",Escola L'Arenal de Llevant,Barcelona,CEB,CEB,4229836,31/03/2022,0,8,8,19,3,0,0,22,6,3,9,19,6
"08058428",Institut Bisaura,Sant Quirze de Besora,CCE,CCE,4214416,23/03/2022,1,0,1,8,0,0,0,8,0,0,0,8,0
"08058441",Escola Giroi,La Garriga,MVO,MVO,4226699,30/03/2022,8,0,8,0,0,6,0,6,0,0,0,7,4
"08058465",Escola Enxaneta,Terrassa,VOC,VOC,4217857,25/03/2022,0,0,0,27,0,0,0,27,27,0,27,27,6
"08058489",CFA Can Batlló,Barcelona,CEB,CEB,4231083,01/04/2022,0,0,0,3,0,4,0,7,0,0,0,7,1
"08058519",Escola Sinera,Arenys de Mar,MVO,MVO,4225479,29/03/2022,0,15,15,0,1,7,0,8,2,0,2,0,4
"08058520",Institut Puig de la Creu,Castellar del Vallès,VOC,VOC,4231489,01/04/2022,1,0,1,16,0,0,0,16,0,0,0,0,1
"08058775",Institut Front Marítim,Barcelona,CEB,CEB,4229379,31/03/2022,0,0,0,14,1,0,0,15,0,1,1,14,0
"08058957",Escola Els Costerets,Sant Pere de Ribes,BCO,PEN,4214182,23/03/2022,0,1,1,12,6,0,0,18,12,6,18,18,4
"08058969",Institut El Vern,Lliçà de Vall,MVO,MVO,4230767,01/04/2022,2,0,2,0,12,0,0,12,0,0,0,12,0
"08059044",CFA La Llagosta,La Llagosta,MVO,MVO,4223711,28/03/2022,0,2,2,2,3,0,1,6,2,3,5,4,1
"08059093",Escola d'Hortsavinyà,Tordera,MVO,MVO,4227733,30/03/2022,1,0,1,0,1,0,1,2,0,0,0,0,2
"08059329",Institut Can Peixauet,Santa Coloma de Gramenet,BCO,BCO,4217792,25/03/2022,0,6,6,9,0,0,0,9,9,0,9,0,12
"08059354",Escola Les Roques Blaves,Esparreguera,BLL,BLL,4223427,28/03/2022,0,0,0,17,0,0,0,17,7,0,7,17,3
"08059524",Institut de Navarcles,Navarcles,CCE,CCE,4225287,29/03/2022,0,0,0,8,0,0,0,8,0,0,0,8,0
"08059551",EOI de Manresa,Manresa,CCE,CCE,4218462,25/03/2022,0,0,0,13,1,0,0,14,0,1,1,0,0
"08059639",Escola Progrés,Badalona,BCO,BCO,4230168,31/03/2022,2,0,2,16,0,0,0,16,0,2,2,16,2
"08059688",Institut Maria Aurèlia Capmany,Cornellà de Llobregat,BLL,BLL,4223910,28/03/2022,0,0,0,20,0,0,0,20,0,0,0,20,0
"08059691",CFA Anna Murià,Terrassa,VOC,VOC,4216135,24/03/2022,0,0,0,0,0,0,1,1,0,1,1,1,1
"08059706",CFA Salvador Espriu,Terrassa,VOC,VOC,4234748,04/04/2022,0,0,0,0,0,0,0,0,0,0,0,0,0
"08059721",Escola Marta Mata,Viladecans,BLL,BLL,4215825,24/03/2022,0,0,0,20,0,0,0,20,20,0,20,20,6
"08059731",CFA Arquitecte Jujol,Sant Joan Despí,BLL,BLL,4215554,24/03/2022,0,0,0,5,1,4,0,10,0,0,0,9,2
"08059755",Escola La Font,Manresa,CCE,CCE,4216648,24/03/2022,0,0,0,0,0,24,0,24,0,0,0,6,2
"08059767",Escola Tanit,Santa Coloma de Gramenet,BCO,BCO,4223314,28/03/2022,1,0,1,0,9,0,0,9,0,9,9,9,2
"08059780",Escola Bellavista-Joan Camps i Giró,Bellavista (Les Franqueses del Vallès),MVO,MVO,4213387,23/03/2022,1,5,6,10,0,0,2,12,10,2,12,11,1
"08059792",Escola Mogent,Montornès del Vallès,MVO,MVO,4213228,23/03/2022,5,0,5,19,0,0,0,19,8,0,8,23,5
"08059809",Escola El Roure,Sant Fost de Campsentelles,MVO,MVO,4231259,01/04/2022,2,12,14,0,0,2,0,2,2,0,2,3,1
"08059810",Escola Vinya del Sastret,Sant Esteve Sesrovires,BLL,BLL,4223331,28/03/2022,0,0,0,10,0,0,0,10,6,0,6,10,2
"08059822",Escola Ernest Lluch,Abrera,BLL,BLL,4215380,24/03/2022,0,0,0,18,0,0,0,18,8,0,8,15,4
"08059871",Escola Gerbert d'Orlhac,Sant Cugat del Vallès,VOC,VOC,4222743,28/03/2022,0,0,0,0,18,0,0,18,0,18,18,10,4
"08059998",Escola La Pau,Sant Sadurní d'Anoia,BCO,PEN,4218816,25/03/2022,0,0,0,19,1,0,0,20,6,0,6,19,4
"08060009",Institut Manuel Carrasco i Formiguera,Sant Feliu de Codines,MVO,MVO,4231579,01/04/2022,0,0,0,0,8,0,0,8,0,8,8,0,8
"08060095",CFA Montseny,Vic,CCE,CCE,4218637,25/03/2022,0,0,0,0,1,0,0,1,0,0,0,0,0
"08060113",CFA Jacint Carrió i Vilaseca,Manresa,CCE,CCE,4218120,25/03/2022,0,0,0,8,0,0,0,8,0,0,0,6,0
"08060137",CFA Edèlia Hernández,Viladecans,BLL,BLL,4218478,25/03/2022,0,0,0,3,2,1,2,8,2,2,4,0,1
"08060204",CFA Gran Sol,Badalona,BCO,BCO,4221775,28/03/2022,0,2,2,0,6,0,0,6,0,6,6,6,0
"08060216",CFA Morera Pomar,Badalona,BCO,BCO,4218539,25/03/2022,0,0,0,9,0,0,0,9,9,0,9,9,0
"08060228",CFA El Clot,Barcelona,CEB,CEB,4230780,01/04/2022,0,7,7,1,2,0,0,3,0,0,0,0,0
"08060231",CFA Pegaso,Barcelona,CEB,CEB,4229924,31/03/2022,0,0,0,2,2,2,2,8,4,4,8,4,0
"08060253",CFA Can Marfà,Mataró,MVO,MVO,4223870,28/03/2022,0,0,0,4,1,0,0,5,0,0,0,0,0
"08060265",CFA Premià de Mar,Premià de Mar,MVO,MVO,4215067,23/03/2022,0,0,0,0,1,0,3,4,0,4,4,0,0
"08060277",CFA Pau Casals,Rubí,VOC,VOC,4214624,23/03/2022,0,0,0,9,0,1,0,10,10,0,10,0,9
"08060289",CFA Fondo,Santa Coloma de Gramenet,BCO,BCO,4214301,23/03/2022,0,3,3,6,0,0,0,6,6,0,6,6,0
"08060290",CFA Singuerlín,Santa Coloma de Gramenet,BCO,BCO,4225485,29/03/2022,0,1,1,5,1,0,0,6,5,1,6,3,2
"08060319",Escola Les Fonts,Argentona,MVO,MVO,4230846,01/04/2022,0,0,0,13,2,0,0,15,13,2,15,0,0
"08060411",CFA Sants-Sant Raimon de Penyafort,Barcelona,CEB,CEB,4224593,29/03/2022,0,0,0,6,0,0,1,7,2,0,2,7,0
"08060423",Escola Mas Prats,Palafolls,MVO,MVO,4227410,30/03/2022,0,0,0,0,18,0,0,18,0,18,18,0,5
"08060484",Escola Taula Rodona,Sant Quirze del Vallès,VOC,VOC,4227540,30/03/2022,0,0,0,18,0,0,0,18,18,0,18,10,4
"08060514",Institut de Masquefa,Masquefa,CCE,PEN,4231174,01/04/2022,26,2,28,0,10,0,0,10,0,10,10,0,0
"08060526",Escola Creixà,Piera,CCE,PEN,4211944,22/03/2022,1,0,1,0,7,0,0,7,0,0,0,0,2
"08060538",EOI del Prat de Llobregat,El Prat de Llobregat,BLL,BLL,4214608,23/03/2022,0,0,0,0,7,0,0,7,0,0,0,0,0
"08060599",Escola Garigot,Castelldefels,BLL,BLL,4212963,23/03/2022,0,0,0,16,0,0,0,16,4,0,4,16,2
"08060605",Escola Font del Roure,Masquefa,CCE,PEN,4212817,23/03/2022,0,12,12,18,0,0,0,18,8,0,8,12,4
"08060629",Escola El Corb,Corbera de Llobregat,BLL,BLL,4234525,04/04/2022,1,0,1,8,0,0,0,8,0,0,0,5,0
"08060757",Escola Joan Torredemer Canela,Matadepera,VOC,VOC,4213334,23/03/2022,1,2,3,0,0,3,15,18,3,15,18,3,4
"08060836",Escola Turó del Drac,Canet de Mar,MVO,MVO,4229388,31/03/2022,0,1,1,0,2,0,2,4,0,4,4,0,2
"08060848",Escola de Sant Andreu de la Barca,Sant Andreu de la Barca,BLL,BLL,4231526,01/04/2022,0,0,0,16,2,0,0,18,16,2,18,16,4
"08060851",Escola L'Olivera,Vallirana,BLL,BLL,4211870,22/03/2022,0,0,0,16,0,0,0,16,0,16,16,16,4
"08060873",Escola Eulàlia Bota,Barcelona,CEB,CEB,4227501,30/03/2022,0,1,1,18,0,0,0,18,6,0,6,18,4
"08060903",Escola El Colomer,El Rieral de Bigues (Bigues i Riells),MVO,MVO,4225604,29/03/2022,0,0,0,17,1,0,0,18,17,1,18,23,5
"08060915",Institut Maria de Bell-lloc,El Rieral de Bigues (Bigues i Riells),MVO,MVO,4233717,04/04/2022,0,0,0,14,2,0,2,18,2,2,4,0,6
"08060927",Escola Vora del Mar,Cubelles,BCO,PEN,4229501,31/03/2022,0,0,0,14,4,0,0,18,14,4,18,14,2
"08060939",Escola Guerau de Liost,Corró d'Avall (Les Franqueses del Vallès),MVO,MVO,4216684,24/03/2022,0,0,0,0,6,13,0,19,4,6,10,13,5
"08060940",Escola Rosa Oriol Anguera,Lliçà d'Amunt,MVO,MVO,4231339,01/04/2022,4,2,6,12,0,0,0,12,12,0,12,8,4
"08060952",Escola Els Vinyals,Lliçà de Vall,MVO,MVO,4225188,29/03/2022,1,0,1,9,0,0,0,9,5,0,5,6,2
"08060964",Escola Quatre Vents,Manlleu,CCE,CCE,4229426,31/03/2022,0,2,2,21,0,0,0,21,21,0,21,19,5
"08060976",Institut del Voltreganès,La Gleva (Les Masies de Voltregà),CCE,CCE,4224594,29/03/2022,1,17,18,3,0,0,0,3,0,0,0,0,0
"08060988",Escola Cal Músic,Mollet del Vallès,MVO,MVO,4215419,24/03/2022,1,0,1,11,4,0,0,15,11,4,15,15,4
"08060991",Escola Mogent,La Roca del Vallès,MVO,MVO,4228908,31/03/2022,0,1,1,15,0,0,2,17,0,2,2,18,4
"08061002",Escola Les Parellades,Sant Pere de Ribes,BCO,PEN,4227214,30/03/2022,0,1,1,0,8,0,0,8,3,0,3,0,3
"08061014",Institut Vinyet,Sitges,BCO,PEN,4231636,01/04/2022,0,13,13,14,1,3,0,18,0,0,0,15,16
"08061026",Escola La Falguera,Vilanova del Vallès,MVO,MVO,4218855,25/03/2022,1,1,2,9,3,0,0,12,9,3,12,7,3
"08061038",Institut de Vilanova del Vallès,Vilanova del Vallès,MVO,MVO,4231166,01/04/2022,0,0,0,19,0,0,0,19,19,0,19,19,0
"08061041",Escola Sant Jordi,Vilanova i la Geltrú,BCO,PEN,4226960,30/03/2022,0,5,5,14,1,0,0,15,14,1,15,9,2
"08061051",Escola Ítaca,Vilanova i la Geltrú,BCO,PEN,4236333,05/04/2022,0,0,0,15,0,0,0,15,0,0,0,15,4
"08061063",Escola La Serreta,Alella,MVO,MVO,4212106,22/03/2022,1,3,4,0,9,0,0,9,0,9,9,9,2
"08061087",Escola Marina,Montgat,MVO,MVO,4229972,31/03/2022,1,3,4,14,1,0,0,15,7,1,8,14,4
"08061099",Institut Font del Ferro,Palafolls,MVO,MVO,4223647,28/03/2022,2,0,2,22,0,0,0,22,0,0,0,0,0
"08061105",Escola Sot del Camp,Sant Vicenç de Montalt,MVO,MVO,4218740,25/03/2022,0,0,0,0,4,0,0,4,0,4,4,0,3
"08061117",Institut Turó d'en Baldiri,Teià,MVO,MVO,4222678,28/03/2022,0,0,0,3,2,0,0,5,0,0,0,3,9
"08061129",Institut Montserrat Colomer,Sant Esteve Sesrovires,BLL,BLL,4231886,01/04/2022,0,0,0,16,4,0,0,20,16,4,20,16,0
"08061142",Escola Miquel Martí i Pol,Barberà del Vallès,VOC,VOC,4225874,29/03/2022,0,0,0,1,0,14,3,18,15,3,18,5,2
"08061154",Escola Ca n'Alzamora,Rubí,VOC,VOC,4213286,23/03/2022,1,0,1,18,1,0,0,19,18,1,19,19,7
"08061166",Escola de Can Llong,Sabadell,VOC,VOC,4222976,28/03/2022,1,7,8,10,0,0,0,10,6,0,6,10,4
"08061178",Escola Turó de Can Mates,Sant Cugat del Vallès,VOC,VOC,4235142,04/04/2022,1,0,1,19,0,0,0,19,19,0,19,19,4
"08061191",Escola Font de l'Orpina,Vacarisses,VOC,VOC,4231726,01/04/2022,1,1,2,6,4,0,0,10,6,4,10,6,2
"08061208",Institut Vacarisses,Vacarisses,VOC,VOC,4230771,01/04/2022,0,0,0,0,18,0,0,18,0,3,3,0,0
"08061221",CFA Vallès,Granollers,MVO,MVO,4218723,25/03/2022,0,0,0,9,0,0,1,10,9,0,9,10,0
"08061348",Escola Bufalà,Badalona,BCO,BCO,4228007,30/03/2022,0,1,1,18,1,0,0,19,10,1,11,15,6
"08061521",Escola Vall de Néspola - ZER El Moianès Ponent,Mura,CCE,CCE,4228303,30/03/2022,1,0,1,0,0,1,1,2,1,1,2,0,1
"08061543",Escola Roser Capdevila,Polinyà,VOC,VOC,4231657,01/04/2022,0,0,0,18,0,0,0,18,18,0,18,18,4
"08061555",CFA Can Folguera,Santa Perpètua de Mogoda,VOC,VOC,4227849,30/03/2022,0,0,0,3,0,0,0,3,3,0,3,0,0
"08061580",CFA Lloreda-la Pau,Badalona,BCO,BCO,4213204,23/03/2022,0,0,0,6,0,1,0,7,6,1,7,6,1
"08061609",Escola Mercè Rodoreda,Martorell,BLL,BLL,4227578,30/03/2022,1,0,1,19,0,0,0,19,19,0,19,19,4
"08061610",Escola La Sínia,Molins de Rei,BLL,BLL,4222627,28/03/2022,1,0,1,16,0,0,2,18,16,2,18,18,2
"08061683",CFA Palau de Mar,Barcelona,CEB,CEB,4223838,28/03/2022,0,2,2,2,1,0,0,3,2,1,3,1,0
"08061701",CFA Maria Rubies,Barcelona,CEB,CEB,4224978,29/03/2022,0,0,0,2,1,0,0,3,0,0,0,0,0
"08061725",EOI Barcelona III,Barcelona,CEB,CEB,4211903,22/03/2022,0,0,0,8,2,0,0,10,0,0,0,8,0
"08061762",Escola Mas Maria,Cabrils,MVO,MVO,4211912,22/03/2022,0,4,4,14,0,0,0,14,14,0,14,14,4
"08061774",Escola Les Arenes,Terrassa,VOC,VOC,4230841,01/04/2022,2,0,2,12,6,0,0,18,12,6,18,0,0
"08061907",CFA Barceloneta,Barcelona,CEB,CEB,4214141,23/03/2022,0,3,3,0,0,1,0,1,0,0,0,1,1
"08061919",CFA Rius i Taulet,Barcelona,CEB,CEB,4228400,30/03/2022,0,0,0,6,0,0,0,6,0,0,0,6,0
"08061932",CFA Bon Pastor,Barcelona,CEB,CEB,4236926,05/04/2022,0,2,2,2,0,0,0,2,2,0,2,1,1
"08061944",CFA Madrid,Barcelona,CEB,CEB,4239179,06/04/2022,0,0,0,0,2,0,3,5,0,5,5,0,0
"08061956",CFA Prosperitat,Barcelona,CEB,CEB,4213828,23/03/2022,3,0,3,0,0,0,0,0,0,0,0,0,0
"08061968",CFA Les Corts,Barcelona,CEB,CEB,4236851,05/04/2022,0,0,0,5,0,1,0,6,6,0,6,6,0
"08061971",CFA Berguedà,Berga,CCE,CCE,4212499,22/03/2022,0,0,0,1,0,0,0,1,0,0,0,1,0
"08061993",CFA Eugeni d'Ors,Esplugues de Llobregat,BLL,BLL,4227874,30/03/2022,0,3,3,6,0,0,0,6,6,0,6,0,1
"08062018",CFA Anoia,Igualada,CCE,PEN,4230237,31/03/2022,0,0,0,0,2,0,0,2,0,2,2,0,0
"08062021",CFA Montcada i Reixac,Montcada i Reixac,VOC,VOC,4216876,24/03/2022,0,2,2,2,0,0,0,2,2,0,2,2,1
"08062031",CFA Mare de Déu de Montserrat,Olesa de Montserrat,BLL,BLL,4212108,22/03/2022,0,1,1,4,0,0,0,4,4,0,4,3,0
"08062043",CFA Parets del Vallès,Parets del Vallès,MVO,MVO,4230967,01/04/2022,0,0,0,0,0,0,0,0,0,0,0,0,0
"08062055",CFA Sant Just Desvern,Sant Just Desvern,BLL,BLL,4239450,07/04/2022,2,2,4,4,0,0,0,4,0,0,0,3,0
"08062079",CFA Ramon Llull,Terrassa,VOC,VOC,4213198,23/03/2022,0,0,0,0,6,0,0,6,0,0,0,0,0
"08062080",CFA Egara,Terrassa,VOC,VOC,4234942,04/04/2022,0,8,8,0,0,2,0,2,0,0,0,8,2
"08062092",CFA Vilafranca del Penedès,Vilafranca del Penedès,BCO,PEN,4230164,31/03/2022,0,0,0,9,2,0,0,11,9,2,11,7,2
"08062109",AFA Ciutat Meridiana,Barcelona,CEB,CEB,4236356,05/04/2022,1,0,1,0,1,0,0,1,0,0,0,0,0
"08062110",CFA Sanfeliu,L'Hospitalet de Llobregat,BCO,BCO,4212724,23/03/2022,0,0,0,7,0,0,1,8,7,1,8,0,1
"08062122",CFA Martorell,Martorell,BLL,BLL,4230415,31/03/2022,0,0,0,3,0,0,5,8,3,5,8,3,0
"08062146",CFA La Verneda,Barcelona,CEB,CEB,4238425,06/04/2022,0,0,0,2,0,0,0,2,0,0,0,0,0
"08062158",EOI de Martorell,Martorell,BLL,BLL,4228290,30/03/2022,0,0,0,9,2,0,0,11,9,2,11,10,0
"08062161",EOI de Sant Cugat del Vallès,Sant Cugat del Vallès,VOC,VOC,4223405,28/03/2022,0,0,0,0,7,0,0,7,0,0,0,1,2
"08062171",EOI d'Igualada,Igualada,CCE,PEN,4231397,01/04/2022,0,0,0,1,0,0,0,1,1,0,1,0,0
"08062183",EOI Osona,Vic,CCE,CCE,4230211,31/03/2022,0,0,0,3,1,1,0,5,4,1,5,4,0
"08062195",EOI Barcelona IV,Barcelona,CEB,CEB,4230278,31/03/2022,0,0,0,14,0,0,1,15,0,0,0,14,0
"08062201",EOI Barcelona V,Barcelona,CEB,CEB,4229483,31/03/2022,0,0,0,0,0,6,1,7,6,1,7,7,1
"08062213",EOI Vallès Oriental,Granollers,MVO,MVO,4212305,22/03/2022,0,4,4,5,0,0,0,5,5,0,5,0,1
"08062225",EOI Garraf,Vilanova i la Geltrú,BCO,PEN,4227315,30/03/2022,0,0,0,0,8,0,0,8,0,8,8,0,9
"08062249",CFA El Carmel,Barcelona,CEB,CEB,4224782,29/03/2022,0,1,1,2,0,0,1,3,2,1,3,1,0
"08062250",CFA Guinardó,Barcelona,CEB,CEB,4218380,25/03/2022,0,1,1,5,0,0,0,5,5,0,5,6,0
"08062262",CFA Montserrat Roig,Barcelona,CEB,CEB,4216261,24/03/2022,0,5,5,0,1,0,0,1,0,1,1,0,1
"08062331",CFA Pere Calders,Barcelona,CEB,CEB,4238110,06/04/2022,4,0,4,4,0,0,1,5,4,1,5,4,0
"08062468",CFA Bellavista,Bellavista (Les Franqueses del Vallès),MVO,MVO,4230391,31/03/2022,0,1,1,0,3,0,0,3,0,3,3,0,0
"08062471",CFA Gavà,Gavà,BLL,BLL,4216856,24/03/2022,0,1,1,0,4,0,0,4,0,4,4,0,1
"08062481",CFA Sant Josep,L'Hospitalet de Llobregat,BCO,BCO,4218055,25/03/2022,0,0,0,0,4,0,0,4,0,4,4,2,0
"08062493",CFA Sant Ramon,L'Hospitalet de Llobregat,BCO,BCO,4222688,28/03/2022,0,0,0,1,1,0,0,2,1,0,1,0,0
"08062511",CFA Alarona,Mataró,MVO,MVO,4212794,23/03/2022,0,0,0,0,1,0,0,1,0,1,1,0,1
"08062523",CFA Marinada,Montornès del Vallès,MVO,MVO,4225646,29/03/2022,0,0,0,2,1,0,0,3,2,1,3,0,1
"08062614",Escola Joan Blanquer,Castellar del Vallès,VOC,VOC,4223398,28/03/2022,1,1,2,0,9,0,0,9,0,9,9,6,2
"08062626",Escola Collserola,Cerdanyola del Vallès,VOC,VOC,4215631,24/03/2022,0,0,0,0,8,0,1,9,0,9,9,0,2
"08062638",Escola La Trama,Sabadell,VOC,VOC,4231389,01/04/2022,1,0,1,9,4,0,0,13,9,4,13,4,3
"08062641",Escola L'Olivera,Sant Cugat del Vallès,VOC,VOC,4226737,30/03/2022,1,0,1,28,2,0,0,30,0,0,0,14,5
"08062675",Escola Pere IV,Barcelona,CEB,CEB,4213371,23/03/2022,0,0,0,19,0,0,0,19,19,0,19,19,4
"08062687",Escola Ponent,Terrassa,VOC,VOC,4227826,30/03/2022,11,2,13,0,10,1,0,11,1,8,9,0,0
"08062705",Escola La Cabana,Les Cabanyes,BCO,PEN,4225132,29/03/2022,2,1,3,0,2,0,0,2,0,2,2,2,1
"08062717",Institut Cabrils,Cabrils,MVO,MVO,4231583,01/04/2022,0,0,0,1,5,0,0,6,1,5,6,1,2
"08062729",Institut Pla Marcell,Cardedeu,MVO,MVO,4230762,01/04/2022,0,0,0,0,20,0,0,20,0,20,20,0,5
"08062730",Institut Els Roures,Dosrius,MVO,MVO,4212904,23/03/2022,14,0,14,14,0,0,0,14,0,0,0,14,0
"08062742",Escola Benviure,Castellbisbal,VOC,VOC,4216094,24/03/2022,0,0,0,0,9,0,0,9,0,9,9,0,2
"08062754",Escola Les Fonts,Gelida,BCO,PEN,4224900,29/03/2022,0,0,0,18,2,0,0,20,18,2,20,18,2
"08062778",Escola Ametllers,Sant Joan de Vilatorrada,CCE,CCE,4225983,29/03/2022,0,0,0,14,1,0,1,16,6,0,6,14,4
"08062781",Escola Mediterrània,Les Roquetes (Sant Pere de Ribes),BCO,PEN,4231728,01/04/2022,0,2,2,14,2,0,0,16,14,2,16,6,4
"08062791",Institut Vilamajor,Sant Pere de Vilamajor,MVO,MVO,4213895,23/03/2022,1,0,1,0,9,0,9,18,0,18,18,0,0
"08062808",Institut Esteve Albert,Sant Vicenç de Montalt,MVO,MVO,4227266,30/03/2022,0,0,0,0,1,16,0,17,0,0,0,0,0
"08062811",Escola Matagalls,Santa Maria de Palautordera,MVO,MVO,4216110,24/03/2022,2,0,2,0,9,0,0,9,9,0,9,6,1
"08062833",Escola Agnès de Sitges,Sitges,BCO,PEN,4222891,28/03/2022,0,5,5,0,7,0,0,7,0,7,7,0,2
"08062857",Institut Tiana,Tiana,MVO,MVO,4227796,30/03/2022,2,7,9,20,0,0,0,20,20,0,20,10,0
"08062869",Escola Serra de Miralles,Tordera,MVO,MVO,4231702,01/04/2022,0,0,0,9,1,0,0,10,9,1,10,2,4
"08062870",Institut La Plana,Vic,CCE,CCE,4213470,23/03/2022,2,1,3,0,14,0,0,14,0,14,14,0,19
"08062924",Escola Josep Guinovart,Castelldefels,BLL,BLL,4213832,23/03/2022,0,2,2,9,0,0,0,9,5,0,5,9,5
"08062948",Escola Miquel Martí i Pol,Viladecans,BLL,BLL,4216649,24/03/2022,0,3,3,0,20,0,0,20,0,20,20,22,6
"08063072",Escola Fructuós Gelabert,Barcelona,CEB,CEB,4223279,28/03/2022,0,0,0,0,19,0,0,19,0,19,19,0,2
"08063229",Institut Montpedrós,Santa Coloma de Cervelló,BLL,BLL,4218070,25/03/2022,1,0,1,36,1,0,0,37,0,1,1,36,1
"08063394",Escola Miquel Martí i Pol,Sant Feliu de Llobregat,BLL,BLL,4227867,30/03/2022,0,0,0,0,2,16,0,18,16,2,18,24,5
"08063618",CFA Esparreguera,Esparreguera,BLL,BLL,4237029,05/04/2022,0,0,0,0,1,0,1,2,0,0,0,0,0
"08063621",CFA Martí i Pol,Manlleu,CCE,CCE,4213610,23/03/2022,0,1,1,3,0,0,0,3,0,0,0,0,1
"08063643",CFA La Cooperativa,Torelló,CCE,CCE,4225914,29/03/2022,0,1,1,2,0,0,0,2,0,0,0,0,1
"08063710",Escola Escola Nova,Cervelló,BLL,BLL,4221211,28/03/2022,0,1,1,0,9,0,0,9,0,9,9,0,2
"08063734",Escola Puigventós,Olesa de Montserrat,BLL,BLL,4234781,04/04/2022,0,0,0,6,12,0,0,18,6,12,18,6,4
"08063758",Escola Can Salvi,Sant Andreu de la Barca,BLL,BLL,4217973,25/03/2022,1,2,3,20,1,0,0,21,20,1,21,20,5
"08063761",Escola Vicente Ferrer,Sant Boi de Llobregat,BLL,BLL,4222002,28/03/2022,1,2,3,7,0,0,0,7,5,0,5,0,2
"08063771",Escola Pla de les Vinyes,Santa Coloma de Cervelló,BLL,BLL,4216740,24/03/2022,1,2,3,10,0,0,2,12,4,2,6,10,2
"08063783",Escola Mediterrània,Viladecans,BLL,BLL,4224729,29/03/2022,1,1,2,0,8,0,0,8,0,8,8,8,2
"08063795",Escola Marta Mata,Vilanova del Camí,CCE,PEN,4231150,01/04/2022,0,0,0,9,0,0,0,9,9,0,9,9,2
"08063801",Institut de Collbató,Collbató,BLL,BLL,4213244,23/03/2022,1,15,16,2,0,2,0,4,0,0,0,4,0
"08063813",Institut Creu de Saba,Olesa de Montserrat,BLL,BLL,4236857,05/04/2022,0,0,0,16,0,0,0,16,16,0,16,16,6
"08063837",Institut Les Margues,Calldetenes,CCE,CCE,4229895,31/03/2022,0,0,0,11,1,0,0,12,0,0,0,4,12
"08063862",Escola L'Olivar,Castellnou de Bages,CCE,CCE,4226953,30/03/2022,1,1,2,12,0,1,0,13,13,0,13,10,3
"08063874",Escola Antonio Machado,Mataró,MVO,MVO,4229985,31/03/2022,0,0,0,0,18,0,0,18,0,18,18,0,4
"08063886",Escola Arrels,Els Monjos (Santa Margarida i els Monjos),BCO,PEN,4225411,29/03/2022,0,0,0,8,3,1,0,12,9,3,12,9,1
"08063898",Escola La Sèquia,Manresa,CCE,CCE,4231772,01/04/2022,1,0,1,15,1,2,1,19,6,1,7,1,2
"08063904",Institut Montgròs,Sant Pere de Ribes,BCO,PEN,4214299,23/03/2022,0,0,0,5,5,0,0,10,5,5,10,1,0
"08063916",Escola Vila Parietes,Parets del Vallès,MVO,MVO,4230879,01/04/2022,0,0,0,0,9,0,0,9,0,9,9,7,2
"08063928",Escola Muntanyola,Muntanyola,CCE,CCE,4212191,22/03/2022,1,0,1,0,0,0,3,3,0,0,0,0,1
"08063931",Escola Les Falgueres,Fogars de la Selva,MVO,MVO,4213308,23/03/2022,1,0,1,9,1,0,0,10,9,1,10,9,1
"08063965",Escola Cau de la Guineu,Corbera de Llobregat,BLL,BLL,4222805,28/03/2022,0,0,0,9,0,0,0,9,3,0,3,9,3
"08064003",Institut Can Margarit,Corbera de Llobregat,BLL,BLL,4221540,28/03/2022,0,3,3,14,0,0,0,14,0,0,0,14,14
"08064027",Escola El Sol i La Lluna,Castellar del Vallès,VOC,VOC,4218948,25/03/2022,1,0,1,0,12,0,0,12,0,4,4,0,4
"08064076",Escola Rivo Rubeo,Rubí,VOC,VOC,4227212,30/03/2022,9,0,9,15,3,0,0,18,9,3,12,0,2
"08064088",Escola Mas Boadella,Sabadell,VOC,VOC,4214404,23/03/2022,1,0,1,20,0,0,0,20,20,0,20,20,5
"08064118",Escola Ciutat d'Alba,Sant Cugat del Vallès,VOC,VOC,4214073,23/03/2022,0,0,0,13,6,0,0,19,13,6,19,0,5
"08064143",Escola La Nova Electra,Terrassa,VOC,VOC,4226987,30/03/2022,1,0,1,19,2,0,0,21,19,2,21,15,7
"08064155",Institut Quatre Cantons,Barcelona,CEB,CEB,4224526,29/03/2022,0,0,0,17,0,0,0,17,17,0,17,17,1
"08064167",Escola Sant Martí,Barcelona,CEB,CEB,4230109,31/03/2022,1,1,2,0,0,0,2,2,0,2,2,1,1
"08064179",Escola La Llacuna del Poblenou,Barcelona,CEB,CEB,4223079,28/03/2022,0,0,0,18,0,0,0,18,18,0,18,18,4
"08064192",Institut Angeleta Ferrer,Barcelona,CEB,CEB,4223936,28/03/2022,2,0,2,8,0,0,0,8,0,0,0,0,0
"08064222",Escola La Roureda,Tordera,MVO,MVO,4230485,31/03/2022,1,2,3,17,0,0,0,17,17,0,17,17,4
"08064623",CFA Concepció Arenal,Barcelona,CEB,CEB,4213033,23/03/2022,0,0,0,1,0,1,0,2,2,0,2,1,0
"08064635",CFA Santiago Rusiñol,La Roca del Vallès,MVO,MVO,4225192,29/03/2022,0,0,0,3,0,0,0,3,0,0,0,3,1
"08064647",CFA Artur Martorell,Sant Esteve Sesrovires,BLL,BLL,4225452,29/03/2022,0,0,0,0,3,0,0,3,0,3,3,0,2
"08064659",CFA Salvador Dalí,La Roca del Vallès,MVO,MVO,4230383,31/03/2022,0,1,1,4,0,0,0,4,4,0,4,0,1
"08064738",Escola Dolors Piera,Vilafranca del Penedès,BCO,PEN,4227886,30/03/2022,2,19,21,13,6,0,0,19,6,0,6,13,6
"08064741",Escola Ítaca,Manresa,CCE,CCE,4225238,29/03/2022,3,0,3,4,2,1,0,7,2,2,4,5,6
"08064751",Escola Mar i Cel,Cubelles,BCO,PEN,4224834,29/03/2022,1,0,1,0,2,0,12,14,0,14,14,0,3
"08064787",Escola Emili Teixidor,Roda de Ter,CCE,CCE,4226847,30/03/2022,3,0,3,10,0,0,0,10,8,0,8,9,2
"08064805",Escola Els Quatre Vents,La Serra (Canovelles),MVO,MVO,4223266,28/03/2022,2,0,2,0,0,18,0,18,18,0,18,0,4
"08064817",Escola Camins,Corró d'Avall (Les Franqueses del Vallès),MVO,MVO,4227989,30/03/2022,0,5,5,11,0,5,2,18,0,2,2,12,4
"08064829",Escola Valldeneu,Sant Martí de Centelles,CCE,CCE,4214505,23/03/2022,0,0,0,1,0,1,0,2,2,0,2,2,1
"08064830",Institut Serra de Noet,Berga,CCE,CCE,4215901,24/03/2022,3,1,4,6,0,0,0,6,0,0,0,6,1
"08064854",Escola Martinet,Cornellà de Llobregat,BLL,BLL,4222835,28/03/2022,0,2,2,21,0,0,2,23,10,2,12,23,4
"08064866",Escola Dolors Martí i Badia,Igualada,CCE,PEN,4223539,28/03/2022,0,4,4,17,0,0,0,17,17,0,17,12,4
"08064881",Escola Campderrós,Vallirana,BLL,BLL,4218882,25/03/2022,0,0,0,5,8,0,0,13,5,8,13,5,4
"08064908",Institut Begues,Begues,BLL,BLL,4213443,23/03/2022,1,0,1,0,10,0,0,10,0,0,0,1,0
"08064911",Institut Valèria Haliné,Castelldefels,BLL,BLL,4213199,23/03/2022,0,0,0,11,0,0,0,11,0,1,1,10,0
"08064921",Institut de Sant Andreu,Sant Andreu de la Barca,BLL,BLL,4222098,28/03/2022,12,0,12,13,0,0,0,13,0,0,0,13,0
"08064945",Escola Mansuet,Collbató,BLL,BLL,4213722,23/03/2022,0,0,0,10,1,0,0,11,10,1,11,8,3
"08064970",Institut Nou de Vilafranca del Penedès,Vilafranca del Penedès,BCO,PEN,4222527,28/03/2022,2,0,2,10,6,0,0,16,0,0,0,0,18
"08064982",Escola de Sant Quirze Safaja - ZER El Moianès Llevant,Sant Quirze Safaja,CCE,CCE,4225480,29/03/2022,1,0,1,0,4,0,0,4,0,4,4,0,1
"08064994",Escola Maria-Mercè Marçal,Mataró,MVO,MVO,4227986,30/03/2022,0,0,0,18,0,0,0,18,18,0,18,18,2
"08065007",Escola Poblenou,Pineda de Mar,MVO,MVO,4212023,22/03/2022,1,8,9,3,1,0,0,4,0,0,0,4,2
"08065019",Institut de Vallbona d'Anoia,Vallbona d'Anoia,CCE,PEN,4217742,25/03/2022,0,0,0,0,8,0,0,8,0,8,8,0,0
"08065196",CFA La Pau,Barcelona,CEB,CEB,4228494,30/03/2022,0,2,2,2,4,0,0,6,2,4,6,6,1
"08065202",CFA Francesc Layret,Barcelona,CEB,CEB,4222770,28/03/2022,0,1,1,2,2,0,0,4,2,2,4,3,0
"08065238",Escola La Sagrera,El Rieral (Santa Eulàlia de Ronçana),MVO,MVO,4226810,30/03/2022,1,5,6,12,0,0,0,12,12,0,12,9,4
"08065251",Escola Pla del Puig,Sant Fruitós de Bages,CCE,CCE,4225886,29/03/2022,1,0,1,9,0,0,0,9,5,0,5,2,2
"08065263",Escola Puigsoler,Sant Vicenç de Castellet,CCE,CCE,4237704,06/04/2022,0,2,2,10,0,0,1,11,3,0,3,0,4
"08065275",Escola Volerany,Vilanova i la Geltrú,BCO,PEN,4230429,31/03/2022,0,1,1,12,4,1,1,18,5,5,10,12,4
"08065287",Escola Marta Mata,Mataró,MVO,MVO,4233833,04/04/2022,0,0,0,0,19,0,0,19,0,19,19,0,1
"08065299",Escola El Calderí,Caldes de Montbui,MVO,MVO,4231468,01/04/2022,1,4,5,0,9,0,0,9,0,3,3,11,0
"08065305",Escola Soler de Vilardell,Sant Celoni,MVO,MVO,4218095,25/03/2022,2,0,2,0,0,0,5,5,0,5,5,0,3
"08065329",Institut de l'Alt Foix,Sant Martí Sarroca,BCO,PEN,4229577,31/03/2022,0,5,5,1,1,12,0,14,0,1,1,15,0
"08065330",Institut Cal Gravat,Manresa,CCE,CCE,4218152,25/03/2022,11,2,13,15,1,2,0,18,17,1,18,18,12
"08065342",Institut Xaloc,Les Roquetes (Sant Pere de Ribes),BCO,PEN,4217284,24/03/2022,0,0,0,0,8,0,0,8,0,8,8,0,0
"08065354",Institut Baix a mar,Vilanova i la Geltrú,BCO,PEN,4231750,01/04/2022,0,0,0,19,1,0,0,20,0,1,1,0,0
"08065366",Institut de Pineda de Mar,Pineda de Mar,MVO,MVO,4216446,24/03/2022,22,3,25,4,1,4,0,9,8,1,9,2,0
"08065391",Institut El Til·ler,Corró d'Avall (Les Franqueses del Vallès),MVO,MVO,4231601,01/04/2022,3,2,5,20,8,0,0,28,0,0,0,20,0
"08065408",Institut Hipàtia d'Alexandria,Lliçà d'Amunt,MVO,MVO,4229271,31/03/2022,0,0,0,6,0,0,0,6,6,0,6,6,0
"08065411",Institut Aiguaviva,Mollet del Vallès,MVO,MVO,4230156,31/03/2022,3,0,3,9,7,0,0,16,9,7,16,3,16
"08065421",Institut Marta Mata,Montornès del Vallès,MVO,MVO,4224518,29/03/2022,0,0,0,14,3,0,0,17,0,0,0,0,16
"08065433",Institut La Sínia,Parets del Vallès,MVO,MVO,4226938,30/03/2022,0,0,0,0,15,0,0,15,0,2,2,0,12
"08065469",Institut Can Record,Sant Esteve de Palautordera,MVO,MVO,4212235,22/03/2022,0,0,0,12,5,0,0,17,12,5,17,15,5
"08065482",Escola Els Ventets - ZER El Moianès Llevant,Collsuspina,CCE,CCE,4229968,31/03/2022,1,0,1,0,0,2,0,2,2,0,2,0,1
"08065512",Escola Serra de l'Obac,Terrassa,VOC,VOC,4223680,28/03/2022,1,0,1,13,6,0,0,19,13,6,19,0,3
"08065652",EOI de l'Alt Penedès,Vilafranca del Penedès,BCO,PEN,4226265,29/03/2022,0,0,0,2,1,0,0,3,0,1,1,3,0
"08065664",EOI del Berguedà,Berga,CCE,CCE,4218527,25/03/2022,0,0,0,1,0,0,0,1,1,0,1,0,0
"08066048",Escola Roser Capdevila,Terrassa,VOC,VOC,4227480,30/03/2022,1,0,1,18,18,0,0,36,0,0,0,0,4
"08066322",Institut Cardener,Sant Joan de Vilatorrada,CCE,CCE,4231106,01/04/2022,0,0,0,8,0,0,0,8,0,0,0,8,0
"08066334",Escola La Serreta,Santpedor,CCE,CCE,4222114,28/03/2022,0,0,0,8,1,0,0,9,8,1,9,6,3
"08066413",Escola Colors,Bellavista (Les Franqueses del Vallès),MVO,MVO,4231457,01/04/2022,1,0,1,0,7,0,2,9,0,5,5,6,2
"08066437",Institut Mont Perdut,Terrassa,VOC,VOC,4218553,25/03/2022,1,0,1,0,30,0,0,30,0,30,30,30,0
"08066462",Escola dels Encants,Barcelona,CEB,CEB,4229449,31/03/2022,0,0,0,14,0,0,0,14,0,0,0,10,0
"08066504",Escola l'Univers,Barcelona,CEB,CEB,4231848,01/04/2022,1,0,1,2,0,0,1,3,2,1,3,2,4
"08066516",Escola Congrés-Indians,Barcelona,CEB,CEB,4230475,31/03/2022,0,0,0,3,3,0,0,6,3,3,6,0,4
"08066528",Institut Martí Pous,Barcelona,CEB,CEB,4229478,31/03/2022,5,0,5,15,0,1,0,16,0,0,0,0,1
"08066531",Escola Fluvià,Barcelona,CEB,CEB,4216730,24/03/2022,0,0,0,17,2,0,0,19,17,2,19,17,5
"08066541",Institut Maria Espinalt,Barcelona,CEB,CEB,4225651,29/03/2022,1,0,1,0,2,0,0,2,0,2,2,0,0
"08066565",Institut Joncar,Barcelona,CEB,CEB,4224142,28/03/2022,16,2,18,5,3,0,0,8,5,3,8,0,11
"08066851",EOI de Mollet del Vallès,Mollet del Vallès,MVO,MVO,4230281,31/03/2022,0,0,0,8,0,0,0,8,0,0,0,8,0
"08066887",EOI de Viladecans,Viladecans,BLL,BLL,4221659,28/03/2022,0,0,0,10,2,0,0,12,0,2,2,7,2
"08066905",Institut Viladomat,Barcelona,CEB,CEB,4225865,29/03/2022,17,4,21,5,0,0,0,5,0,0,0,9,0
"08067016",Escola Ernest Lluch,L'Hospitalet de Llobregat,BCO,BCO,4233286,04/04/2022,1,0,1,8,0,0,1,9,6,0,6,8,1
"08067041",Escola Xoriguer,Centelles,CCE,CCE,4214382,23/03/2022,1,1,2,3,6,0,0,9,0,0,0,9,1
"08067090",Escola Can Manent,Cardedeu,MVO,MVO,4230786,01/04/2022,0,0,0,0,0,2,1,3,2,1,3,0,4
"08067120",Escola Santa Agnès de Malanyanes,Santa Agnès de Malanyanes (La Roca del Vallès),MVO,MVO,4231771,01/04/2022,5,1,6,3,0,0,0,3,0,3,3,5,1
"08067132",Escola Josefina Ibáñez,Abrera,BLL,BLL,4227160,30/03/2022,2,0,2,0,0,0,9,9,0,9,9,0,1
"08067144",Institut de Cervelló,Cervelló,BLL,BLL,4213516,23/03/2022,1,4,5,0,7,0,7,14,0,0,0,14,0
"08067181",Escola de Rellinars,Rellinars,VOC,VOC,4216620,24/03/2022,1,0,1,6,0,0,0,6,6,0,6,6,2
"08067193",Escola del Bosc,Rubí,VOC,VOC,4216277,24/03/2022,0,0,0,0,10,0,0,10,0,10,10,0,2
"08067201",Escola Lola Anglada,Sant Quirze del Vallès,VOC,VOC,4225507,29/03/2022,0,0,0,15,2,0,0,17,5,2,7,18,4
"08067211",Institut Salas i Xandri,Sant Quirze del Vallès,VOC,VOC,4225263,29/03/2022,0,0,0,4,2,1,1,8,5,3,8,4,0
"08067235",Escola Roc Alabern,Terrassa,VOC,VOC,4213110,23/03/2022,1,3,4,18,1,0,0,19,6,1,7,19,5
"08067247",Escola El Vapor,Terrassa,VOC,VOC,4213341,23/03/2022,0,0,0,19,0,0,0,19,11,0,11,19,0
"08067430",Escola Montserrat Solà,Mataró,MVO,MVO,4231482,01/04/2022,1,5,6,0,16,0,0,16,0,0,0,5,8
"08067582",Escola Marta Mata,Barberà del Vallès,VOC,VOC,4228094,30/03/2022,0,0,0,8,2,0,0,10,4,1,5,14,3
"08067594",Institut Escola Les Vinyes,Castellbisbal,VOC,VOC,4230968,01/04/2022,22,4,26,17,5,2,0,24,4,3,7,0,0
"08067600",Escola Valldaura,Manresa,CCE,CCE,4227180,30/03/2022,0,1,1,6,0,0,0,6,3,0,3,0,2
"08067636",Institut Manresa Sis,Manresa,CCE,CCE,4228708,31/03/2022,4,0,4,0,2,0,8,10,0,0,0,8,0
"08067648",Institut Les Vinyes,Cubelles,BCO,PEN,4231340,01/04/2022,0,0,0,17,0,0,0,17,0,0,0,17,0
"08067661",Escola Joan Coromines,Mataró,MVO,MVO,4231699,01/04/2022,0,1,1,12,0,0,1,13,0,0,0,4,2
"08067752",Institut Sagrera Sant Andreu,Barcelona,CEB,CEB,4218481,25/03/2022,10,0,10,0,1,0,5,6,0,0,0,0,3
"08067764",Escola La Maquinista,Barcelona,CEB,CEB,4216407,24/03/2022,0,0,0,0,0,0,6,6,0,0,0,0,0
"08067818",Escola La Sínia,Vic,CCE,CCE,4215843,24/03/2022,0,0,0,0,18,0,0,18,0,18,18,0,4
"08068136",CFA Víctor Català,Sant Esteve Sesrovires,BLL,BLL,4215814,24/03/2022,0,0,0,0,4,0,0,4,0,4,4,0,0
"08068331",Escola Badalona Port,Badalona,BCO,BCO,4213473,23/03/2022,0,0,0,0,9,0,0,9,0,9,9,0,2
"08068343",Escola Les Ciències,Badalona,BCO,BCO,4222589,28/03/2022,1,0,1,8,1,0,0,9,3,1,4,8,1
"08068379",Escola Mar Nova,Premià de Mar,MVO,MVO,4230073,31/03/2022,1,0,1,0,0,0,0,0,0,1,1,0,1
"08068380",Institut Gurb,Gurb,CCE,CCE,4225053,29/03/2022,0,0,0,0,12,0,0,12,0,4,4,0,0
"08068410",Escola Palau d'Ametlla,Montornès del Vallès,MVO,MVO,4214026,23/03/2022,2,0,2,9,0,0,0,9,5,0,5,9,2
"08068495",Institut Josefina Castellví i Piulachs,Viladecans,BLL,BLL,4228866,31/03/2022,0,0,0,15,2,0,0,17,15,2,17,2,2
"08068537",Institut Les Aimerigues,Terrassa,VOC,VOC,4229359,31/03/2022,2,1,3,22,0,0,0,22,6,0,6,22,0
"08068616",Institut Bages Sud,El Borràs (Castellbell i el Vilar),CCE,CCE,4229394,31/03/2022,1,6,7,0,0,8,0,8,6,2,8,6,2
"08069499",Escola Vic-centre,Vic,CCE,CCE,4231278,01/04/2022,0,0,0,5,4,0,0,9,2,4,6,4,1
"08069581",CFA Carme Karr,Sant Joan de Vilatorrada,CCE,CCE,4230675,31/03/2022,0,0,0,2,0,4,0,6,4,2,6,1,0
"08069736",Escola Paco Candel,L'Hospitalet de Llobregat,BCO,BCO,4229990,31/03/2022,0,0,0,18,0,0,0,18,18,0,18,18,0
"08069748",Escola Montigalà,Badalona,BCO,BCO,4229040,31/03/2022,2,6,8,0,0,9,0,9,9,0,9,2,3
"08069751",Escola Santa Coloma,Santa Coloma de Gramenet,BCO,BCO,4227857,30/03/2022,1,10,11,0,9,0,0,9,0,9,9,2,2
"08070143",Escola Riera Alta,Santa Coloma de Gramenet,BCO,BCO,4231400,01/04/2022,3,0,3,18,0,0,0,18,14,0,14,18,2
"08070234",Escola Can Fabra,Barcelona,CEB,CEB,4231343,01/04/2022,0,0,0,18,0,0,0,18,6,0,6,16,4
"08070799",Escola Tiziana,Tiana,MVO,MVO,4222380,28/03/2022,1,0,1,8,1,1,0,10,3,1,4,5,1
"08070908",Institut Escola La Tordera,Santa Maria de Palautordera,MVO,MVO,4223546,28/03/2022,0,0,0,19,0,0,0,19,6,0,6,19,2
"08071020",Escola Enxaneta,Viladecans,BLL,BLL,4218134,25/03/2022,1,0,1,0,11,0,0,11,0,11,11,0,4
"08071147",Escola Roser Capdevila,Sant Joan Despí,BLL,BLL,4217749,25/03/2022,5,1,6,10,0,0,0,10,6,0,6,10,4
"08071196",Institut Can Roca,Terrassa,VOC,VOC,4230897,01/04/2022,3,0,3,18,0,3,0,21,21,0,21,20,0
"08071214",Institut Escola Castellterçol,Castellterçol,CCE,CCE,4213868,23/03/2022,0,0,0,14,0,0,0,14,0,0,0,0,8
"08071226",Institut Escola Costa i Llobera,Barcelona,CEB,CEB,4227934,30/03/2022,0,0,0,24,1,5,0,30,17,1,18,30,4
"08071238",Institut Escola Jacint Verdaguer,Sant Sadurní d'Anoia,BCO,PEN,4229488,31/03/2022,3,0,3,30,0,0,0,30,6,0,6,30,6
"08071691",Institut Escola del Prat,El Prat de Llobregat,BLL,BLL,4222936,28/03/2022,1,5,6,12,1,0,0,13,12,1,13,11,6
"08072176",Institut del Ter,Manlleu,CCE,CCE,4229300,31/03/2022,1,16,17,0,13,0,0,13,0,13,13,13,10
"08072188",Institut Escola Sant Jordi,Navàs,CCE,CCE,4225884,29/03/2022,0,8,8,6,0,0,17,23,6,17,23,20,2
"08072255",Institut Premià de Mar,Premià de Mar,MVO,MVO,4223061,28/03/2022,0,2,2,4,2,0,0,6,4,2,6,2,0
"08072292",Institut Escola Turó de Roquetes,Barcelona,CEB,CEB,4229828,31/03/2022,2,0,2,0,30,0,0,30,0,0,0,0,8
"08072310",Institut Escola Rec Comtal,Barcelona,CEB,CEB,4223197,28/03/2022,7,2,9,0,21,0,0,21,0,13,13,14,12
"08072383",Institut Domus d'Olivet,La Serra (Canovelles),MVO,MVO,4227753,30/03/2022,0,0,0,0,0,0,8,8,0,8,8,2,1
"08072401",Institut Torrent dels Alous,Rubí,VOC,VOC,4226757,30/03/2022,3,0,3,21,0,0,0,21,21,0,21,8,0
"08072589",EOI Barcelona-Guinardó,Barcelona,CEB,CEB,4214634,23/03/2022,0,12,12,0,0,0,0,0,0,0,0,0,1
"08072590",EOI de Rubí,Rubí,VOC,VOC,4234175,04/04/2022,5,0,5,0,0,1,0,1,0,0,0,0,0
"08072607",EOI de Cornellà de Llobregat,Cornellà de Llobregat,BLL,BLL,4212248,22/03/2022,0,3,3,10,0,0,0,10,0,0,0,10,0
"08072978",Institut Sunsi Móra,Canet de Mar,MVO,MVO,4225163,29/03/2022,0,0,0,11,0,0,0,11,11,0,11,5,1
"08073028",Institut de Sant Pol de Mar,Sant Pol de Mar,MVO,MVO,4222605,28/03/2022,0,0,0,19,0,7,0,26,0,0,0,15,0
"08073031",Institut Neus Català,Cornellà de Llobregat,BLL,BLL,4234559,04/04/2022,0,0,0,6,0,0,2,8,0,2,2,6,2
"08073077",Institut Maria Canela,Martorell,BLL,BLL,4218678,25/03/2022,0,0,0,5,3,1,0,9,0,0,0,3,9
"08073119",Institut Can Periquet,Palau-solità i Plegamans,VOC,VOC,4227768,30/03/2022,2,0,2,7,1,0,0,8,0,0,0,10,1
"08073171",Institut La Riera,Badalona,BCO,BCO,4226937,30/03/2022,2,0,2,3,3,0,0,6,3,0,3,0,2
"08073193",Institut Badia i Margarit,Igualada,CCE,PEN,4216763,24/03/2022,1,6,7,10,2,0,0,12,8,0,8,8,6
"08073651",Institut Pic del Vent,Caldes de Montbui,MVO,MVO,4229637,31/03/2022,0,0,0,2,0,2,0,4,0,0,0,0,10
"08073843",Institut Tordària,Tordera,MVO,MVO,4213651,23/03/2022,0,0,0,11,3,0,0,14,11,3,14,10,1
"08073958",Escola Nova d'Argentona,Argentona,MVO,MVO,4215885,24/03/2022,0,5,5,0,0,16,1,17,16,1,17,16,2
"08073961",Institut Pla del Bosc,Canyelles,BCO,PEN,4234701,04/04/2022,0,4,4,0,0,13,0,13,13,0,13,12,1
"08074070",EOI de Calella,Calella,MVO,MVO,4223130,28/03/2022,0,0,0,2,4,0,0,6,0,0,0,2,0
"08074380",Escola Castell de Dosrius,Dosrius,MVO,MVO,4212846,23/03/2022,0,19,19,9,1,4,0,14,13,1,14,13,1
"08074410",Institut La Serra,Sabadell,VOC,VOC,4229563,31/03/2022,0,0,0,0,0,0,5,5,0,5,5,0,4
"08074628",Institut El Prat de Llobregat,El Prat de Llobregat,BLL,BLL,4231388,01/04/2022,10,0,10,0,0,3,1,4,0,0,0,0,0
"08074631",Institut Les Salines,El Prat de Llobregat,BLL,BLL,4213098,23/03/2022,0,0,0,37,3,0,0,40,37,3,40,0,0
"08074641",Escola Els 30 Passos,Barcelona,CEB,CEB,4216865,24/03/2022,0,0,0,0,5,0,0,5,0,5,5,0,0
"08074801",Institut Marta Estrada,Granollers,MVO,MVO,4229884,31/03/2022,0,0,0,8,0,0,0,8,8,0,8,8,0
"08074811",Escola Turó de Can Gili,Granollers,MVO,MVO,4227006,30/03/2022,1,0,1,7,4,0,0,11,7,3,10,10,3
"08074823",Escola Els Picots,Lliçà d'Amunt,MVO,MVO,4212079,22/03/2022,1,0,1,6,11,0,0,17,6,11,17,18,6
"08074835",Escola Jaume Llull,Sant Andreu de Llavaneres,MVO,MVO,4230069,31/03/2022,0,0,0,17,0,0,0,17,17,0,17,17,4
"08074847",Institut de Nàutica de Barcelona,Barcelona,CEB,CEB,4230253,31/03/2022,0,1,1,0,5,0,0,5,0,5,5,4,0
"08075074",Institut de Santa Coloma de Gramenet,Santa Coloma de Gramenet,BCO,BCO,4226916,30/03/2022,10,0,10,0,4,0,2,6,0,0,0,0,1
"08075207",Escola Entença,Barcelona,CEB,CEB,4227996,30/03/2022,0,0,0,0,0,0,0,0,0,0,0,0,2
"08075244",Escola Les Bases,Manresa,CCE,CCE,4230084,31/03/2022,1,0,1,0,0,0,2,2,0,0,0,0,2
"08075256",Institut Escola Marta Mata,Torelló,CCE,CCE,4235942,05/04/2022,0,0,0,0,17,0,10,27,0,10,10,0,1
"08075268",Escola La Mirada,Sant Cugat del Vallès,VOC,VOC,4236127,05/04/2022,6,0,6,0,17,0,0,17,0,17,17,0,1
"08075281",Institut Bitàcola,Barberà del Vallès,VOC,VOC,4231856,01/04/2022,1,3,4,10,1,0,0,11,4,1,5,11,0
"08075293",Institut Escola Gavà Mar,Gavà,BLL,BLL,4227500,30/03/2022,5,16,21,0,0,23,2,25,0,0,0,16,12
"08075384",Institut Escola La Mina,Sant Adrià de Besòs,BCO,BCO,4227992,30/03/2022,1,5,6,24,6,0,0,30,0,0,0,30,16
"08075608",Escola 9 Graons,Barcelona,CEB,CEB,4224671,29/03/2022,5,0,5,0,1,2,7,10,0,0,0,0,4
"08075611",Escola Gaia,Barcelona,CEB,CEB,4230965,01/04/2022,1,0,1,0,1,0,0,1,0,0,0,0,0
"08075621",Escola Teixidores de Gràcia,Barcelona,CEB,CEB,4213690,23/03/2022,2,0,2,0,0,0,0,0,0,0,0,1,1
"08075633",Escola Anglesola,Barcelona,CEB,CEB,4224990,29/03/2022,6,0,6,0,0,0,0,0,0,0,0,0,0
"08075645",Escola La Flor de Maig,Barcelona,CEB,CEB,4230563,31/03/2022,2,0,2,4,6,0,0,10,4,6,10,1,1
"08075657",Institut Escola Antaviana,Barcelona,CEB,CEB,4213718,23/03/2022,6,4,10,4,1,12,3,20,0,0,0,12,0
"08075669",Institut Escola El Til·ler,Barcelona,CEB,CEB,4216520,24/03/2022,3,0,3,9,7,0,0,16,0,0,0,12,4
"08075670",Institut Escola Trinitat Nova,Barcelona,CEB,CEB,4237479,05/04/2022,0,0,0,0,0,12,0,12,0,0,0,8,6
"08075682",Institut Olímpia,Viladecans,BLL,BLL,4230928,01/04/2022,6,0,6,0,12,0,0,12,0,12,12,3,1
"08075700",Escola Xirinacs,Barcelona,CEB,CEB,4238627,06/04/2022,0,0,0,0,0,0,3,3,0,3,3,0,0
"08075712",Institut Les Cinc Sénies,Mataró,MVO,MVO,4231196,01/04/2022,6,0,6,0,0,0,11,11,0,0,0,0,0
"08075724",Escola Norai,Montgat,MVO,MVO,4214681,23/03/2022,3,0,3,1,0,0,0,1,0,0,0,1,0
"08076078",Escola Auditori,Barcelona,CEB,CEB,4236733,05/04/2022,4,0,4,6,0,0,0,6,2,0,2,0,1
"08076091",Institut Ca n'Oriac,Sabadell,VOC,VOC,4229742,31/03/2022,9,8,17,0,0,0,0,0,0,7,7,0,1
"08076108",Institut Jaume Cabré,Terrassa,VOC,VOC,4219606,26/03/2022,8,0,8,2,0,0,0,2,0,0,0,0,0
"08076111",Institut Jaume Botey,L'Hospitalet de Llobregat,BCO,BCO,4228024,30/03/2022,3,0,3,3,4,0,4,11,0,0,0,0,1
"08076145",Institut Escola Mar Mediterrània,Mataró,MVO,MVO,4226913,30/03/2022,5,2,7,10,0,0,0,10,10,0,10,10,2
"08076157",Institut Escola Àngela Bransuela,Mataró,MVO,MVO,4227648,30/03/2022,5,4,9,12,3,0,0,15,4,2,6,10,12
"08076169",Institut Escola Gornal,L'Hospitalet de Llobregat,BCO,BCO,4231393,01/04/2022,4,4,8,5,0,0,0,5,4,0,4,9,3
"08076194",Institut Tecnològic de Barcelona,Barcelona,CEB,CEB,4224738,29/03/2022,0,0,0,0,12,0,0,12,0,12,12,0,0
"08076391",Institut Pedralbes,Barcelona,CEB,CEB,4226993,30/03/2022,0,0,0,30,16,0,0,46,12,0,12,0,2
"08076406",Institut Narcisa Freixas i Cruells,Sabadell,VOC,VOC,4236119,05/04/2022,6,0,6,0,6,0,0,6,0,6,6,0,4
"08076421",Institut Escola Pepa Colomer,El Prat de Llobregat,BLL,BLL,4222488,28/03/2022,8,6,14,15,0,0,2,17,0,0,0,12,3
"08076431",Institut Escola Baldomer Solà,Badalona,BCO,BCO,4230114,31/03/2022,5,16,21,10,0,0,0,10,10,0,10,10,2
"08076443",Institut Escola Rafael Alberti,Badalona,BCO,BCO,4213779,23/03/2022,5,0,5,0,19,0,0,19,4,0,4,15,12
"08076455",Institut Escola Sant Jordi,Badalona,BCO,BCO,4226943,30/03/2022,5,0,5,0,8,0,0,8,0,8,8,0,6
"08076467",Institut Escola Pere Lliscart,L'Hospitalet de Llobregat,BCO,BCO,4217875,25/03/2022,8,2,10,0,17,0,0,17,0,17,17,0,13
"08076479",Institut Escola Sant Quintí de Mediona,Sant Quintí de Mediona,BCO,PEN,4212792,23/03/2022,1,0,1,3,3,0,0,6,0,0,0,0,4
"08076480",Institut Escola Pallaresa,Santa Coloma de Gramenet,BCO,BCO,4230955,01/04/2022,5,0,5,17,0,0,0,17,6,0,6,17,3
"08076492",Institut Escola Pompeu Fabra,El Pont de Vilomara i Rocafort,CCE,CCE,4225051,29/03/2022,6,0,6,18,2,0,0,20,18,2,20,18,6
"08076509",Institut Escola Arts,Barcelona,CEB,CEB,4234541,04/04/2022,4,0,4,0,5,1,9,15,1,14,15,0,10
"08076510",Institut Escola Pla de l'Avellà,Cabrera de Mar,MVO,MVO,4226786,30/03/2022,6,0,6,0,23,0,0,23,0,23,23,22,6
"08076522",Institut Escola Pallerola,Sant Celoni,MVO,MVO,4212917,23/03/2022,2,0,2,14,6,1,0,21,6,5,11,18,2
"08076534",Institut Escola Montagut,Santa Susanna,MVO,MVO,4227937,30/03/2022,7,2,9,10,2,0,0,12,5,0,5,4,5
"08076546",Institut Escola Can Llobet,Barberà del Vallès,VOC,VOC,4230268,31/03/2022,4,0,4,6,17,0,0,23,6,17,23,4,9
"08076558",Institut Escola Sant Esteve,Castellar del Vallès,VOC,VOC,4229390,31/03/2022,9,0,9,13,2,0,0,15,13,2,15,0,4
"08076561",Institut Escola El Viver,Montcada i Reixac,VOC,VOC,4223940,28/03/2022,6,0,6,23,1,0,0,24,1,0,1,16,4
"08076571",Institut Escola El Martinet,Ripollet,VOC,VOC,4222537,28/03/2022,2,0,2,0,4,0,0,4,0,4,4,0,3
"08076583",Institut Escola Els Pinetons,Ripollet,VOC,VOC,4230943,01/04/2022,8,0,8,2,3,0,0,5,0,0,0,0,0
"08076595",Institut Escola Teresa Altet,Rubí,VOC,VOC,4231841,01/04/2022,4,0,4,0,17,0,0,17,0,0,0,0,6
"08076601",Institut Escola Pere Viver,Terrassa,VOC,VOC,4223620,28/03/2022,5,0,5,20,4,0,0,24,6,0,6,20,10
"08076613",Institut Escola Barnola,Avinyó,CCE,CCE,4213899,23/03/2022,3,0,3,0,0,0,10,10,0,10,10,7,4
"08076637",Institut FP Sant Cugat del Vallès,Sant Cugat del Vallès,VOC,VOC,4235780,05/04/2022,0,6,6,1,11,9,0,21,0,0,0,0,8
"08076649",Institut de Jardineria i Agricultura Les Garberes,Castellar del Vallès,VOC,VOC,4221792,28/03/2022,0,0,0,1,0,0,1,2,1,1,2,0,2
"08076650",CFA Sant Adrià de Besòs,Sant Adrià de Besòs,BCO,BCO,4232008,01/04/2022,0,0,0,0,0,0,0,0,0,0,0,0,0
"08076820",Institut Escola Sala i Badrinas,Terrassa,VOC,VOC,4228296,30/03/2022,4,3,7,22,1,0,0,23,22,1,23,18,4
"08076893",Institut Vilafranca 2,Vilafranca del Penedès,BCO,PEN,4228105,30/03/2022,4,0,4,0,5,0,2,7,0,0,0,0,2
"08076901",Institut Escola Turó d'en Caritg,Badalona,BCO,BCO,4231448,01/04/2022,3,6,9,0,26,0,0,26,0,26,26,0,11
"08076923",Institut Escola Llibertat,Badalona,BCO,BCO,4226816,30/03/2022,3,0,3,0,0,18,0,18,18,0,18,21,6
"08076935",Institut Escola Puig i Gairalt,L'Hospitalet de Llobregat,BCO,BCO,4213601,23/03/2022,2,0,2,21,0,0,0,21,21,0,21,24,9
"08076947",Institut Escola Lluís Millet,Santa Coloma de Gramenet,BCO,BCO,4227572,30/03/2022,3,1,4,6,0,1,1,8,5,0,5,6,1
"08076959",Institut Escola Carles Capdevila,Els Hostalets de Balenyà (Balenyà),CCE,CCE,4212955,23/03/2022,8,17,25,0,0,0,15,15,0,0,0,12,8
"08076960",Institut Escola Renaixença,Els Hostalets de Pierola,CCE,PEN,4231294,01/04/2022,4,0,4,0,12,0,5,17,0,17,17,13,4
"08076972",Institut Escola Piera,Piera,CCE,PEN,4233701,04/04/2022,0,0,0,27,0,0,0,27,27,0,27,52,13
"08076984",Institut Escola Josep Maria Xandri,Sant Pere de Torelló,CCE,CCE,4227975,30/03/2022,1,0,1,0,1,0,3,4,0,4,4,3,1
"08076996",Institut Escola Mossen Cinto,Folgueroles,CCE,CCE,4229519,31/03/2022,4,0,4,4,0,0,0,4,1,0,1,4,2
"08077009",Institut Escola Castell d'Òdena,Òdena,CCE,PEN,4231739,01/04/2022,4,1,5,6,0,0,0,6,6,0,6,0,2
"08077010",Institut Escola Coves d'en Cimany,Barcelona,CEB,CEB,4218127,25/03/2022,4,0,4,0,0,3,1,4,0,0,0,0,5
"08077022",Institut Escola Els Tres Pins,Vallromanes,MVO,MVO,4229323,31/03/2022,1,0,1,15,0,0,0,15,3,0,3,15,8
"08077034",Institut Escola El Pi Gros,Sant Cebrià de Vallalta,MVO,MVO,4223301,28/03/2022,3,0,3,17,0,0,0,17,17,0,17,8,8
"08077046",Institut Escola Joan Sallarès i Pla,Sabadell,VOC,VOC,4213368,23/03/2022,4,0,4,0,0,0,13,13,0,7,7,0,7
"08077058",Institut Escola Catalunya,Sant Cugat del Vallès,VOC,VOC,4216600,24/03/2022,4,2,6,25,1,2,0,28,8,0,8,20,8
"08077061",Institut Escola Onze de Setembre,Sant Quirze del Vallès,VOC,VOC,4213264,23/03/2022,3,5,8,7,0,0,0,7,7,0,7,7,6
"08077071",Institut Escola Mas Rampinyo,Montcada i Reixac,VOC,VOC,4229161,31/03/2022,5,0,5,2,2,0,0,4,2,2,4,0,1
"08077083",Institut Vapor del Fil,Barcelona,CEB,CEB,4225457,29/03/2022,5,1,6,0,0,0,4,4,0,0,0,0,2
"08077095",Institut Escola Mirades,Barcelona,CEB,CEB,4218914,25/03/2022,4,12,16,19,5,0,2,26,19,7,26,26,6
"08077101",Institut Escola Tres Fonts de les Corts,Barcelona,CEB,CEB,4227051,30/03/2022,4,0,4,0,9,0,9,18,0,18,18,5,6
"08077113",Escola Voltregà,Sant Hipòlit de Voltregà,CCE,CCE,4230052,31/03/2022,0,2,2,4,11,0,0,15,0,0,0,0,4
"08077125",Institut Escola Antoni Ubach i Soler,Terrassa,VOC,VOC,4223262,28/03/2022,3,0,3,0,14,0,0,14,0,6,6,0,8
"08077137",Institut de l'Esport de Barcelona,Barcelona,CEB,CEB,4227854,30/03/2022,1,0,1,25,0,5,0,30,0,0,0,0,3
"08077149",Institut Escola Eixample,Barcelona,CEB,CEB,4225178,29/03/2022,2,0,2,0,1,4,2,7,0,0,0,4,2
"08077162",Escola Ateneu Igualadí,Igualada,CCE,PEN,4227715,30/03/2022,2,0,2,8,4,0,0,12,8,4,12,9,3
"08077174",Institut La Vall de Tenes,"Sagrera, la (Santa Eulàlia de Ronçana)",MVO,MVO,4229710,31/03/2022,7,0,7,29,0,2,0,31,0,0,0,8,0
"08077228",Institut Professional de Turisme Eqüestre del Maresme,Santa Susanna,MVO,MVO,4212808,23/03/2022,2,0,2,0,0,0,3,3,0,3,3,0,0
"08077356",Escola Les Filadores,Sentmenat,VOC,VOC,4228004,30/03/2022,0,0,0,0,0,1,0,1,1,0,1,0,0
"08077371",Institut Escola El Morsell,Olivella,BCO,PEN,4222400,28/03/2022,1,0,1,1,1,0,0,2,1,1,2,0,3
"08077381",Institut Escola Virolet,Sabadell,VOC,VOC,4225805,29/03/2022,5,0,5,22,0,0,0,22,0,0,0,0,4
"08077393",Institut Escola Lluís Millet,El Masnou,MVO,MVO,4213880,23/03/2022,3,1,4,18,0,0,0,18,0,0,0,18,2
"08077401",Institut Escola Guillem de Balsareny,Balsareny,CCE,CCE,4213043,23/03/2022,2,0,2,9,0,0,1,10,9,1,10,13,1
"08077435",Institut dels Aliments de Barcelona,Barcelona,CEB,CEB,4228351,30/03/2022,0,3,3,0,11,0,0,11,0,11,11,0,5
"08077447",Institut de formació professional Antoni Algueró,Sant Just Desvern,BLL,BLL,4221083,27/03/2022,2,0,2,0,12,0,0,12,0,12,12,0,3
"08077459",Institut Escola Santiga,Santa Perpètua de Mogoda,VOC,VOC,4229440,31/03/2022,2,5,7,14,0,0,0,14,14,4,18,24,5
"08077460",Institut Escola Santa Anna,Premià de Dalt,MVO,MVO,4224613,29/03/2022,15,0,15,11,1,1,0,13,12,1,13,10,6
"08077472",Institut Escola Intermunicipal del Penedès,Sant Sadurní d'Anoia,BCO,PEN,4232642,03/04/2022,2,4,6,33,0,0,0,33,0,0,0,33,0
"08077484",Institut Escola Elisabets,Barcelona,CEB,CEB,4225722,29/03/2022,12,0,12,0,1,0,0,1,0,1,1,0,3
"08077496",Institut Escola Sicília,Barcelona,CEB,CEB,4227881,30/03/2022,7,0,7,6,0,0,0,6,2,0,2,6,4
"08077502",Institut Escola Londres,Barcelona,CEB,CEB,4224819,29/03/2022,0,0,0,0,0,0,0,0,0,0,0,0,8
"08077514",Escola Aldana,Barcelona,CEB,CEB,4238118,06/04/2022,0,0,0,1,0,3,5,9,4,5,9,0,2
"08077939",Escola de la Vila,Polinyà,VOC,VOC,4233399,04/04/2022,2,0,2,18,2,0,0,20,18,2,20,6,7
"08077976",Institut Miquel Biada,Mataró,MVO,MVO,4231688,01/04/2022,0,0,0,12,40,0,0,52,12,40,52,0,0
"17000019",Escola Lluís Marià Vidal,Agullana,GIR,GIR,4229317,31/03/2022,1,0,1,0,0,3,2,5,3,2,5,2,1
"17000032",Escola Vilademany,Aiguaviva,GIR,GIR,4211861,22/03/2022,1,0,1,4,3,0,0,7,4,3,7,2,2
"17000056",Escola la Branca - ZER Montgrí,Albons,GIR,GIR,4215658,24/03/2022,1,4,5,0,0,0,1,1,0,1,1,0,1
"17000068",Escola del Far d'Empordà,El Far d'Empordà,GIR,GIR,4213666,23/03/2022,1,1,2,0,3,0,0,3,0,0,0,2,2
"17000071",Escola Bac de Cerdanya,Alp,GIR,APA,4222764,28/03/2022,1,0,1,7,0,0,0,7,7,0,7,0,1
"17000093",Escola Gaspar de Queralt,Amer,GIR,GIR,4214031,23/03/2022,0,0,0,9,1,0,0,10,4,1,5,9,2
"17000123",Escola Sant Jordi,Bonmatí (Sant Julià del Llor i Bonmatí),GIR,GIR,4225175,29/03/2022,1,0,1,1,0,1,0,2,2,0,2,0,1
"17000135",Escola Pompeu Fabra,Anglès,GIR,GIR,4222747,28/03/2022,0,0,0,6,18,0,0,24,0,6,6,6,2
"17000160",Escola Doctor Carulla,Arbúcies,GIR,GIR,4215806,24/03/2022,0,3,3,19,0,2,2,23,21,2,23,30,4
"17000241",Escola Fluvianets,L'Armentera,GIR,GIR,4217848,25/03/2022,2,1,3,0,0,0,2,2,0,2,2,0,0
"17000251",Escola Gonçal Comellas,Avinyonet de Puigventós,GIR,GIR,4227182,30/03/2022,1,3,4,6,0,0,0,6,3,0,3,0,1
"17000263",Escola Doctor Arruga,Begur,GIR,GIR,4212074,22/03/2022,0,0,0,9,0,0,0,9,5,0,5,9,3
"17000305",Institut Pere Alsius i Torrent,Banyoles,GIR,GIR,4229549,31/03/2022,1,0,1,20,0,0,0,20,0,0,0,0,20
"17000329",Escola Pla de l'Ametller,Banyoles,GIR,GIR,4215895,24/03/2022,0,0,0,18,0,0,0,18,18,0,18,9,4
"17000330",Institut Josep Brugulat,Banyoles,GIR,GIR,4228960,31/03/2022,1,0,1,15,14,0,0,29,15,14,29,13,0
"17000342",Escola de la Vila Baldiri Reixac,Banyoles,GIR,GIR,4222719,28/03/2022,0,0,0,21,0,0,0,21,21,0,21,21,4
"17000354",Escola Joan Reglà,Bàscara,GIR,GIR,4212098,22/03/2022,1,1,2,7,0,0,0,7,0,0,0,7,3
"17000381",Escola El Rajaret - ZER Montgrí,Bellcaire d'Empordà,GIR,GIR,4229701,31/03/2022,2,3,5,0,0,0,0,0,0,0,0,0,1
"17000408",Escola Doctor Sobrequés,Bescanó,GIR,GIR,4228083,30/03/2022,1,0,1,22,1,0,0,23,5,1,6,19,6
"17000411",Escola Joan de Margarit,La Bisbal d'Empordà,GIR,GIR,4216303,24/03/2022,0,1,1,11,1,0,0,12,4,0,4,15,11
"17000469",Escola Joaquim Ruyra,Blanes,GIR,GIR,4213557,23/03/2022,0,0,0,9,0,0,0,9,4,0,4,6,2
"17000470",Escola Carles Faust,Blanes,GIR,GIR,4227045,30/03/2022,1,2,3,8,0,0,0,8,8,0,8,5,2
"17000548",Escola Mossèn Joan Batlle,Blanes,GIR,GIR,4213664,23/03/2022,0,0,0,13,0,0,0,13,13,0,13,13,4
"17000551",Institut Sa Palomera,Blanes,GIR,GIR,4228313,30/03/2022,1,0,1,5,1,0,0,6,5,1,6,0,0
"17000561",Escola de Bordils,Bordils,GIR,GIR,4222068,28/03/2022,0,0,0,0,5,0,5,10,0,0,0,0,1
"17000573",Escola Sant Andreu de Borrassà,Borrassà,GIR,GIR,4215995,24/03/2022,2,2,4,0,2,0,0,2,0,2,2,2,1
"17000603",Escola Santa Cecília - ZER Les Salines,Boadella i les Escaules,GIR,GIR,4223575,28/03/2022,2,0,2,0,0,1,1,2,1,1,2,1,1
"17000676",Escola Sant Esteve,Caldes de Malavella,GIR,GIR,4214520,23/03/2022,0,4,4,15,0,0,0,15,2,0,2,0,4
"17000688",Escola Pere Rosselló,Calonge (Calonge i Sant Antoni),GIR,GIR,4214509,23/03/2022,8,0,8,6,1,7,1,15,13,2,15,14,4
"17000706",Institut Puig Cargol,Calonge (Calonge i Sant Antoni),GIR,GIR,4214717,23/03/2022,1,0,1,0,0,19,0,19,19,0,19,0,0
"17000718",Escola Llevantí de Mar,Sant Antoni de Calonge (Calonge i Sant Antoni),GIR,GIR,4214011,23/03/2022,0,1,1,9,0,0,0,9,9,0,9,9,2
"17000731",Escola Pirineu,Campdevànol,GIR,GIR,4224835,29/03/2022,0,12,12,7,0,0,0,7,5,2,7,6,2
"17000779",Escola Doctor Robert,Camprodon,GIR,GIR,4218414,25/03/2022,0,0,0,8,2,1,0,11,0,2,2,9,3
"17000822",Escola Els Dòlmens - ZER Requesens,Capmany,GIR,GIR,4214437,23/03/2022,1,1,2,3,0,0,0,3,3,0,3,3,1
"17000846",Escola Puig d'Arques,Cassà de la Selva,GIR,GIR,4228168,30/03/2022,0,0,0,18,1,0,0,19,10,0,10,18,3
"17000861",Escola Castellroc,Castellfollit de la Roca,GIR,GIR,4224741,29/03/2022,1,1,2,3,0,0,0,3,2,0,2,1,0
"17000871",Escola Ruiz Amado,Castelló d'Empúries,GIR,GIR,4225095,29/03/2022,0,0,0,18,0,0,0,18,10,0,10,18,4
"17000883",Escola Vall d'Aro,Castell d'Aro (Castell-Platja d'Aro),GIR,GIR,4225492,29/03/2022,0,0,0,0,9,0,0,9,0,9,9,0,1
"17000895",Escola Els Estanys,Platja d'Aro (Castell-Platja d'Aro),GIR,GIR,4213614,23/03/2022,0,8,8,16,1,0,0,17,16,1,17,7,4
"17000913",Escola L'Aulet,Celrà,GIR,GIR,4229263,31/03/2022,0,0,0,0,14,0,0,14,0,5,5,0,3
"17000925",Escola L'Aixart,Cervià de Ter,GIR,GIR,4230065,31/03/2022,1,0,1,1,2,3,0,6,3,0,3,1,1
"17000937",Escola Mossèn Josep Maria Albert - ZER Empordà,Cistella,GIR,GIR,4231943,01/04/2022,0,0,0,0,0,0,1,1,0,0,0,0,0
"17000950",Escola Puig d'Esquers - ZER Cap de Creus,Colera,GIR,GIR,4227913,30/03/2022,1,0,1,0,0,0,2,2,0,2,2,1,2
"17000986",Escola La Vall del Terri,Cornellà del Terri,GIR,GIR,4231391,01/04/2022,0,0,0,13,1,0,0,14,13,1,14,0,4
"17000998",Escola El Rodonell,Corçà,GIR,GIR,4229236,31/03/2022,1,0,1,5,0,0,0,5,0,0,0,5,2
"17001024",Escola Les Gavarres - ZER Empordanet-Gavarres,"Cruïlles (Cruïlles, Monells i Sant Sadurní l'Heura)",GIR,GIR,4231047,01/04/2022,1,1,2,0,0,0,0,0,0,0,0,0,0
"17001036",Escola Mont-roig - ZER Requesens,Darnius,GIR,GIR,4213201,23/03/2022,2,0,2,1,0,0,0,1,0,0,0,1,1
"17001048",Escola Empúries,L'Escala,GIR,GIR,4222524,28/03/2022,0,0,0,0,3,23,0,26,23,3,26,23,4
"17001085",Escola Antoni Balmanya - ZER Requesens,Espolla,GIR,GIR,4231357,01/04/2022,1,0,1,0,0,0,0,0,0,0,0,0,1
"17001097",Escola Carles de Fortuny,Esponellà,GIR,GIR,4213216,23/03/2022,1,0,1,1,0,4,0,5,0,0,0,4,1
"17001103",Escola Salvador Dalí,Figueres,GIR,GIR,4211969,22/03/2022,0,0,0,18,0,0,2,20,8,2,10,18,2
"17001115",Escola Josep Pous i Pagès,Figueres,GIR,GIR,4231076,01/04/2022,1,2,3,3,8,0,0,11,3,8,11,0,4
"17001218",Institut Ramon Muntaner,Figueres,GIR,GIR,4230230,31/03/2022,0,2,2,0,5,0,0,5,0,5,5,0,2
"17001221",Institut Narcís Monturiol,Figueres,GIR,GIR,4229495,31/03/2022,0,0,0,37,0,0,0,37,0,0,0,37,0
"17001279",Escola Sant Pau,Figueres,GIR,GIR,4231119,01/04/2022,0,0,0,13,1,3,1,18,16,2,18,15,5
"17001280",Escola Joaquim Cusí i Furtunet,Figueres,GIR,GIR,4227972,30/03/2022,1,8,9,5,1,7,2,15,6,3,9,9,2
"17001292",Escola Les Moreres,Flaçà,GIR,GIR,4226017,29/03/2022,1,0,1,6,0,0,2,8,6,2,8,5,2
"17001346",Escola Forn d'Anells,Fornells de la Selva,GIR,GIR,4213843,23/03/2022,0,0,0,10,6,0,0,16,10,6,16,16,4
"17001361",Escola Teresa de Pallejà,Fortià,GIR,GIR,4228252,30/03/2022,1,0,1,5,0,0,0,5,2,0,2,5,2
"17001371",Escola de Garrigàs - ZER Empordà,Garrigàs,GIR,GIR,4215929,24/03/2022,1,1,2,1,0,0,0,1,0,0,0,1,1
"17001383",Escola Joaquim Gifre,Garriguella,GIR,GIR,4230819,01/04/2022,2,4,6,3,1,0,0,4,3,0,3,0,2
"17001395",Escola Santa Coloma - ZER Cerdanya,Ger,GIR,APA,4228418,30/03/2022,2,0,2,0,2,0,1,3,0,3,3,0,1
"17001425",Escola Eiximenis,Girona,GIR,GIR,4218856,25/03/2022,0,0,0,0,9,0,0,9,0,9,9,0,2
"17001449",Escola Annexa - Joan Puigbert,Girona,GIR,GIR,4230238,31/03/2022,0,0,0,14,2,1,0,17,15,2,17,15,2
"17001450",Escola Joan Bruguera,Girona,GIR,GIR,4222116,28/03/2022,0,0,0,8,1,0,0,9,8,1,9,0,2
"17001462",Escola Verd,Girona,GIR,GIR,4218110,25/03/2022,0,0,0,5,4,0,0,9,5,4,9,0,1
"17001486",Escola Montjuïc,Girona,GIR,GIR,4211891,22/03/2022,0,0,0,9,0,0,0,9,9,0,9,7,2
"17001516",Escola Pla de Girona,Girona,GIR,GIR,4229349,31/03/2022,0,1,1,15,0,0,1,16,15,1,16,15,2
"17001693",CEE Font de l'Abella,Girona,GIR,GIR,4229533,31/03/2022,11,0,11,1,0,15,0,16,0,0,0,5,3
"17001723",Institut Jaume Vicens Vives,Girona,GIR,GIR,4231319,01/04/2022,0,0,0,16,0,0,1,17,0,0,0,0,0
"17001735",Institut Montilivi,Girona,GIR,GIR,4229804,31/03/2022,0,0,0,1,0,0,0,1,0,0,0,0,37
"17001759",Institut Escola d'Hostaleria i Turisme de Girona,Girona,GIR,GIR,4212811,23/03/2022,0,0,0,8,4,4,0,16,12,4,16,0,10
"17001838",Escola Àgora,Girona,GIR,GIR,4212021,22/03/2022,0,0,0,4,9,0,0,13,4,9,13,9,1
"17001887",Escola Carme Auguet,Girona,GIR,GIR,4212317,22/03/2022,1,0,1,8,0,0,0,8,4,0,4,0,2
"17001930",Escola Josep Dalmau i Carles,Girona,GIR,GIR,4216149,24/03/2022,1,0,1,18,0,0,0,18,10,0,10,0,6
"17001954",Escola de Vila-roja,Vila-roja (Girona),GIR,GIR,4212125,22/03/2022,1,0,1,6,1,0,0,7,6,1,7,2,3
"17001981",Escola Mare de Déu dels Socors,Hostalric,GIR,GIR,4218774,25/03/2022,1,0,1,28,0,0,0,28,28,0,28,23,0
"17002004",Escola Josep Peñuelas del Rio,La Jonquera,GIR,GIR,4216478,24/03/2022,0,0,0,12,6,0,0,18,12,6,18,7,4
"17002028",Escola Montserrat Vayreda i Trullol,Lladó,GIR,GIR,4231452,01/04/2022,1,0,1,0,0,3,1,4,3,1,4,3,0
"17002031",Escola Lacustària,Llagostera,GIR,GIR,4230112,31/03/2022,4,0,4,14,0,0,0,14,0,0,0,14,4
"17002065",Escola Les Moreres - ZER Vall de Ter,Llanars,GIR,GIR,4222183,28/03/2022,1,0,1,1,0,0,0,1,1,0,1,1,1
"17002077",Escola Pompeu Fabra,Llançà,GIR,GIR,4212208,22/03/2022,1,1,2,18,1,1,0,20,19,1,20,18,4
"17002089",Escola de Llers,Llers,GIR,GIR,4223413,28/03/2022,1,0,1,0,0,9,0,9,5,0,5,0,2
"17002090",Escola Jaume I - ZER Cerdanya,Llívia,GIR,APA,4228227,30/03/2022,3,3,6,2,0,0,1,3,2,0,2,0,0
"17002107",Escola Pere Torrent,Lloret de Mar,GIR,GIR,4223442,28/03/2022,0,10,10,0,4,7,6,17,7,10,17,16,6
"17002168",Escola Les Salines - ZER Les Salines,Maçanet de Cabrenys,GIR,GIR,4221395,28/03/2022,1,0,1,1,0,2,1,4,3,1,4,1,1
"17002181",Escola Sant Jordi,Maçanet de la Selva,GIR,GIR,4217472,25/03/2022,9,0,9,0,0,0,0,0,8,1,9,9,4
"17002193",Escola Santa Fe,Sant Julià de Ramis,GIR,GIR,4219102,25/03/2022,1,0,1,6,0,1,0,7,7,0,7,7,0
"17002201",Escola Finestres,Mieres,GIR,GIR,4213908,23/03/2022,0,0,0,1,0,0,0,1,0,0,0,0,1
"17002247",Escola Mont Cós - ZER El Llierca,Montagut (Montagut i Oix),GIR,GIR,4214203,23/03/2022,1,2,3,0,1,2,0,3,0,0,0,2,1
"17002259",Escola Torres Jonama,Mont-ras,GIR,GIR,4227395,30/03/2022,0,3,3,8,1,0,0,9,3,1,4,9,2
"17002260",Escola Joaquim Vallmajó,Navata,GIR,GIR,4215422,24/03/2022,1,0,1,0,0,0,1,1,0,0,0,0,1
"17002296",Escola Malagrida,Olot,GIR,GIR,4228198,30/03/2022,0,0,0,18,0,0,0,18,10,0,10,18,4
"17002314",Escola Pla de Dalt,Olot,GIR,GIR,4218885,25/03/2022,0,0,0,4,2,0,0,6,4,2,6,18,4
"17002326",Escola Volcà Bisaroques,Olot,GIR,GIR,4227412,30/03/2022,0,0,0,16,2,0,0,18,16,2,18,18,4
"17002387",Institut Montsacopa,Olot,GIR,GIR,4230866,01/04/2022,0,0,0,22,3,0,0,25,0,0,0,0,0
"17002399",Institut La Garrotxa,Olot,GIR,GIR,4218047,25/03/2022,0,0,0,40,3,0,0,43,12,0,12,43,6
"17002429",Escola Sant Roc,Olot,GIR,GIR,4212984,23/03/2022,0,1,1,20,0,0,0,20,20,0,20,20,2
"17002430",Escola Maria Pagès i Trayter,Ordis,GIR,GIR,4216526,24/03/2022,1,0,1,2,0,1,0,3,3,0,3,1,1
"17002442",Escola La Vall,Osor,GIR,GIR,4228057,30/03/2022,2,1,3,0,0,0,0,0,0,0,0,0,0
"17002481",Escola Torres Jonama,Palafrugell,GIR,GIR,4216631,24/03/2022,13,1,14,0,1,3,0,4,3,1,4,4,4
"17002491",Escola Josep Barceló i Matas,Palafrugell,GIR,GIR,4213284,23/03/2022,1,6,7,15,2,0,0,17,15,2,17,15,4
"17002545",Institut Frederic Martí i Carreras,Palafrugell,GIR,GIR,4213590,23/03/2022,0,0,0,24,0,0,0,24,0,0,0,24,12
"17002557",Institut Baix Empordà,Palafrugell,GIR,GIR,4229797,31/03/2022,1,1,2,15,6,12,0,33,0,0,0,27,21
"17002569",Escola La Vila,Palamós,GIR,GIR,4224772,29/03/2022,0,0,0,25,3,0,0,28,25,3,28,0,7
"17002624",Escola Martí Inglès,Palau-saverdera,GIR,GIR,4218043,25/03/2022,1,3,4,3,2,0,0,5,2,2,4,3,1
"17002651",Escola Quermany,Pals,GIR,GIR,4214422,23/03/2022,0,0,0,7,2,0,0,9,7,2,9,9,2
"17002703",Escola Pau,Pau,GIR,GIR,4212217,22/03/2022,1,3,4,1,0,0,0,1,0,0,0,1,1
"17002715",Escola Pedra Blanca - ZER Empordanet-Gavarres,La Pera,GIR,GIR,4215917,24/03/2022,1,0,1,2,0,0,0,2,2,0,2,2,1
"17002740",Escola Ramon Muntaner,Peralada,GIR,GIR,4212211,22/03/2022,0,0,0,9,0,0,0,9,9,0,9,0,2
"17002752",Escola Sant Cristòfol,Les Planes d'Hostoles,GIR,GIR,4227993,30/03/2022,1,0,1,8,2,0,0,10,8,2,10,8,2
"17002764",Escola Núria Morer i Pi - ZER Comte Arnau,Planoles,GIR,GIR,4211885,22/03/2022,2,0,2,3,0,0,0,3,0,0,0,2,0
"17002776",Escola Tramuntana - ZER Empordà,Pont de Molins,GIR,GIR,4230269,31/03/2022,1,0,1,1,0,2,0,3,1,0,1,3,1
"17002791",Escola L'Entorn,Porqueres,GIR,GIR,4217835,25/03/2022,0,0,0,18,0,0,0,18,18,0,18,15,5
"17002818",Escola Frigolet,Porqueres,GIR,GIR,4215774,24/03/2022,1,0,1,0,0,0,0,0,0,0,0,0,1
"17002831",Escola Sant Jaume,Portbou,GIR,GIR,4216168,24/03/2022,1,0,1,0,0,3,0,3,0,0,0,1,1
"17002879",Escola Les Clisques - ZER Cap de Creus,El Port de la Selva,GIR,GIR,4225785,29/03/2022,1,0,1,2,2,2,2,8,0,2,2,1,1
"17002880",Escola Alfons I,Puigcerdà,GIR,APA,4211901,22/03/2022,0,1,1,16,0,0,0,16,16,0,16,10,3
"17002922",Escola Santa Margarida,Quart,GIR,GIR,4223922,28/03/2022,0,0,0,11,0,0,0,11,11,0,11,11,1
"17002983",Escola El Bruc,Riells i Viabrea,GIR,GIR,4213303,23/03/2022,0,0,0,0,9,0,0,9,0,5,5,0,2
"17002995",Escola Joan Maragall,Ripoll,GIR,GIR,4230978,01/04/2022,0,0,0,12,0,0,0,12,12,0,12,15,5
"17003070",Escola Josep Boada,Riudarenes,GIR,GIR,4213015,23/03/2022,1,0,1,0,0,0,0,0,0,0,0,0,2
"17003082",Escola Lluís Castells,Riudaura,GIR,GIR,4225838,29/03/2022,1,0,1,1,7,0,0,8,1,7,8,1,2
"17003094",Escola de Riudellots de la Selva,Riudellots de la Selva,GIR,GIR,4225609,29/03/2022,0,1,1,5,0,0,0,5,5,0,5,10,3
"17003136",Escola Narcís Monturiol,Roses,GIR,GIR,4231667,01/04/2022,0,0,0,9,1,0,0,10,9,1,10,10,3
"17003151",Escola Silvestre Santaló,Salt,GIR,GIR,4215872,24/03/2022,1,0,1,9,0,0,0,9,9,0,9,0,2
"17003203",Institut Salvador Espriu,Salt,GIR,GIR,4217774,25/03/2022,0,0,0,31,0,0,0,31,0,0,0,31,6
"17003215",Escola La Farga,Salt,GIR,GIR,4230026,31/03/2022,1,0,1,16,2,0,0,18,16,2,18,16,2
"17003227",Escola Sant Sebastià - ZER Requesens,Sant Climent Sescebes,GIR,GIR,4213993,23/03/2022,2,3,5,3,0,0,0,3,3,0,3,3,1
"17003264",Escola Gaziel,Sant Feliu de Guíxols,GIR,GIR,4227865,30/03/2022,0,10,10,0,0,10,0,10,0,0,0,15,5
"17003306",Institut Sant Elm,Sant Feliu de Guíxols,GIR,GIR,4227769,30/03/2022,0,0,0,18,0,0,0,18,0,0,0,5,15
"17003318",Institut de Sant Feliu de Guíxols,Sant Feliu de Guíxols,GIR,GIR,4229261,31/03/2022,0,0,0,37,0,0,0,37,0,0,0,37,0
"17003321",Escola Mossèn Baldiri Reixach,Sant Feliu de Guíxols,GIR,GIR,4214400,23/03/2022,4,0,4,0,12,2,3,17,0,0,0,0,4
"17003343",Escola Rocalba,Sant Feliu de Pallerols,GIR,GIR,4216340,24/03/2022,1,1,2,3,0,4,1,8,7,1,8,7,2
"17003392",Escola Agustí Gifre,Sant Gregori,GIR,GIR,4212491,22/03/2022,0,0,0,23,23,0,0,46,0,0,0,21,3
"17003422",Escola Taialà,Domeny (Girona),GIR,GIR,4225778,29/03/2022,0,0,0,19,2,0,0,21,19,2,21,20,6
"17003434",Escola Guilleries,Sant Hilari Sacalm,GIR,GIR,4224939,29/03/2022,0,0,0,13,4,0,0,17,13,4,17,10,4
"17003461",Escola Les Escomes,Sant Jaume de Llierca,GIR,GIR,4226994,30/03/2022,2,2,4,5,0,0,0,5,5,0,5,3,2
"17003471",Escola Sant Jordi,Sant Jordi Desvalls,GIR,GIR,4218269,25/03/2022,2,0,2,4,0,1,0,5,2,0,2,4,1
"17003537",Escola de Vallfogona de Ripollès - ZER Comte Arnau,Vallfogona de Ripollès,GIR,GIR,4214515,23/03/2022,2,0,2,0,0,0,0,0,0,0,0,0,0
"17003598",Escola Vallgarriga,Sant Miquel de Fluvià,GIR,GIR,4212944,23/03/2022,1,0,1,0,4,0,0,4,0,4,4,0,1
"17003616",Escola Els Pinets - ZER Vall de Ter,Sant Pau de Segúries,GIR,GIR,4217719,25/03/2022,1,0,1,0,0,3,0,3,3,0,3,4,0
"17003628",Escola Llagut,Sant Pere Pescador,GIR,GIR,4229995,31/03/2022,2,0,2,8,0,0,0,8,8,0,8,0,5
"17003631",Escola La Pedra Dreta - ZER Empordanet-Gavarres,"Sant Sadurní de l'Heura (Cruïlles, Monells i Sant Sadurní l'Heura)",GIR,GIR,4229373,31/03/2022,1,0,1,1,0,0,0,1,1,0,1,1,1
"17003641",Escola Sant Salvador d'Horta,Santa Coloma de Farners,GIR,GIR,4215838,24/03/2022,1,0,1,20,0,0,0,20,0,0,0,20,1
"17003689",Escola Pedralta,Santa Cristina d'Aro,GIR,GIR,4226745,30/03/2022,0,5,5,0,0,5,0,5,0,0,0,17,3
"17003719",Escola Joan Maragall,Santa Pau,GIR,GIR,4231352,01/04/2022,1,2,3,2,0,0,2,4,1,0,1,2,2
"17003732",Escola Castanyer,Sant Joan les Fonts,GIR,GIR,4228973,31/03/2022,1,2,3,8,0,0,0,8,8,0,8,4,0
"17003756",Escola Montserrat,Sarrià de Ter,GIR,GIR,4224818,29/03/2022,0,1,1,0,2,0,0,2,0,0,0,0,3
"17003768",Escola Els Terraprims,"Camallera (Saus, Camallera i Llampaies)",GIR,GIR,4229612,31/03/2022,1,0,1,6,0,0,0,6,6,0,6,4,2
"17003781",Escola Juncadella,La Cellera de Ter,GIR,GIR,4213161,23/03/2022,0,0,0,8,3,0,0,11,2,1,3,0,3
"17003801",Escola Bora Gran,Serinyà,GIR,GIR,4218842,25/03/2022,1,0,1,0,2,0,0,2,0,2,2,1,1
"17003823",Escola Verdaguer,Sils,GIR,GIR,4227396,30/03/2022,0,0,0,14,2,2,0,18,16,2,18,14,3
"17003860",Escola Portitxol,L'Estartit (Torroella de Montgrí),GIR,GIR,4225356,29/03/2022,1,4,5,13,2,0,0,15,13,2,15,12,3
"17003872",Escola Guillem de Montgrí,Torroella de Montgrí,GIR,GIR,4224112,28/03/2022,0,0,0,23,3,0,0,26,23,3,26,20,7
"17003902",Escola Joan Roura i Parella - ZER El Llierca,Tortellà,GIR,GIR,4214001,23/03/2022,1,0,1,0,5,0,0,5,0,5,5,0,2
"17003926",Escola Ignasi Melé i Farré,Tossa de Mar,GIR,GIR,4229653,31/03/2022,2,9,11,11,0,0,0,11,11,0,11,5,2
"17003938",Escola Puig Rodó - ZER Montgrí,Ullà,GIR,GIR,4214112,23/03/2022,1,0,1,0,3,0,2,5,0,5,5,4,1
"17003941",Escola L'Estany - ZER Empordanet-Gavarres,Ullastret,GIR,GIR,4218456,25/03/2022,1,0,1,0,0,0,1,1,0,1,1,0,1
"17004001",Escola Verntallat,El Mallol (La Vall d'en Bas),GIR,GIR,4228989,31/03/2022,0,0,0,12,1,0,0,13,6,1,7,12,4
"17004049",Escola Oliveres Mil·lenàries - ZER Tramuntana,Ventalló,GIR,GIR,4230436,31/03/2022,1,1,2,0,3,0,0,3,0,3,3,0,2
"17004062",Escola Santa Bàrbara - ZER Els Castells,Vidrà,CCE,CCE,4215681,24/03/2022,0,0,0,3,0,0,0,3,3,0,3,2,2
"17004074",Escola Sant Iscle,Vidreres,GIR,GIR,4211856,22/03/2022,0,0,0,11,0,2,0,13,13,0,13,12,2
"17004098",Escola Torre d'en Reig,Vilabertran,GIR,GIR,4213917,23/03/2022,1,0,1,9,0,0,0,9,0,0,0,0,3
"17004116",Escola Madrenc,Vilablareix,GIR,GIR,4228950,31/03/2022,1,2,3,0,15,0,0,15,0,15,15,0,5
"17004128",Escola Puig Segalar - ZER Tramuntana,Viladamat,GIR,GIR,4212918,23/03/2022,1,2,3,0,0,0,1,1,0,1,1,0,1
"17004153",Escola de Sant Esteve de Guialbes,Sant Esteve de Guialbes (Vilademuls),GIR,GIR,4227075,30/03/2022,2,0,2,0,0,4,0,4,4,0,4,3,2
"17004189",Escola Els Castanyers - ZER Guilleries,Viladrau,CCE,CCE,4213598,23/03/2022,2,0,2,0,1,0,2,3,0,3,3,3,1
"17004190",Escola Sol i Vent,Vilafant,GIR,GIR,4213276,23/03/2022,5,3,8,3,1,0,0,4,3,0,3,1,1
"17004207",Escola Santiago Ratés,Vilajuïga,GIR,GIR,4228868,31/03/2022,1,0,1,3,0,0,0,3,3,0,3,2,2
"17004219",Escola La Daina - ZER Vall de Ter,Vilallonga de Ter,GIR,GIR,4229397,31/03/2022,0,0,0,0,0,0,0,0,0,0,0,0,0
"17004220",Escola Els Valentins - ZER Tramuntana,Vilamacolum,GIR,GIR,4225231,29/03/2022,1,1,2,1,1,0,0,2,0,0,0,1,1
"17004232",Escola Josep de Ribot i Olivas,Vilamalla,GIR,GIR,4217642,25/03/2022,0,3,3,6,0,3,0,9,9,0,9,6,2
"17004244",Escola Tramuntana - ZER Empordà,Vilanant,GIR,GIR,4229769,31/03/2022,2,1,3,0,0,2,0,2,0,0,0,0,1
"17004281",Escola Josep Madrenys,Vilobí d'Onyar,GIR,GIR,4216723,24/03/2022,0,0,0,13,3,0,0,16,13,3,16,0,4
"17004293",Escola Manuel de Pedrolo - ZER Les Salines,Biure,GIR,GIR,4228752,31/03/2022,1,0,1,0,0,3,0,3,0,0,0,0,1
"17004335",Escola Santa Eugènia,Girona,GIR,GIR,4217789,25/03/2022,0,0,0,4,5,0,0,9,4,5,9,0,4
"17004347",Escola Font de la Pólvora,Vila-roja (Girona),GIR,GIR,4218738,25/03/2022,1,0,1,2,0,0,0,2,2,0,2,0,0
"17004360",CEE La Maçana,Salt,GIR,GIR,4227001,30/03/2022,2,0,2,1,0,0,0,1,1,0,1,0,0
"17004438",Institut Alexandre Deulofeu,Figueres,GIR,GIR,4213631,23/03/2022,0,0,0,28,0,0,0,28,28,0,28,0,10
"17004451",Escola Jaume Vicens i Vives,Roses,GIR,GIR,4223443,28/03/2022,1,5,6,15,0,0,0,15,15,0,15,11,4
"17004463",Escola Anicet de Pagès i de Puig,Figueres,GIR,GIR,4218296,25/03/2022,1,0,1,6,5,0,0,11,6,5,11,4,4
"17004487",Institut Rafael Campalans,Anglès,GIR,GIR,4229520,31/03/2022,0,20,20,7,1,0,0,8,0,0,0,34,0
"17004499",Institut Narcís Xifra i Masmitjà,Girona,GIR,GIR,4227911,30/03/2022,0,0,0,47,0,0,0,47,47,0,47,47,20
"17004517",Institut Anton Busquets i Punset,Sant Hilari Sacalm,GIR,GIR,4223124,28/03/2022,3,0,3,20,1,0,0,21,20,1,21,20,4
"17004529",Escola Migdia,Girona,GIR,GIR,4211872,22/03/2022,0,2,2,19,4,0,0,23,19,4,23,23,4
"17004530",Institut Santiago Sobrequés i Vidal,Girona,GIR,GIR,4230950,01/04/2022,0,0,0,25,0,0,0,25,0,1,1,25,8
"17004566",Escola Napoleó Soliva,Blanes,GIR,GIR,4211945,22/03/2022,0,0,0,0,0,0,11,11,0,0,0,0,0
"17004578",Institut Castell d'Estela,Amer,GIR,GIR,4229392,31/03/2022,0,0,0,0,11,0,0,11,0,11,11,0,6
"17004657",Escola Esteve Carles,Lloret de Mar,GIR,GIR,4229415,31/03/2022,0,2,2,6,5,0,0,11,6,5,11,6,3
"17004682",Escola L'Estació,Sant Feliu de Guíxols,GIR,GIR,4223053,28/03/2022,0,4,4,17,0,0,0,17,6,0,6,17,4
"17004694",Escola Cassià Costal,Girona,GIR,GIR,4225762,29/03/2022,1,0,1,16,0,0,0,16,0,0,0,11,4
"17004712",CEE Ventijol,Blanes,GIR,GIR,4225446,29/03/2022,3,1,4,5,2,5,0,12,10,2,12,3,2
"17004724",CEE Palau,Girona,GIR,GIR,4218115,25/03/2022,3,0,3,9,0,0,0,9,9,0,9,0,0
"17004736",CEE Els Àngels,Sant Joan de Palamós (Palamós),GIR,GIR,4213300,23/03/2022,6,0,6,7,2,0,0,9,7,2,9,7,1
"17004748",CEE Mare de Déu del Mont,Vilafant,GIR,GIR,4227840,30/03/2022,11,2,13,4,1,2,1,8,1,2,3,6,1
"17004751",Escola Tomàs Raguer,Ripoll,GIR,GIR,4227843,30/03/2022,0,5,5,0,0,4,2,6,4,2,6,4,2
"17004761",CEE Doctor Ramon Suriñach,Ripoll,GIR,GIR,4215541,24/03/2022,2,1,3,0,0,0,0,0,0,0,0,0,0
"17004827",Escola Alzina Reclamadora,Fontcoberta,GIR,GIR,4226840,30/03/2022,0,0,0,0,0,0,11,11,0,0,0,0,2
"17004852",EOI de Girona,Girona,GIR,GIR,4229084,31/03/2022,0,2,2,19,2,0,0,21,0,2,2,18,0
"17004864",Escola El Pla,Salt,GIR,GIR,4213799,23/03/2022,0,1,1,10,6,0,0,16,10,6,16,18,2
"17004876",Escola l'Olivar Vell,Esclanyà (Begur),GIR,GIR,4217168,24/03/2022,1,1,2,1,1,3,0,5,3,1,4,0,1
"17004888",Escola Santa Cecília - ZER Cerdanya,Bolvir,GIR,APA,4218089,25/03/2022,0,0,0,0,0,0,0,0,0,0,0,0,1
"17004891",Escola Josep Pallach,Figueres,GIR,GIR,4212951,23/03/2022,0,0,0,12,1,4,1,18,16,2,18,18,4
"17004906",Escola Salvador Espriu,Vidreres,GIR,GIR,4212933,23/03/2022,0,6,6,16,2,0,0,18,10,2,12,18,4
"17004943",Escola Montfalgars,Girona,GIR,GIR,4230236,31/03/2022,0,0,0,18,0,0,0,18,18,0,18,18,2
"17004955",Escola Pompeu Fabra,Lloret de Mar,GIR,GIR,4214554,23/03/2022,7,0,7,0,11,0,12,23,0,0,0,6,0
"17005017",Escola Quatre Vents,Blanes,GIR,GIR,4214046,23/03/2022,0,0,0,11,1,0,1,13,11,1,12,11,3
"17005029",Escola L'Esquirol - ZER Vall de Ter,Ogassa,GIR,GIR,4225664,29/03/2022,1,0,1,0,0,1,0,1,1,0,1,2,0
"17005042",Institut Carles Rahola i Llorens,Girona,GIR,GIR,4229105,31/03/2022,0,0,0,19,2,0,0,21,19,2,21,19,2
"17005182",Escola Can Puig,Banyoles,GIR,GIR,4218775,25/03/2022,0,0,0,18,0,0,0,18,10,0,10,18,4
"17005248",Escola Mas Clarà,La Bisbal d'Empordà,GIR,GIR,4218284,25/03/2022,0,5,5,0,0,13,0,13,6,0,6,13,4
"17005251",Institut El Pedró,L'Escala,GIR,GIR,4228213,30/03/2022,6,0,6,19,0,0,0,19,0,0,0,19,3
"17005261",Escola Montpalau - ZER El Llierca,Argelaguer,GIR,GIR,4225523,29/03/2022,1,0,1,0,0,3,0,3,2,0,2,0,1
"17005339",CFA Les Bernardes,Salt,GIR,GIR,4218090,25/03/2022,0,0,0,7,0,0,0,7,7,0,7,7,1
"17005340",EA d'Olot,Olot,GIR,GIR,4226109,29/03/2022,5,0,5,0,1,0,0,1,0,0,0,0,0
"17005352",Institut de Palamós,Palamós,GIR,GIR,4223947,28/03/2022,0,0,0,25,3,0,0,28,0,0,0,28,0
"17005364",Institut Cap Norfeu,Roses,GIR,GIR,4228395,30/03/2022,1,0,1,24,0,0,0,24,24,0,24,8,24
"17005376",Institut de Santa Coloma de Farners,Santa Coloma de Farners,GIR,GIR,4213860,23/03/2022,2,0,2,34,0,0,0,34,2,0,2,34,0
"17005388",Institut Vallvera,Salt,GIR,GIR,4230496,31/03/2022,0,0,0,31,2,0,0,33,0,0,0,0,5
"17005522",Escola Veïnat,Salt,GIR,GIR,4225384,29/03/2022,1,0,1,8,0,0,0,8,4,0,4,8,1
"17005649",Institut Cendrassos,Figueres,GIR,GIR,4218082,25/03/2022,1,0,1,2,6,0,0,8,2,6,8,0,12
"17005650",Institut de Cassà de la Selva,Cassà de la Selva,GIR,GIR,4222100,28/03/2022,1,0,1,0,0,10,0,10,0,0,0,0,6
"17005662",Institut Serrallarga,Blanes,GIR,GIR,4217005,24/03/2022,0,2,2,9,25,0,0,34,0,0,0,34,16
"17005704",Institut Abat Oliba,Ripoll,GIR,GIR,4229680,31/03/2022,2,0,2,3,8,0,0,11,3,8,11,3,1
"17005731",Institut S'Agulla,Blanes,GIR,GIR,4238454,06/04/2022,0,0,0,26,0,0,0,26,0,0,0,26,0
"17005741",Institut Pere Borrell,Puigcerdà,GIR,APA,4225653,29/03/2022,0,0,0,27,2,0,0,29,2,2,4,29,0
"17005893",Institut Bosc de la Coma,Olot,GIR,GIR,4217929,25/03/2022,1,0,1,27,1,0,0,28,27,1,28,27,0
"17005911",Institut Ramon Coll i Rodés,Lloret de Mar,GIR,GIR,4212260,22/03/2022,0,0,0,27,0,3,2,32,30,2,32,30,4
"17005923",Institut Montgrí,Torroella de Montgrí,GIR,GIR,4215824,24/03/2022,2,0,2,27,0,0,0,27,27,0,27,27,0
"17006083",Institut Castelló d'Empúries,Castelló d'Empúries,GIR,GIR,4229543,31/03/2022,0,0,0,25,0,0,0,25,0,0,0,25,25
"17006605",Institut Montsoriu,Arbúcies,GIR,GIR,4222352,28/03/2022,0,0,0,19,2,0,0,21,0,0,0,19,0
"17006666",Institut Pla de l'Estany,Banyoles,GIR,GIR,4229254,31/03/2022,0,1,1,28,0,0,0,28,0,0,0,10,2
"17006681",Institut Germans Vila-Riera,Camprodon,GIR,GIR,4229604,31/03/2022,0,0,0,0,6,0,0,6,0,2,2,0,0
"17006691",Institut Ridaura,Castell d'Aro (Castell-Platja d'Aro),GIR,GIR,4218013,25/03/2022,0,0,0,0,10,0,0,10,0,10,10,0,10
"17006708",Institut de Celrà,Celrà,GIR,GIR,4233547,04/04/2022,0,0,0,21,2,0,0,23,0,0,0,0,23
"17006711",Escola M. Àngels Anglada,Figueres,GIR,GIR,4227570,30/03/2022,1,0,1,10,0,0,0,10,6,0,6,10,2
"17006721",Escola Marta Mata,Girona,GIR,GIR,4217938,25/03/2022,0,0,0,17,0,0,0,17,9,0,9,17,4
"17006733",Institut Vescomtat de Cabrera,Hostalric,GIR,GIR,4229399,31/03/2022,0,0,0,19,1,0,0,20,19,1,20,20,2
"17006745",Institut de La Jonquera,La Jonquera,GIR,GIR,4213230,23/03/2022,0,1,1,10,0,0,0,10,0,0,0,10,6
"17006757",Institut de Llagostera,Llagostera,GIR,GIR,4229650,31/03/2022,0,0,0,1,0,0,4,5,0,0,0,0,17
"17006769",Institut de Llançà,Llançà,GIR,GIR,4212843,23/03/2022,0,0,0,17,1,0,0,18,17,1,18,17,18
"17006770",Institut Rocagrossa,Lloret de Mar,GIR,GIR,4218076,25/03/2022,0,0,0,17,4,0,0,21,17,4,21,21,4
"17006782",Escola Carrilet,Palafrugell,GIR,GIR,4214633,23/03/2022,7,0,7,0,1,13,0,14,0,0,0,12,3
"17006800",Escola Els Grecs,Roses,GIR,GIR,4227983,30/03/2022,0,0,0,15,0,0,0,15,4,0,4,0,0
"17006812",Institut de Tossa de Mar,Tossa de Mar,GIR,GIR,4231426,01/04/2022,0,0,0,0,0,11,0,11,2,0,2,11,2
"17006824",Institut Vidreres,Vidreres,GIR,GIR,4225591,29/03/2022,0,0,0,22,22,0,0,44,0,22,22,0,6
"17006836",Escola Les Mèlies,Vilafant,GIR,GIR,4213680,23/03/2022,0,1,1,18,0,0,0,18,18,0,18,0,4
"17006851",Institut Illa de Rodes,Roses,GIR,GIR,4231469,01/04/2022,0,0,0,21,4,0,0,25,0,0,0,1,4
"17006873",Escola Castellum,Sant Julià de Ramis,GIR,GIR,4228799,31/03/2022,0,0,0,12,0,4,0,16,4,0,4,10,8
"17006939",Institut Santa Eugènia,Girona,GIR,GIR,4230601,31/03/2022,0,3,3,36,0,0,0,36,0,0,0,36,46
"17006940",Escola de Lliurona,Albanyà,GIR,GIR,4230031,31/03/2022,1,0,1,0,0,1,1,2,0,0,0,0,1
"17006952",Escola La Draga,Banyoles,GIR,GIR,4229130,31/03/2022,0,2,2,17,0,0,0,17,6,0,6,8,4
"17007014",CFA Lloret de Mar,Lloret de Mar,GIR,GIR,4230315,31/03/2022,0,1,1,3,0,0,0,3,0,0,0,3,0
"17007129",CFA Es Piteus,Blanes,GIR,GIR,4238624,06/04/2022,0,1,1,0,0,2,0,2,0,0,0,2,0
"17007178",CFA Maria Verdaguer,Figueres,GIR,GIR,4230215,31/03/2022,0,0,0,9,0,0,0,9,1,0,1,9,0
"17007181",CFA Girona,Girona,GIR,GIR,4218636,25/03/2022,0,0,0,0,8,0,0,8,0,8,8,0,0
"17007300",Institut La Bisbal,La Bisbal d'Empordà,GIR,GIR,4227517,30/03/2022,0,0,0,5,0,10,0,15,2,0,2,0,37
"17007609",Institut Olivar Gran,Figueres,GIR,GIR,4221249,28/03/2022,6,0,6,44,0,0,0,44,44,0,44,35,0
"17007658",CFA Sant Feliu de Guíxols,Sant Feliu de Guíxols,GIR,GIR,4229848,31/03/2022,0,0,0,0,0,2,0,2,0,0,0,0,1
"17007671",CFA La Garrotxa,Olot,GIR,GIR,4238215,06/04/2022,0,1,1,4,1,0,0,5,0,0,0,4,0
"17007828",Escola Pinya de Rosa,Blanes,GIR,GIR,4212966,23/03/2022,0,0,0,18,3,0,0,21,6,0,6,20,5
"17007907",Escola Joana d'Empúries,Castelló d'Empúries,GIR,GIR,4218739,25/03/2022,1,0,1,15,0,0,0,15,5,0,5,15,2
"17007919",Escola Mas Masó,Salt,GIR,GIR,4227580,30/03/2022,1,0,1,22,0,0,0,22,22,0,22,22,3
"17007981",EOI d'Olot,Olot,GIR,GIR,4228226,30/03/2022,0,5,5,2,0,0,0,2,0,0,0,1,0
"17008006",Escola Amistat,Figueres,GIR,GIR,4231019,01/04/2022,0,0,0,25,5,0,0,30,0,0,0,25,3
"17008018",Escola Ardenya,Sant Feliu de Guíxols,GIR,GIR,4227059,30/03/2022,10,0,10,0,0,8,0,8,8,0,8,8,6
"17008080",Escola Àngels Alemany i Boris,Lloret de Mar,GIR,GIR,4218823,25/03/2022,2,5,7,28,0,0,0,28,0,0,0,26,6
"17008122",EOI de Blanes,Blanes,GIR,GIR,4232255,02/04/2022,0,0,0,6,1,0,0,7,0,0,0,7,0
"17008134",EOI de Figueres,Figueres,GIR,GIR,4217787,25/03/2022,0,0,0,8,1,0,0,9,0,0,0,8,0
"17008146",CFA Palafrugell,Palafrugell,GIR,GIR,4230298,31/03/2022,0,0,0,4,0,0,0,4,0,0,0,0,1
"17008237",Escola Montserrat Vayreda,Roses,GIR,GIR,4226793,30/03/2022,0,0,0,15,0,0,0,15,15,0,15,5,4
"17008249",Escola Castell de Farners,Santa Coloma de Farners,GIR,GIR,4216765,24/03/2022,0,0,0,15,3,0,0,18,15,3,18,22,4
"17008274",Escola Sa Forcanera,Blanes,GIR,GIR,4227225,30/03/2022,1,0,1,4,13,0,0,17,1,5,6,5,4
"17008286",Escola Domeny,Girona,GIR,GIR,4228093,30/03/2022,0,0,0,18,0,0,0,18,10,0,10,18,0
"17008298",Escola El Gegant del Rec,Salt,GIR,GIR,4230128,31/03/2022,1,0,1,18,4,0,0,22,0,0,0,0,4
"17008365",CFA Pla de l'Estany,Banyoles,GIR,GIR,4230062,31/03/2022,0,0,0,3,0,0,0,3,1,2,3,0,0
"17008377",CFA Ripollès,Ripoll,GIR,GIR,4212828,23/03/2022,0,1,1,3,0,0,0,3,3,0,3,1,0
"17008389",CFA La Selva,Santa Coloma de Farners,GIR,GIR,4227852,30/03/2022,0,0,0,0,0,0,1,1,0,1,1,0,0
"17008390",Institut de Vilafant,Vilafant,GIR,GIR,4212189,22/03/2022,4,0,4,0,12,0,0,12,0,0,0,9,0
"17008407",Institut Salvador Sunyer i Aimeric,Salt,GIR,GIR,4215355,24/03/2022,2,0,2,0,11,0,0,11,0,11,11,4,13
"17008419",Escola Llums del Nord,Puigcerdà,GIR,APA,4213804,23/03/2022,0,0,0,0,9,0,0,9,0,5,5,3,2
"17008444",Escola Parc de les Aigües,Figueres,GIR,GIR,4225210,29/03/2022,1,1,2,18,0,0,0,18,9,0,9,18,4
"17008468",Escola La Sínia,Sant Antoni de Calonge (Calonge i Sant Antoni),GIR,GIR,4231372,01/04/2022,0,0,0,0,5,0,0,5,0,5,5,0,2
"17008471",Escola Les Falgueres,Celrà,GIR,GIR,4231643,01/04/2022,3,0,3,0,17,0,0,17,0,17,17,0,4
"17008481",Escola L'Esculapi,L'Escala,GIR,GIR,4218848,25/03/2022,3,4,7,0,0,0,8,8,0,0,0,2,0
"17008493",Escola Vall-llobrega,Vall-llobrega,GIR,GIR,4213174,23/03/2022,1,0,1,0,0,0,9,9,0,9,9,0,1
"17008501",Escola Aldric,Cassà de la Selva,GIR,GIR,4239800,07/04/2022,0,0,0,19,1,0,0,20,10,0,10,20,0
"17008523",Escola Pi Verd,Palafrugell,GIR,GIR,4213966,23/03/2022,1,4,5,12,0,0,0,12,6,0,6,18,4
"17008547",Escola Les Arrels,Maçanet de la Selva,GIR,GIR,4229019,31/03/2022,0,3,3,2,4,0,0,6,4,0,4,0,2
"17008641",Escola de Cabanes,Cabanes,GIR,GIR,4229586,31/03/2022,2,1,3,8,0,0,0,8,8,0,8,6,2
"17008651",Institut de Caldes de Malavella,Caldes de Malavella,GIR,GIR,4218453,25/03/2022,1,0,1,6,0,0,0,6,0,0,0,0,14
"17008675",Escola Pericot,Girona,GIR,GIR,4216617,24/03/2022,0,0,0,0,18,0,0,18,0,18,18,0,2
"17008687",Escola Les Deveses,Salt,GIR,GIR,4213898,23/03/2022,1,0,1,18,0,0,0,18,0,0,0,18,4
"17008778",Escola El Morrot,Olot,GIR,GIR,4222958,28/03/2022,0,0,0,6,6,3,3,18,0,9,9,0,3
"17008781",Escola La Benaula,Caldes de Malavella,GIR,GIR,4229453,31/03/2022,0,0,0,8,0,1,0,9,9,0,9,9,2
"17008808",Escola Carme Guasch i Darné,Figueres,GIR,GIR,4228002,30/03/2022,0,2,2,18,0,0,0,18,12,0,12,18,4
"17008821",EOI de Banyoles,Banyoles,GIR,GIR,4228193,30/03/2022,0,0,0,4,0,0,0,4,4,0,4,0,0
"17008882",Escola La Bòbila,Les Preses,GIR,GIR,4229795,31/03/2022,0,2,2,6,3,0,0,9,2,3,5,6,2
"17008894",Escola Alzines Balladores,Sant Feliu de Buixalleu,GIR,GIR,4223047,28/03/2022,1,1,2,0,0,3,9,12,3,9,12,7,2
"17008951",Institut Maçanet de la Selva,Maçanet de la Selva,GIR,GIR,4225990,29/03/2022,1,0,1,11,0,0,0,11,11,0,11,11,5
"17008997",Escola Forallac,Vulpellac (Forallac),GIR,GIR,4223239,28/03/2022,1,0,1,7,7,0,0,14,0,7,7,2,3
"17009126",Escola El Bosc de la Pabordia,Girona,GIR,GIR,4229869,31/03/2022,0,1,1,21,0,0,0,21,0,0,0,0,6
"17009138",Escola Puig de les Cadiretes,Llagostera,GIR,GIR,4227258,30/03/2022,0,5,5,2,1,10,2,15,0,2,2,10,4
"17009199",Escola Els Estanys,Sils,GIR,GIR,4215677,24/03/2022,0,0,0,0,0,9,0,9,5,0,5,9,2
"17009205",Institut de Vilablareix,Vilablareix,GIR,GIR,4237087,05/04/2022,0,0,0,22,0,0,0,22,0,0,0,22,12
"17009242",Escola Nou de Quart,Quart,GIR,GIR,4225998,29/03/2022,1,0,1,0,9,0,0,9,0,9,9,0,1
"17009278",Escola Fanals d'Aro,Castell d'Aro (Castell-Platja d'Aro),GIR,GIR,4229193,31/03/2022,0,2,2,0,0,7,0,7,7,0,7,0,0
"17009308",Institut de Sils,Sils,GIR,GIR,4231620,01/04/2022,0,0,0,0,1,0,0,1,0,1,1,1,16
"17009345",Escola Camins,Banyoles,GIR,GIR,4218975,25/03/2022,1,0,1,0,0,0,2,2,0,2,2,0,3
"17009710",Escola Empordanet,La Bisbal d'Empordà,GIR,GIR,4225782,29/03/2022,1,0,1,0,9,0,0,9,0,9,9,0,2
"17009783",Institut La Miquela,Bescanó,GIR,GIR,4230245,31/03/2022,0,0,0,14,0,0,0,14,14,0,14,0,0
"17009795",Institut Escola Francesc Cambó i Batlle,Verges,GIR,GIR,4215703,24/03/2022,0,0,0,0,22,0,0,22,0,0,0,0,10
"17009801",Institut Escola Salvador Vilarrasa,Besalú,GIR,GIR,4230884,01/04/2022,0,0,0,2,0,0,0,2,2,0,2,0,2
"17009813",Institut Escola Mestre Andreu,Sant Joan de les Abadesses,GIR,GIR,4217862,25/03/2022,2,1,3,6,15,0,0,21,6,5,11,5,4
"17009850",Escola Les Arrels,Salt,GIR,GIR,4216011,24/03/2022,1,0,1,0,0,0,12,12,0,12,12,0,4
"17009898",Institut Escola Lloret de Mar,Lloret de Mar,GIR,GIR,4225193,29/03/2022,2,28,30,0,6,0,0,6,0,6,6,2,3
"17010037",Institut El Bruc,Riells i Viabrea,GIR,GIR,4217917,25/03/2022,0,0,0,0,6,0,0,6,0,0,0,1,4
"17010049",Escola Balandrau,Girona,GIR,GIR,4218340,25/03/2022,0,0,0,0,0,0,0,0,0,0,0,0,1
"17010189",Institut Vall de Llémena,Sant Gregori,GIR,GIR,4231122,01/04/2022,1,1,2,7,2,2,0,11,9,2,11,7,2
"17010414",Institut Ermessenda de Girona,Girona,GIR,GIR,4231011,01/04/2022,3,0,3,0,12,0,6,18,0,18,18,0,18
"17010441",CFA Nou Girona,Girona,GIR,GIR,4231102,01/04/2022,0,0,0,5,0,0,0,5,0,0,0,5,0
"17010451",CFA Tramuntana,Figueres,GIR,GIR,4234706,04/04/2022,0,0,0,9,0,0,0,9,9,0,9,9,0
"17010682",Institut de Sarrià de Ter,Sarrià de Ter,GIR,GIR,4231689,01/04/2022,0,1,1,0,0,0,6,6,0,6,6,0,0
"17010694",Institut Escola El Bruel-Empuriabrava,Castelló d'Empúries,GIR,GIR,4215701,24/03/2022,3,0,3,14,0,0,0,14,3,0,3,8,2
"17010700",Institut Sant Quirze,Lloret de Mar,GIR,GIR,4229920,31/03/2022,0,0,0,3,0,0,4,7,0,0,0,0,2
"17010797",Institut Escola Caritat Serinyana - Cap de Creus,Cadaqués,GIR,GIR,4216686,24/03/2022,1,0,1,15,0,0,0,15,15,0,15,10,2
"17010803",Institut Escola Vall de Ribes,Ribes de Freser,GIR,GIR,4214454,23/03/2022,0,0,0,15,0,0,0,15,15,0,15,13,3
"17010815",Institut Escola Vila-romà,Palamós,GIR,GIR,4218656,25/03/2022,4,2,6,0,30,0,0,30,0,30,30,21,6
"17010827",Institut Escola Greda,Olot,GIR,GIR,4212322,22/03/2022,4,0,4,12,0,0,0,12,0,0,0,12,4
"17010839",Institut de Peralada,Peralada,GIR,GIR,4212375,22/03/2022,4,2,6,1,0,0,0,1,1,0,1,0,0
"17010840",Institut La Sureda,Palafrugell,GIR,GIR,4225328,29/03/2022,0,0,0,0,3,0,0,3,0,3,3,0,0
"17010921",Institut Escola Montseny,Breda,GIR,GIR,4224590,29/03/2022,0,13,13,8,0,0,0,8,7,0,7,4,2
"17010931",Escola Les Curculles-ZER Empordà,Palau de Santa Eulàlia,GIR,GIR,4212615,22/03/2022,0,0,0,0,1,0,0,1,0,0,0,0,0
"25000031",Escola Andreu Farran - ZER Montsec,Àger,LLE,LLE,4215818,24/03/2022,0,0,0,0,0,1,1,2,0,0,0,0,1
"25000067",Escola Macià-Companys,Agramunt,LLE,LLE,4231713,01/04/2022,1,0,1,9,1,0,0,10,9,1,10,7,2
"25000110",Escola Arrels - ZER L'Horta de Lleida,Els Alamús,LLE,LLE,4212812,23/03/2022,0,0,0,0,1,0,0,1,0,1,1,0,1
"25000122",Escola Sant Esteve - ZER Urgellet,Alàs i Cerc,LLE,APA,4212532,22/03/2022,0,0,0,2,0,0,0,2,2,0,2,2,1
"25000146",Escola Mare de Déu de Montserrat - ZER Vall de l'Aranyó,L'Albagés,LLE,LLE,4212652,22/03/2022,0,0,0,2,0,0,0,2,2,0,2,0,1
"25000158",Escola Sant Salvador,Albatàrrec,LLE,LLE,4215871,24/03/2022,2,3,5,5,1,0,0,6,5,1,6,6,2
"25000161",Escola L'Àlber,Albesa,LLE,LLE,4229454,31/03/2022,1,0,1,9,0,0,0,9,3,0,3,2,3
"25000171",Escola Els Aubis - ZER Riu Set,L'Albi,LLE,LLE,4212306,22/03/2022,0,0,0,3,0,0,1,4,3,1,4,3,1
"25000183",Escola La Dula - ZER L'Eral,Alcanó,LLE,LLE,4213842,23/03/2022,0,0,0,1,1,0,0,2,0,1,1,2,1
"25000195",Escola Comtes de Torregrossa,Alcarràs,LLE,LLE,4230705,31/03/2022,1,1,2,22,0,0,0,22,22,0,22,22,6
"25000225",Escola Mare de Déu del Carme,Alcoletge,LLE,LLE,4214140,23/03/2022,6,9,15,0,0,5,4,9,0,0,0,9,4
"25000274",Escola d'Alfés - ZER L'Eral,Alfés,LLE,LLE,4229117,31/03/2022,0,0,0,0,1,0,0,1,0,0,0,1,1
"25000286",Escola Sant Blai - ZER Serra Llarga,Algerri,LLE,LLE,4215409,24/03/2022,0,0,0,3,1,0,0,4,3,1,4,4,1
"25000316",Escola d'Alins - ZER Alt Pallars Sobirà,Alins,LLE,APA,MANUAL,44659,1,0,1,0,1,0,0,1,0,1,1,0,0
"25000341",Escola Antònia Simó Arnó,Almacelles,LLE,LLE,4227018,30/03/2022,3,0,3,26,0,1,0,27,27,0,27,26,6
"25000468",Escola Doctor Serés,Alpicat,LLE,LLE,EVALISA,44986,1,0,1,9,10,0,0,19,0,6,6,0,0
"25000481",Escola Sant Isidre - ZER Ponent,Gimenells (Gimenells i el Pla de la Font),LLE,LLE,4230534,31/03/2022,0,0,0,4,0,0,0,4,4,0,4,4,0
"25000511",Escola Inocencio Pardos - ZER Ponent,El Pla de la Font (Gimenells i el Pla de la Font),LLE,LLE,4217355,24/03/2022,0,0,0,1,0,0,0,1,1,0,1,1,1
"25000535",Escola Loseron - ZER Val d'Aran,Arties (Naut Aran),LLE,APA,4213859,23/03/2022,0,0,0,0,3,0,0,3,0,0,0,0,0
"25000559",Escola Sant Martí - ZER Val d'Aran,Gessa (Naut Aran),LLE,APA,4216151,24/03/2022,1,1,2,1,0,0,0,1,0,0,0,1,0
"25000560",Escola Ruda - ZER Val d'Aran,Salardú (Naut Aran),LLE,APA,4239561,07/04/2022,0,1,1,2,2,0,0,4,2,2,4,0,2
"25000584",Escola Santa Creu,Anglesola,LLE,LLE,4227386,30/03/2022,1,0,1,9,0,0,0,9,9,0,9,9,2
"25000602",Escola Albirka,Arbeca,LLE,LLE,4230988,01/04/2022,0,0,0,8,1,0,0,9,8,1,9,0,0
"25000626",Escola Els Til.lers,Artesa de Lleida,LLE,LLE,4233363,04/04/2022,0,0,0,0,0,0,4,4,0,4,4,0,1
"25000638",Escola Els Planells,Artesa de Segre,LLE,LLE,4224870,29/03/2022,1,0,1,0,0,1,0,1,0,0,0,0,4
"25000675",Escola Mare de Déu de la Guardiola - ZER El Romaní,La Sentiu de Sió,LLE,LLE,4212931,23/03/2022,0,0,0,1,0,0,0,1,0,0,0,0,1
"25000699",Escola de Les Avellanes - ZER Montsec,Les Avellanes (Les Avellanes i Santa Linya),LLE,LLE,4215035,23/03/2022,0,0,0,0,0,2,0,2,0,0,0,2,1
"25000717",Escola de Tartareu - ZER Montsec,Tartareu (Les Avellanes i Santa Linya),LLE,LLE,4231528,01/04/2022,0,0,0,0,0,1,0,1,1,0,1,0,1
"25000730",Escola Francesc Feliu,Aitona,LLE,LLE,4226774,30/03/2022,1,1,2,4,10,0,0,14,4,10,14,6,4
"25000778",Escola Gaspar de Portolà,Balaguer,LLE,LLE,4223264,28/03/2022,19,0,19,0,0,9,0,9,0,0,0,3,2
"25000781",Escola Àngel Guimerà,Balaguer,LLE,LLE,4231663,01/04/2022,1,0,1,9,0,0,0,9,9,0,9,9,2
"25000833",Institut Ciutat de Balaguer,Balaguer,LLE,LLE,4213850,23/03/2022,1,0,1,20,0,0,0,20,20,0,20,20,8
"25000857",Escola La Noguera,Balaguer,LLE,LLE,4212063,22/03/2022,1,1,2,0,3,0,0,3,0,3,3,0,4
"25000869",Escola Sant Roc - ZER Riu Ondara,Barbens,LLE,LLE,4223390,28/03/2022,0,0,0,5,0,0,0,5,3,0,3,0,1
"25000951",Escola Pere Teixiné - ZER Riu Corb,Belianes,LLE,LLE,4238138,06/04/2022,0,2,2,2,0,0,0,2,1,0,1,1,1
"25000961",Escola Bonavista,Bellcaire d'Urgell,LLE,LLE,4212195,22/03/2022,1,0,1,4,3,0,0,7,4,3,7,3,2
"25000985",Escola Ramon Farrerons,Bell-lloc d'Urgell,LLE,LLE,4227111,30/03/2022,0,0,0,10,2,0,0,12,2,2,4,4,3
"25001001",Escola Sant Bartomeu - ZER Espernallac,Bellmunt d'Urgell,LLE,LLE,4214647,23/03/2022,0,0,0,0,2,0,0,2,0,2,2,0,1
"25001011",Escola Valeri Serra,Bellpuig,LLE,LLE,4222289,28/03/2022,1,0,1,14,0,0,0,14,5,0,5,11,0
"25001059",Escola Mare de Déu de Talló,Bellver de Cerdanya,LLE,APA,4224746,29/03/2022,1,0,1,1,8,0,0,9,1,8,9,0,1
"25001084",Escola Joaquim Palacín,Bellvís,LLE,LLE,4218162,25/03/2022,1,2,3,5,0,0,0,5,0,0,0,3,2
"25001096",Escola Sant Joan,Benavent de Segrià,LLE,LLE,4228062,30/03/2022,1,0,1,10,5,0,0,15,10,5,15,3,3
"25001126",Escola Vallmajor - ZER Elaia,Bovera,LLE,LLE,4212066,22/03/2022,0,0,0,1,0,0,0,1,1,0,1,0,1
"25001138",Escola Casteth Leon - ZER Val d'Aran,Es Bòrdes,LLE,APA,4239928,07/04/2022,0,0,0,0,1,0,0,1,1,1,2,0,1
"25001141",Escola Joan XXIII,Les Borges Blanques,LLE,LLE,4213307,23/03/2022,0,0,0,23,2,0,0,25,23,2,25,23,4
"25001199",Escola Sant Ròc,Bossòst,LLE,APA,4229452,31/03/2022,0,1,1,3,1,0,0,4,3,1,4,2,1
"25001229",Escola Dos Rius - ZER El Jonc,Camarasa,LLE,LLE,4222709,28/03/2022,0,0,0,0,0,3,1,4,3,0,3,3,1
"25001242",Escola Castell-Ciutat - ZER Urgellet,Castellciutat (La Seu d'Urgell),LLE,APA,4214532,23/03/2022,1,0,1,2,1,0,0,3,2,1,3,0,2
"25001254",Escola Timorell - ZER Vall de l'Aranyó,Castelldans,LLE,LLE,4216366,24/03/2022,0,0,0,4,0,0,0,4,2,0,2,4,1
"25001266",Escola L'Estel - ZER Vent Serè,Castellnou de Seana,LLE,LLE,4216227,24/03/2022,1,0,1,2,1,0,0,3,1,1,2,1,1
"25001278",Escola Santa Maria - ZER Serra Llarga,Castelló de Farfanya,LLE,LLE,4238077,06/04/2022,0,1,1,3,1,0,0,4,0,0,0,0,1
"25001281",Escola El Terrall - ZER Espernallac,Castellserà,LLE,LLE,4214622,23/03/2022,0,1,1,5,0,0,0,5,0,0,0,5,1
"25001291",Escola Jaume Balmes,Cervera,LLE,LLE,4231307,01/04/2022,1,0,1,15,0,0,0,15,0,0,0,12,3
"25001311",Institut Antoni Torroja,Cervera,LLE,LLE,4229643,31/03/2022,1,0,1,6,0,0,0,6,6,0,6,6,0
"25001321",Escola Mossèn Josep Arques,Cervera,LLE,LLE,4227418,30/03/2022,1,0,1,12,0,0,2,14,4,0,4,12,4
"25001333",Escola El Cérvol - ZER Riu Set,Cervià de les Garrigues,LLE,LLE,4218417,25/03/2022,0,1,1,1,2,0,1,4,1,0,1,0,0
"25001357",Escola de Ciutadilla - ZER Guicivervi,Ciutadilla,LLE,LLE,4224864,29/03/2022,1,1,2,0,0,0,0,0,0,0,0,0,0
"25001400",Escola Sant Climent - ZER Narieda,Coll de Nargó,LLE,APA,4222246,28/03/2022,0,0,0,0,3,0,0,3,0,3,3,0,1
"25001424",Escola Sol Ixent,Corbins,LLE,LLE,4223325,28/03/2022,1,2,3,8,1,0,0,9,8,1,9,7,2
"25001436",Escola Sol Naixent - ZER El Romaní,Cubells,LLE,LLE,4212690,22/03/2022,1,0,1,0,0,1,0,1,0,0,0,1,1
"25001473",Escola Porcel de Cervera - ZER Pedrera,L'Espluga Calba,LLE,LLE,4214783,23/03/2022,1,1,2,1,0,0,0,1,1,0,1,0,1
"25001539",Escola La Closa,Esterri d'Àneu,LLE,APA,4229002,31/03/2022,1,0,1,4,4,0,0,8,4,4,8,5,2
"25001606",Escola Minyons d'Urgell,Fondarella,LLE,LLE,4219019,25/03/2022,1,0,1,6,0,0,3,9,2,3,5,0,2
"25001618",Escola Guillem Isarn,La Fuliola,LLE,LLE,4216576,24/03/2022,0,0,0,5,4,0,0,9,5,4,9,3,2
"25001692",Escola Francesc Arenes,Golmés,LLE,LLE,4214330,23/03/2022,0,0,0,12,1,0,0,13,6,0,6,10,2
"25001709",Escola Santa Margarida - ZER Alt Berguedà,Gósol,CCE,CCE,4212497,22/03/2022,0,0,0,0,0,0,0,0,0,0,0,0,0
"25001710",Escola de la Granadella - ZER Elaia,La Granadella,LLE,LLE,4225793,29/03/2022,0,0,0,5,1,0,0,6,5,1,6,4,1
"25001722",Escola Sant Jaume - ZER L'Oliver,La Granja d'Escarp,LLE,LLE,4216040,24/03/2022,1,0,1,0,0,5,0,5,0,0,0,2,1
"25001758",Escola de Guimerà - ZER Guicivervi,Guimerà,LLE,LLE,4232245,02/04/2022,0,1,1,0,0,0,1,1,0,1,1,0,1
"25001761",Escola Ramon Faus i Esteve,Guissona,LLE,LLE,4223251,28/03/2022,1,4,5,0,4,14,0,18,14,4,18,14,4
"25001795",Escola Sant Sebastià - ZER Serra Llarga,Ivars de Noguera,LLE,LLE,4229813,31/03/2022,0,1,1,2,0,0,0,2,0,0,0,1,1
"25001801",Escola Mare de Déu de l'Horta,Ivars d'Urgell,LLE,LLE,4229759,31/03/2022,1,1,2,6,0,2,0,8,10,0,10,4,2
"25001886",Escola Aeso - ZER Pallars Jussà,Isona (Isona i Conca Dellà),LLE,APA,4223205,28/03/2022,0,0,0,4,0,0,0,4,0,0,0,2,1
"25001916",Escola L'Espígol - ZER Garrigues Altes,Juncosa,LLE,LLE,4213018,23/03/2022,0,0,0,3,0,0,0,3,3,0,3,0,1
"25001928",Escola Manuel Ortiz i Castelló,Juneda,LLE,LLE,4224628,29/03/2022,0,0,0,10,12,0,0,22,12,10,22,0,6
"25001953",Escola Enric Farreny,Lleida,LLE,LLE,4225867,29/03/2022,1,0,1,8,1,0,0,9,3,1,4,3,2
"25001990",Escola Antoni Bergós - ZER L'Horta de Lleida,Butsènit (Lleida),LLE,LLE,4225495,29/03/2022,0,0,0,0,0,2,0,2,2,0,2,0,1
"25002003",Escola Santa Maria de Gardeny,Lleida,LLE,LLE,4227365,30/03/2022,3,0,3,12,3,0,0,15,12,3,15,12,3
"25002064",Escola Camps Elisis,Lleida,LLE,LLE,4230265,31/03/2022,2,0,2,10,1,0,0,11,0,0,0,10,1
"25002076",Escola La Seu Vella,Lleida,LLE,LLE,4215943,24/03/2022,3,7,10,2,0,2,2,6,0,0,0,4,1
"25002088",Escola Riu Segre,Lleida,LLE,LLE,4234246,04/04/2022,1,0,1,28,0,0,0,28,0,0,0,23,4
"25002091",Escola Magí Morera i Galícia,Lleida,LLE,LLE,4212837,23/03/2022,7,3,10,3,0,2,0,5,0,0,0,3,1
"25002106",Escola Pardinyes,Lleida,LLE,LLE,4222620,28/03/2022,1,0,1,9,2,0,0,11,9,0,9,9,3
"25002121",Escola Príncep de Viana,Lleida,LLE,LLE,4225642,29/03/2022,5,0,5,9,0,0,0,9,9,0,9,3,2
"25002131",Escola Creu del Batlle - ZER L'Horta de Lleida,Lleida,LLE,LLE,4214152,23/03/2022,1,0,1,1,0,0,0,1,1,0,1,1,1
"25002659",Escola Sant Josep de Calassanç,Lleida,LLE,LLE,4214174,23/03/2022,0,0,0,9,0,0,0,9,6,0,6,9,2
"25002672",Escola de Pràctiques I,Lleida,LLE,LLE,4225890,29/03/2022,0,0,0,6,3,0,0,9,0,3,3,7,2
"25002684",Institut Samuel Gili i Gaya,Lleida,LLE,LLE,4225503,29/03/2022,0,1,1,24,0,0,0,24,24,0,24,24,3
"25002696",Institut Marius Torres,Lleida,LLE,LLE,4227526,30/03/2022,1,1,2,24,5,0,0,29,0,0,0,29,0
"25002726",Institut Guindàvols,Lleida,LLE,LLE,4237839,06/04/2022,0,1,1,0,20,0,0,20,0,20,20,0,4
"25002787",Institut Joan Oró,Lleida,LLE,LLE,4231160,01/04/2022,4,0,4,18,4,0,0,22,0,0,0,0,0
"25002799",Institut Caparrella,Lleida,LLE,LLE,4231483,01/04/2022,4,2,6,18,2,15,0,35,0,0,0,0,0
"25002854",Escola El Segrià - ZER L'Horta de Lleida,Llívia (Lleida),LLE,LLE,4223472,28/03/2022,0,0,0,2,0,0,2,4,2,2,4,0,2
"25002921",Escola El Vilot - ZER Ponent,Sucs (Lleida),LLE,LLE,4228865,31/03/2022,0,0,0,3,0,2,0,5,3,0,3,2,1
"25002957",Escola Estudi Alejandro Casona,Les,LLE,APA,4218200,25/03/2022,1,0,1,4,0,0,0,4,4,0,4,0,2
"25002970",Escola El Sitjar,Linyola,LLE,LLE,4230124,31/03/2022,1,2,3,5,0,0,0,5,4,0,4,0,2
"25002982",Escola de Lladurs - ZER El Solsonès,Lladurs,CCE,CCE,4214719,23/03/2022,1,0,1,1,0,0,0,1,0,0,0,1,0
"25003019",Escola Arc d'Adà - ZER L'Oliver,Llardecans,LLE,LLE,4213594,23/03/2022,1,0,1,2,1,0,0,3,2,1,3,2,1
"25003032",Escola de Llavorsí - ZER Alt Pallars Sobirà,Llavorsí,LLE,APA,4239059,06/04/2022,2,0,2,1,0,0,1,2,0,0,0,1,1
"25003056",Escola Portella Blanca - ZER Baridà-Batllia,Lles de Cerdanya,LLE,APA,4238532,06/04/2022,0,0,0,0,1,0,0,1,0,0,0,0,0
"25003093",Escola de Llobera - ZER El Solsonès,Llobera,CCE,CCE,4212287,22/03/2022,1,0,1,0,0,1,1,2,0,1,1,0,0
"25003111",Escola de Massalcoreig - ZER L'Oliver,Massalcoreig,LLE,LLE,4214228,23/03/2022,1,0,1,1,1,0,0,2,1,1,2,3,1
"25003123",Escola Otogesa - ZER L'Oliver,Maials,LLE,LLE,4239134,06/04/2022,0,1,1,3,1,0,0,4,3,1,4,3,2
"25003135",Escola Joan Ros i Porta - ZER El Jonc,Menàrguens,LLE,LLE,4222965,28/03/2022,0,1,1,2,1,0,0,3,1,1,2,1,2
"25003147",Escola Sant Miquel,Miralcamp,LLE,LLE,4218734,25/03/2022,0,0,0,0,7,0,3,10,0,10,10,0,1
"25003202",Institut Mollerussa,Mollerussa,LLE,LLE,4230093,31/03/2022,0,0,0,2,23,0,0,25,2,23,25,0,0
"25003238",Escola de Butsènit - ZER El Sió,Butsènit (Montgai),LLE,LLE,4213754,23/03/2022,0,0,0,1,1,0,0,2,1,1,2,1,1
"25003241",Escola Colomina - ZER El Romaní,Montgai,LLE,LLE,4212486,22/03/2022,1,0,1,0,0,0,1,1,0,1,1,1,1
"25003263",Escola Pere Sarret - ZER Baridà-Batllia,Martinet (Montellà i Martinet),LLE,APA,4236616,05/04/2022,0,0,0,0,0,0,0,0,0,0,0,0,1
"25003275",Escola Ridolaina,Montellà (Montellà i Martinet),LLE,APA,4224634,29/03/2022,0,0,0,1,0,3,0,4,4,0,4,3,2
"25003299",Escola Rosa Campà,Montferrer (Montferrer i Castellbò),LLE,APA,4225066,29/03/2022,1,0,1,5,0,0,0,5,5,0,5,5,1
"25003305",Escola Sant Isidre - ZER La Coma,Montoliu de Lleida,LLE,LLE,4228396,30/03/2022,0,0,0,3,0,0,0,3,3,0,3,3,1
"25003330",Escola Aiguadora - ZER El Solsonès,Navès,CCE,CCE,4214726,23/03/2022,1,0,1,0,0,0,2,2,0,0,0,0,1
"25003469",Escola Miret i Sans - ZER Narieda,Organyà,LLE,APA,4214236,23/03/2022,0,0,0,5,0,0,0,5,5,0,5,5,3
"25003470",Escola L'Espígol - ZER Montsec,Gerb (Os de Balaguer),LLE,LLE,4216541,24/03/2022,0,0,0,0,0,3,0,3,3,0,3,0,1
"25003482",Escola Leandre Cristòfol - ZER Montsec,Os de Balaguer,LLE,LLE,4222711,28/03/2022,0,1,1,0,0,0,1,1,0,1,1,0,1
"25003494",Escola Arnau Berenguer,El Palau d'Anglesola,LLE,LLE,4229148,31/03/2022,0,0,0,10,7,0,0,17,10,7,17,0,4
"25003500",Escola de les Pallargues - ZER La Segarra,Els Plans de Sió,LLE,LLE,4228107,30/03/2022,0,0,0,0,0,4,0,4,1,0,1,0,1
"25003536",Escola de la Coma - ZER El Solsonès,La Coma i la Pedra,CCE,CCE,4230260,31/03/2022,0,0,0,0,0,0,0,0,0,0,0,0,0
"25003551",Escola Ramon Gombal - ZER Espernallac,Penelles,LLE,LLE,4211863,22/03/2022,0,2,2,1,0,0,0,1,0,0,0,1,1
"25003585",Escola Sant Miquel - ZER Narieda,Peramola,LLE,APA,4225784,29/03/2022,0,0,0,0,0,2,0,2,2,0,2,2,1
"25003627",Escola de Sant Climenç - ZER El Solsonès,Sant Climenç (Pinell de Solsonès),CCE,CCE,4216613,24/03/2022,1,0,1,1,0,0,0,1,0,0,0,0,0
"25003652",Escola El Roser - ZER Plaurcén,El Poal,LLE,LLE,4224742,29/03/2022,1,1,2,1,1,0,0,2,1,1,2,0,1
"25003676",Escola Els Set Focs - ZER Elaia,Bellaguarda,LLE,LLE,4215227,23/03/2022,0,0,0,1,0,0,1,2,1,1,2,1,1
"25003688",Escola Els Raiers,La Pobla de Segur,LLE,APA,4238718,06/04/2022,2,1,3,0,0,18,0,18,0,0,0,1,2
"25003718",Escola de Ponts,Ponts,LLE,LLE,4238360,06/04/2022,1,2,3,12,0,0,0,12,0,0,0,10,3
"25003755",Escola Ribagorçana,El Pont de Suert,LLE,APA,4214522,23/03/2022,1,0,1,7,2,0,0,9,7,2,9,5,3
"25003792",Escola Blanca de Villalonga - ZER Alt Segrià,La Portella,LLE,LLE,4230657,31/03/2022,1,0,1,1,0,0,0,1,1,0,1,0,1
"25003809",Escola Montalbà - ZER Riu Corb,Preixana,LLE,LLE,4227323,30/03/2022,0,0,0,3,0,0,0,3,3,0,3,0,1
"25003810",Escola de Preixens - ZER El Sió,Preixens,LLE,LLE,4212982,23/03/2022,0,1,1,0,0,0,1,1,0,0,0,1,1
"25003822",Escola de Les Ventoses - ZER El Sió,Les Ventoses (Preixens),LLE,LLE,4226097,29/03/2022,0,0,0,1,0,0,0,1,1,0,1,1,0
"25003846",Escola El Puig - ZER Baridà-Batllia,Prullans,LLE,APA,4212264,22/03/2022,0,0,0,0,0,0,1,1,0,0,0,1,1
"25003858",Escola de Puigverd d'Agramunt - ZER El Sió,Puigverd d'Agramunt,LLE,LLE,4225940,29/03/2022,0,0,0,1,0,0,0,1,1,0,1,1,0
"25003861",Escola Sant Jordi,Puigverd de Lleida,LLE,LLE,4215585,24/03/2022,1,0,1,2,2,0,0,4,2,2,4,2,1
"25003871",Escola Montsent de Pallars - ZER Alt Pallars Sobirà,Rialp,LLE,APA,4222691,28/03/2022,0,0,0,2,3,0,0,5,0,2,2,1,1
"25003895",Escola Els Minairons - ZER Alt Pallars Sobirà,Ribera de Cardós (Vall de Cardós),LLE,APA,4223458,28/03/2022,2,0,2,1,0,1,0,2,2,0,2,0,0
"25003950",Escola Arnau Mir - ZER Urgellet,El Pla de Sant Tirs (Ribera d'Urgellet),LLE,APA,4214327,23/03/2022,0,1,1,2,0,1,0,3,3,0,3,3,2
"25003974",Escola de Freixinet de Solsona - ZER El Solsonès,Riner,CCE,CCE,4215601,24/03/2022,1,0,1,1,0,0,0,1,1,0,1,0,0
"25004000",Escola La Rosella,Rosselló,LLE,LLE,4218987,25/03/2022,1,1,2,11,0,0,6,17,11,6,17,11,4
"25004024",Escola de Sanaüja - ZER La Segarra,Sanaüja,LLE,LLE,4213052,23/03/2022,0,0,0,3,0,0,0,3,0,0,0,2,1
"25004036",Escola L'Estel,Sant Guim de Freixenet,LLE,LLE,4213756,23/03/2022,0,0,0,8,7,0,0,15,8,7,15,0,2
"25004073",Escola Mare de Déu de la Mercè,Sant Ramon,LLE,LLE,4211880,22/03/2022,2,0,2,0,0,2,0,2,0,0,0,0,0
"25004085",Escola Vall Ondara - ZER La Segarra,Els Hostalets (Ribera d'Ondara),LLE,LLE,4228269,30/03/2022,0,0,0,3,0,0,0,3,3,0,3,0,1
"25004103",Escola El Tallat - ZER Riu Corb,Sant Martí de Maldà (Sant Martí de Riucorb),LLE,LLE,4217928,25/03/2022,0,0,0,1,1,0,0,2,1,1,2,1,1
"25004115",Escola La Roca - ZER L'Eral,Sarroca de Lleida,LLE,LLE,4214425,23/03/2022,0,0,0,0,1,0,0,1,0,1,1,0,0
"25004140",Escola Mossèn Albert Vives,La Seu d'Urgell,LLE,APA,4213791,23/03/2022,12,0,12,3,0,15,0,18,18,0,18,16,5
"25004188",Institut Joan Brudieu,La Seu d'Urgell,LLE,APA,4225477,29/03/2022,0,0,0,28,0,0,0,28,0,0,0,28,0
"25004218",Escola Miquel Baró Daban,Seròs,LLE,LLE,4218750,25/03/2022,2,0,2,11,0,0,0,11,0,0,0,11,2
"25004221",Escola El Timó - ZER Plaurcén,Sidamon,LLE,LLE,4216714,24/03/2022,0,0,0,0,1,2,0,3,2,0,2,0,1
"25004231",Escola del Soleràs - ZER Garrigues Altes,El Soleràs,LLE,LLE,4214030,23/03/2022,0,0,0,2,0,0,0,2,2,0,2,2,1
"25004243",Escola Setelsis,Solsona,CCE,CCE,4211959,22/03/2022,0,0,0,16,3,0,0,19,6,0,6,16,2
"25004395",Escola Jaume Miret,Soses,LLE,LLE,4237859,06/04/2022,1,0,1,7,0,0,2,9,3,1,4,0,2
"25004401",Escola El Roser - ZER La Coma,Sudanell,LLE,LLE,4213203,23/03/2022,0,1,1,4,0,0,0,4,4,0,4,4,1
"25004413",Escola de Sunyer - ZER L'Eral,Sunyer,LLE,LLE,4225630,29/03/2022,1,1,2,0,1,0,0,1,0,1,1,0,1
"25004462",Escola Jacint Verdaguer,Tàrrega,LLE,LLE,4227285,30/03/2022,1,1,2,16,3,0,0,19,16,3,19,16,7
"25004498",Institut Manuel de Pedrolo,Tàrrega,LLE,LLE,4226515,29/03/2022,1,1,2,16,0,0,0,16,16,0,16,16,17
"25004528",EA Ondara,Tàrrega,LLE,LLE,4214148,23/03/2022,0,0,0,0,5,0,0,5,0,0,0,0,0
"25004531",Escola Àngel Guimerà,Tàrrega,LLE,LLE,4227949,30/03/2022,1,0,1,18,0,4,0,22,22,0,22,0,4
"25004565",Escola Alfred Potrony,Térmens,LLE,LLE,4229258,31/03/2022,0,0,0,1,0,3,2,6,1,2,3,2,1
"25004577",Escola de Tírvia - ZER Alt Pallars Sobirà,Tírvia,LLE,APA,4228244,30/03/2022,0,0,0,0,0,0,1,1,0,1,1,1,0
"25004607",Escola Sant Gil,Torà,LLE,LLE,4227482,30/03/2022,0,1,1,7,0,5,0,12,3,0,3,8,1
"25004644",Escola Espígol - ZER Riu Ondara,Tornabous,LLE,LLE,4223497,28/03/2022,0,0,0,6,0,0,0,6,3,0,3,0,1
"25004656",Escola de Torrebesses - ZER L'Eral,Torrebesses,LLE,LLE,4216127,24/03/2022,0,0,0,2,0,0,0,2,2,0,2,0,0
"25004711",Escola la Creu,Torrefarrera,LLE,LLE,4229593,31/03/2022,1,0,1,20,0,0,0,20,20,0,20,17,6
"25004723",Escola La Bassa,Torregrossa,LLE,LLE,4221660,28/03/2022,1,7,8,3,6,0,0,9,3,6,9,0,4
"25004747",Escola Carrassumada,Torres de Segre,LLE,LLE,4225984,29/03/2022,0,2,2,7,0,0,0,7,0,0,0,7,2
"25004759",Escola El Roser - ZER Alt Segrià,Torre-serona,LLE,LLE,4215761,24/03/2022,1,0,1,0,0,0,1,1,0,1,1,0,0
"25004772",Escola Valldeflors,Tremp,LLE,APA,4212906,23/03/2022,13,0,13,0,0,7,0,7,0,0,0,17,4
"25004826",Escola de Tuixent - ZER Urgellet,Tuixén (Josa i Tuixén),LLE,APA,4212516,22/03/2022,0,0,0,0,0,1,0,1,0,0,0,1,0
"25004851",Escola Salvador Espriu,Vallfogona de Balaguer,LLE,LLE,4229202,31/03/2022,2,2,4,0,0,5,1,6,2,1,3,6,2
"25004863",Escola Jardí - ZER Guicivervi,Verdú,LLE,LLE,4238999,06/04/2022,0,0,0,4,0,0,0,4,0,4,4,3,1
"25004929",Escola Garona,Vielha (Vielha e Mijaran),LLE,APA,4231302,01/04/2022,0,0,0,18,4,0,0,22,18,4,22,21,7
"25004966",Escola Ramon Perelló - ZER Guicivervi,Vilagrassa,LLE,LLE,4226157,29/03/2022,0,0,0,3,1,0,0,4,3,1,4,4,2
"25004981",Escola Vidal i Abad - ZER Alta Ribagorça,Vilaller,LLE,APA,4239879,07/04/2022,0,1,1,3,0,0,0,3,0,0,0,2,1
"25005016",Escola Marinada,Vilanova de Bellpuig,LLE,LLE,4216106,24/03/2022,3,5,8,5,0,0,2,7,0,0,0,0,2
"25005053",Escola Mare de Déu del Puig de Meià - ZER El Romaní,Vilanova de Meià,LLE,LLE,4238100,06/04/2022,0,2,2,0,0,0,1,1,0,1,1,0,1
"25005065",Escola de Vilanova de Segrià - ZER Alt Segrià,Vilanova de Segrià,LLE,LLE,4229406,31/03/2022,0,0,0,1,0,4,0,5,5,0,5,0,1
"25005077",Escola Mossèn Ton Clavé - ZER Vent Serè,Vila-sana,LLE,LLE,4218336,25/03/2022,2,0,2,3,0,0,0,3,3,0,3,4,1
"25005090",Escola Mestral - ZER Argelaga,Vilanova de la Barca,LLE,LLE,4227563,30/03/2022,0,0,0,4,1,0,0,5,4,1,5,3,1
"25005107",Escola Sant Bonifaci - ZER Riu Set,Vinaixa,LLE,LLE,4215811,24/03/2022,1,0,1,2,0,0,0,2,2,0,2,0,0
"25005119",Escola Pinyana,Alfarràs,LLE,LLE,4217737,25/03/2022,9,1,10,0,0,0,0,0,0,0,0,0,2
"25005120",Escola Teresa Bergadà,Alguaire,LLE,LLE,MANUAL,44659,0,0,0,13,0,0,0,13,0,0,0,0,2
"25005144",Escola Àngel Serafí i Casanovas,Sort,LLE,APA,4221369,28/03/2022,0,0,0,12,2,0,0,14,7,1,8,14,4
"25005171",Escola Mestre Ignasi Peraire,Mollerussa,LLE,LLE,4227533,30/03/2022,6,0,6,11,0,0,0,11,11,0,11,11,4
"25005260",Institut Ribera del Sió,Agramunt,LLE,LLE,4215900,24/03/2022,2,0,2,5,7,0,0,12,0,0,0,5,0
"25005429",Institut Els Planells,Artesa de Segre,LLE,LLE,4239415,07/04/2022,1,0,1,0,2,0,0,2,0,0,0,0,2
"25005430",Escola Joan XXIII,Lleida,LLE,LLE,4223417,28/03/2022,1,1,2,12,0,0,0,12,6,6,12,6,4
"25005442",Institut Escola del Treball,Lleida,LLE,LLE,4227322,30/03/2022,0,10,10,7,7,1,0,15,0,0,0,5,3
"25005454",Institut Francesc Ribalta,Solsona,CCE,CCE,4229919,31/03/2022,10,1,11,20,0,0,0,20,0,0,0,6,0
"25005533",Escola Pau Claris,La Seu d'Urgell,LLE,APA,4238700,06/04/2022,2,0,2,12,0,0,2,14,12,2,14,12,2
"25005545",Escola Pompeu Fabra,Mollerussa,LLE,LLE,4222410,28/03/2022,0,0,0,19,0,0,0,19,0,0,0,0,4
"25005557",CEE Siloé,Mollerussa,LLE,LLE,4213338,23/03/2022,4,1,5,1,0,1,0,2,2,0,2,1,0
"25005582",Institut Terres de Ponent,Mollerussa,LLE,LLE,4218221,25/03/2022,1,0,1,16,1,0,0,17,0,0,0,17,0
"25005673",Escola Joan Maragall,Lleida,LLE,LLE,4211920,22/03/2022,1,0,1,0,13,0,0,13,0,13,13,0,3
"25005685",Institut La Segarra,Cervera,LLE,LLE,4228835,31/03/2022,3,18,21,12,1,2,0,15,0,0,0,13,0
"25005727",Institut Almatà,Balaguer,LLE,LLE,4231491,01/04/2022,5,0,5,26,2,0,0,28,0,0,0,3,3
"25005880",Escola Frederic Godas,Lleida,LLE,LLE,4225803,29/03/2022,2,2,4,6,0,0,0,6,0,0,0,6,2
"25005892",Escola Maldanell - ZER Riu Corb,Maldà,LLE,LLE,4217040,24/03/2022,0,1,1,1,0,0,0,1,0,0,0,0,0
"25005909",Escola Mossèn Ramon Muntanyola - ZER Riu Corb,Els Omells de Na Gaia,LLE,LLE,4238098,06/04/2022,1,0,1,0,0,0,0,0,0,0,0,0,0
"25005910",Escola Abat Ruera - ZER Pedrera,Puiggròs,LLE,LLE,4214435,23/03/2022,0,2,2,2,0,0,0,2,2,0,2,0,3
"25005983",Escola Sant Serni - ZER Baridà-Batllia,Prats i Sansor,LLE,APA,4236630,05/04/2022,1,0,1,0,0,1,0,1,1,0,1,1,1
"25006069",Escola d'Ardèvol - ZER El Solsonès,Ardèvol (Pinós),CCE,CCE,4231121,01/04/2022,1,0,1,0,0,0,1,1,0,1,1,1,1
"25006148",Institut d'Ostalaria de Les-Val d'Aran,Les,LLE,APA,4213750,23/03/2022,0,0,0,8,3,0,0,11,0,0,0,0,0
"25006227",Institut d'Almenar,Almenar,LLE,LLE,4214181,23/03/2022,1,0,1,0,0,0,10,10,0,0,0,0,0
"25006239",Institut d'Aran,Vielha (Vielha e Mijaran),LLE,APA,4231239,01/04/2022,1,0,1,4,6,0,0,10,4,6,10,0,1
"25006240",Institut El Pont de Suert,El Pont de Suert,LLE,APA,4218204,25/03/2022,0,0,0,18,0,0,0,18,0,0,0,18,0
"25006252",EOI de Lleida,Lleida,LLE,LLE,4231997,01/04/2022,0,1,1,22,0,0,0,22,0,0,0,0,1
"25006264",Escola Espiga,Lleida,LLE,LLE,4223520,28/03/2022,0,3,3,18,2,0,0,20,18,2,20,20,4
"25006276",Escola Sant Jordi,Lleida,LLE,LLE,4214285,23/03/2022,0,0,0,9,0,0,0,9,2,0,2,9,2
"25006288",Institut de Tremp,Tremp,LLE,APA,4227402,30/03/2022,1,2,3,9,11,0,0,20,9,11,20,1,0
"25006291",Institut Hug Roger III,Sort,LLE,APA,4227611,30/03/2022,2,0,2,0,12,0,2,14,0,0,0,0,0
"25006409",Escola Joc de la Bola,Lleida,LLE,LLE,4231729,01/04/2022,19,0,19,0,1,3,0,4,3,0,3,2,5
"25006410",CFA Segrià,Lleida,LLE,LLE,4231248,01/04/2022,0,3,3,1,0,3,0,4,0,0,0,4,0
"25006483",Institut Canigó,Almacelles,LLE,LLE,4227324,30/03/2022,0,0,0,18,0,0,2,20,18,2,20,4,8
"25006495",Institut Josep Lladonosa,Lleida,LLE,LLE,4212802,23/03/2022,2,0,2,15,3,0,0,18,15,3,18,15,10
"25006501",Escola Alba,Corbins,LLE,LLE,4222765,28/03/2022,0,0,0,18,0,0,0,18,18,0,18,18,4
"25006513",Institut Manuel de Montsuar,Lleida,LLE,LLE,4222503,28/03/2022,3,0,3,19,0,0,0,19,19,0,19,0,11
"25006525",Institut Josep Vallverdú,Les Borges Blanques,LLE,LLE,4215406,24/03/2022,1,0,1,25,0,0,0,25,25,0,25,25,7
"25006549",Escola d'Espluga de Serra - ZER Alta Ribagorça,Espluga de Serra (Tremp),LLE,APA,4215772,24/03/2022,0,0,0,1,0,0,0,1,1,0,1,3,0
"25006574",Institut de Ponts,Ponts,LLE,LLE,4229081,31/03/2022,0,0,0,8,0,0,0,8,8,0,8,5,0
"25006598",Institut Lo Pla d'Urgell,Bellpuig,LLE,LLE,4227240,30/03/2022,3,0,3,17,0,0,0,17,17,0,17,15,0
"25006720",Institut d'Hoteleria i Turisme,Lleida,LLE,LLE,4229166,31/03/2022,0,0,0,3,1,3,0,7,6,1,7,6,1
"25006732",Institut Torrevicens,Lleida,LLE,LLE,4229910,31/03/2022,2,2,4,30,6,2,3,41,0,0,0,3,4
"25006744",CEE Esperança,Lleida,LLE,LLE,4222612,28/03/2022,6,0,6,1,4,0,0,5,1,4,5,1,0
"25006771",Institut Ronda,Lleida,LLE,LLE,4224975,29/03/2022,0,3,3,22,2,0,0,24,22,2,24,22,2
"25006781",Institut Alfons Costafreda,Tàrrega,LLE,LLE,4231991,01/04/2022,2,2,4,14,6,6,0,26,0,3,3,24,6
"25007025",Institut Morelló,Esterri d'Àneu,LLE,APA,4221701,28/03/2022,0,0,0,3,1,0,0,4,0,1,1,3,4
"25007153",Institut d'Alcarràs,Alcarràs,LLE,LLE,4215842,24/03/2022,3,0,3,13,6,0,0,19,0,6,6,22,22
"25007189",Institut Maria Rúbies,Lleida,LLE,LLE,4226776,30/03/2022,0,0,0,22,0,0,0,22,0,0,0,22,0
"25007499",Institut l'Olivera,La Granadella,LLE,LLE,4224791,29/03/2022,0,0,0,5,0,0,0,5,0,0,0,0,0
"25007505",Institut de Guissona,Guissona,LLE,LLE,4224425,29/03/2022,0,0,0,6,2,0,0,8,0,2,2,5,5
"25007517",Institut La Serra,Mollerussa,LLE,LLE,4231537,01/04/2022,0,0,0,14,2,0,0,16,0,0,0,8,0
"25007529",Institut Seròs,Seròs,LLE,LLE,4233823,04/04/2022,2,0,2,0,0,0,0,0,0,0,0,0,2
"25007611",CFA Victorina Vila,Lleida,LLE,LLE,4217415,25/03/2022,0,0,0,4,0,3,0,7,0,0,0,4,0
"25007700",Institut Ermengol IV,Bellcaire d'Urgell,LLE,LLE,4215328,24/03/2022,1,0,1,12,0,0,0,12,0,0,0,12,2
"25007992",Escola d'Almenar,Almenar,LLE,LLE,4238122,06/04/2022,7,0,7,0,0,10,0,10,0,0,0,0,0
"25008212",Escola Pràctiques II,Lleida,LLE,LLE,4223463,28/03/2022,1,20,21,6,0,3,0,9,9,0,9,5,2
"25008352",Institut de La Pobla de Segur,La Pobla de Segur,LLE,APA,4226354,29/03/2022,1,0,1,10,0,0,0,10,0,0,0,4,1
"25008534",Escola de La Vall de Boí - ZER Alta Ribagorça,Barruera (La Vall de Boí),LLE,APA,4239322,07/04/2022,0,0,0,6,1,0,0,7,6,2,8,6,1
"25008546",EOI de Tàrrega,Tàrrega,LLE,LLE,4230997,01/04/2022,0,0,0,0,7,0,0,7,0,0,0,0,1
"25008558",EOI de La Seu d'Urgell,La Seu d'Urgell,LLE,APA,4213840,23/03/2022,0,0,0,0,7,0,0,7,0,7,7,0,0
"25008561",CFA Balaguer,Balaguer,LLE,LLE,4214578,23/03/2022,0,1,1,0,3,0,0,3,0,3,3,0,1
"25008571",CFA Joan Comorera,Cervera,LLE,LLE,4223588,28/03/2022,0,0,0,4,0,0,0,4,0,0,0,4,0
"25008583",CFA La Seu d'Urgell,La Seu d'Urgell,LLE,APA,4218746,25/03/2022,0,0,0,0,0,0,0,0,0,0,0,0,0
"25008595",CFA Tàrrega,Tàrrega,LLE,LLE,4218694,25/03/2022,1,0,1,4,1,0,0,5,0,1,1,1,1
"25008625",CFA Mollerussa,Mollerussa,LLE,LLE,4238461,06/04/2022,0,1,1,0,3,0,0,3,0,0,0,0,0
"25008649",Escola Francesco Tonucci,Lleida,LLE,LLE,4222668,28/03/2022,5,3,8,4,0,0,0,4,0,0,0,4,3
"25008741",CFA Val d'Aran,Vielha (Vielha e Mijaran),LLE,APA,4227076,30/03/2022,0,0,0,0,0,0,0,0,0,0,0,0,0
"25008753",CFA Solsonès,Solsona,CCE,CCE,4215905,24/03/2022,0,0,0,2,1,0,0,3,2,1,3,2,0
"25008765",Escola La Vall Fosca - ZER Pallars Jussà,La Plana de Mont-ros (La Torre de Cabdella),LLE,APA,4227601,30/03/2022,0,0,0,5,0,0,0,5,5,0,5,5,3
"25008777",Escola Parc de l'Aigua,Lleida,LLE,LLE,4229809,31/03/2022,0,10,10,3,1,6,0,10,4,0,4,6,4
"25008789",Escola Mont-roig,Balaguer,LLE,LLE,4231188,01/04/2022,1,0,1,11,0,0,0,11,0,0,0,0,4
"25008790",Escola Maria-Mercè Marçal,Tàrrega,LLE,LLE,4226780,30/03/2022,2,0,2,0,0,0,14,14,0,14,14,14,4
"25008893",Escola Parc del Saladar,Alcarràs,LLE,LLE,4231235,01/04/2022,5,0,5,19,0,0,0,19,6,0,6,16,6
"25008923",CFA Enric Granados,Lleida,LLE,LLE,4238125,06/04/2022,0,0,0,0,0,0,0,0,0,0,0,0,0
"25008935",Escola La Ràpita - ZER El Jonc,La Ràpita (Vallfogona de Balaguer),LLE,LLE,4216814,24/03/2022,0,0,0,3,1,0,0,4,3,1,4,0,2
"25008984",CFA Tremp,Tremp,LLE,APA,4216129,24/03/2022,0,1,1,1,0,0,1,2,1,0,1,2,0
"25009034",Escola Ciutat Jardí,Lleida,LLE,LLE,4231251,01/04/2022,0,10,10,10,1,0,0,11,10,1,11,6,4
"25009071",Escola Països Catalans,Lleida,LLE,LLE,4233241,04/04/2022,0,0,0,0,3,0,0,3,0,3,3,0,4
"25009095",Escola Les Savines,Cervera,LLE,LLE,4226006,29/03/2022,1,0,1,3,6,0,0,9,3,6,9,0,2
"25009101",Escola El Vinyet,Solsona,CCE,CCE,4231049,01/04/2022,0,0,0,9,0,0,0,9,0,0,0,9,1
"25009113",Escola Mestre Ramon Estadella i Torradeflot,Guissona,LLE,LLE,4225429,29/03/2022,2,0,2,15,2,0,0,17,15,2,17,15,3
"25009186",Institut La Valira,La Seu d'Urgell,LLE,APA,4229099,31/03/2022,1,0,1,8,1,0,0,9,8,1,9,8,0
"25009344",Escola La Mitjana,Lleida,LLE,LLE,4223454,28/03/2022,0,0,0,14,4,0,0,18,14,0,14,0,4
"25009356",Escola Les Arrels,Mollerussa,LLE,LLE,4224007,28/03/2022,1,4,5,7,0,0,0,7,0,0,0,6,1
"25009368",Escola La Valira-ZER Urgellet,La Seu d'Urgell,LLE,APA,4229500,31/03/2022,0,0,0,0,1,0,0,1,0,1,1,0,0
"25009721",Institut d'Alpicat,Alpicat,LLE,LLE,4218066,25/03/2022,6,0,6,0,0,1,5,6,0,0,0,0,1
"25009733",Institut Joan Solà,Torrefarrera,LLE,LLE,4232011,01/04/2022,7,0,7,16,3,0,0,19,0,0,0,0,0
"25009800",Escola Torrelameu - ZER Argelaga,Torrelameu,LLE,LLE,MANUAL,44659,1,0,1,3,0,0,0,3,0,0,0,0,1
"25009836",Institut La Mitjana,Lleida,LLE,LLE,4218556,25/03/2022,1,7,8,18,0,0,0,18,0,0,0,18,1
"25010085",Escola Josep Mañé i Gavaldà - ZER Ponent,Raïmat (Lleida),LLE,LLE,4238005,06/04/2022,0,0,0,0,2,0,2,4,0,4,4,0,1
"25010127",Institut Castell dels Templers,Lleida,LLE,LLE,4213163,23/03/2022,0,0,0,4,0,9,0,13,0,0,0,0,2
"25010231",Escola de Salàs de Pallars - ZER Pallars Jussà,Salàs de Pallars,LLE,APA,4231493,01/04/2022,2,0,2,3,1,0,0,4,0,1,1,0,1
"25010280",Institut Escola Torre Queralt,Lleida,LLE,LLE,4217661,25/03/2022,1,4,5,0,0,5,0,5,0,0,0,18,6
"25010310",Institut de Mollerussa IV,Mollerussa,LLE,LLE,4227184,30/03/2022,9,0,9,0,0,0,0,0,0,0,0,0,10
"25010334",Institut Escola Magraners,Lleida,LLE,LLE,4218754,25/03/2022,4,0,4,7,1,0,0,8,7,1,8,4,5
"25010358",Institut Escola Vall de Lord,Sant Llorenç de Morunys,CCE,CCE,4218302,25/03/2022,1,4,5,0,5,0,2,7,2,5,7,5,5
"25010361",Institut Centre d'Esports de Muntanya del Pallars,La Pobla de Segur,LLE,APA,4216457,24/03/2022,0,0,0,4,2,2,2,10,2,2,4,0,0
"25010383",Institut Escola d'Oliana,Oliana,LLE,APA,4232028,01/04/2022,1,3,4,14,1,0,0,15,0,0,0,11,0
"43000020",Escola Sant Miquel,El Pla de Manlleu (Aiguamúrcia),TAR,TAR,4236878,05/04/2022,1,1,2,2,1,0,0,3,2,0,2,2,1
"43000081",Escola Joan Baptista Serra,Alcanar,TEB,TEB,4229201,31/03/2022,21,0,21,14,4,0,0,18,0,1,1,9,8
"43000135",Escola Mare de Déu del Remei,Alcover,TAR,TAR,4214419,23/03/2022,1,0,1,24,0,0,0,24,0,0,0,23,6
"43000184",Escola Teresa Salvat i Llauradó - ZER Baix Camp Nord,L'Aleixar,TAR,TAR,4235495,04/04/2022,1,0,1,0,0,3,2,5,3,2,5,3,2
"43000214",Escola Josep Fusté,Alforja,TAR,TAR,4222666,28/03/2022,1,5,6,5,0,0,0,5,2,0,2,0,2
"43000226",Escola La Barquera - ZER Atzavara,Alió,TAR,TAR,4236597,05/04/2022,1,1,2,1,0,1,0,2,0,0,0,0,1
"43000251",Escola La Portalada,Altafulla,TAR,TAR,4229949,31/03/2022,0,2,2,18,0,0,0,18,0,0,0,13,4
"43000263",Escola Sant Jordi,L'Ametlla de Mar,TEB,TEB,4233430,04/04/2022,0,0,0,22,1,0,0,23,10,0,10,23,6
"43000275",Escola Miquel Granell,Amposta,TEB,TEB,4237662,06/04/2022,0,8,8,16,2,0,0,18,0,2,2,8,5
"43000329",Institut Ramon Berenguer IV,Amposta,TEB,TEB,4228059,30/03/2022,1,20,21,4,0,5,1,10,0,1,1,9,0
"43000378",Escola Sant Julià,L'Arboç,TAR,PEN,4233548,04/04/2022,0,0,0,0,19,0,0,19,0,19,19,19,2
"43000421",Escola La Miranda - ZER Ports-Algars,Arnes,TEB,TEB,4229474,31/03/2022,1,0,1,0,0,2,1,3,1,1,2,3,2
"43000433",Escola Sant Miquel,Ascó,TEB,TEB,4225795,29/03/2022,3,0,3,8,1,0,0,9,3,0,3,8,1
"43000470",Escola Valldemur - ZER Conca de Barberà,Barberà de la Conca,TAR,TAR,4230243,31/03/2022,1,0,1,3,0,0,0,3,3,0,3,3,1
"43000512",Escola El Sarraí - ZER Baix Priorat,Bellmunt del Priorat,TAR,TAR,4214709,23/03/2022,1,0,1,0,0,0,0,0,1,0,1,0,0
"43000548",Escola La Muntanyeta,Bellvei,TAR,PEN,4214468,23/03/2022,1,1,2,13,0,0,0,13,13,0,13,8,4
"43000551",Escola Llorenç Vallespí i Vidiella - ZER Riu i Serra,Benifallet,TEB,TEB,4227909,30/03/2022,1,0,1,3,0,0,0,3,3,0,3,2,1
"43000561",Escola Antoni Nat - ZER Benissanet-Miravet,Benissanet,TEB,TEB,4226962,30/03/2022,0,2,2,5,1,0,0,6,3,1,4,4,2
"43000597",Escola Ull del Vent,La Bisbal del Penedès,TAR,PEN,4230056,31/03/2022,0,0,0,16,1,0,0,17,16,1,17,17,4
"43000603",Escola de Blancafort - ZER Poblet,Blancafort,TAR,TAR,4236755,05/04/2022,1,0,1,2,0,0,0,2,2,0,2,0,1
"43000615",Escola L'Estel - ZER Els Ceps,Bonastre,TAR,PEN,4235125,04/04/2022,1,0,1,0,4,0,0,4,0,1,1,4,1
"43000627",Escola Rocabruna,Les Borges del Camp,TAR,TAR,4216201,24/03/2022,0,0,0,9,0,0,0,9,3,0,3,9,1
"43000639",Escola Sant Blai - ZER Terra Alta-Centre,Bot,TEB,TEB,4231966,01/04/2022,0,0,0,3,1,0,0,4,3,1,4,1,2
"43000640",Escola Mare de Déu de la Candela,Botarell,TAR,TAR,4223853,28/03/2022,1,1,2,0,8,0,0,8,0,8,8,1,1
"43000652",Escola Sant Jaume de Bràfim - ZER Atzavara,Bràfim,TAR,TAR,4230902,01/04/2022,1,0,1,0,4,0,0,4,0,2,2,5,0
"43000676",Escola El Castell - ZER Montsant,Cabacés,TAR,TAR,4213106,23/03/2022,1,0,1,0,2,0,0,2,0,0,0,1,1
"43000688",Escola de Cabra del Camp - ZER La Parellada,Cabra del Camp,TAR,TAR,4211889,22/03/2022,0,0,0,1,3,0,0,4,1,3,4,0,0
"43000706",Escola Santa Creu de Calafell,Calafell,TAR,PEN,4229049,31/03/2022,2,4,6,21,0,0,0,21,0,0,0,18,6
"43000721",Escola Mossèn Jacint Verdaguer,Segur de Calafell (Calafell),TAR,PEN,4236412,05/04/2022,1,4,5,17,0,0,0,17,17,0,17,12,4
"43000779",Institut Ramon Berenguer IV,Cambrils,TAR,TAR,4236285,05/04/2022,1,0,1,24,1,0,0,25,24,1,25,25,18
"43000792",Escola Sant Isidre - ZER Les Vinyes,Capçanes,TAR,TAR,4225706,29/03/2022,1,0,1,0,0,0,1,1,0,1,1,0,0
"43000809",Escola La Gessera - ZER Ports-Algars,Caseres,TEB,TEB,4213954,23/03/2022,1,0,1,0,0,0,1,1,0,0,0,0,1
"43000871",Escola Maria Jesús Ortí i Abella,La Sénia,TEB,TEB,4225461,29/03/2022,15,2,17,0,1,17,2,20,17,3,20,13,6
"43000895",Escola Mossèn Ramon Bergadà,Constantí,TAR,TAR,4215386,24/03/2022,0,1,1,14,0,0,4,18,0,0,0,14,4
"43000950",Escola Doctor Ferran - ZER Terra Alta-Centre,Corbera d'Ebre,TEB,TEB,4229387,31/03/2022,1,0,1,1,2,0,0,3,1,2,3,2,2
"43000998",Escola Pompeu Fabra,Cunit,TAR,PEN,4239927,07/04/2022,0,0,0,13,1,0,0,14,6,1,7,14,3
"43001000",Escola de Xerta,Xerta,TEB,TEB,4225365,29/03/2022,1,0,1,5,0,0,0,5,3,0,3,5,2
"43001036",Escola Martí Poch,L'Espluga de Francolí,TAR,TAR,4214012,23/03/2022,1,0,1,9,2,0,0,11,0,0,0,0,2
"43001051",Escola Antoni Vilanova,Falset,TAR,TAR,4237330,05/04/2022,0,0,0,16,1,0,0,17,0,1,1,12,2
"43001097",Escola Los Castellets - ZER Terra Alta Nord,La Fatarella,TEB,TEB,4223120,28/03/2022,1,0,1,0,0,0,3,3,0,0,0,0,1
"43001115",Escola Mare de Déu de l'Esperança - ZER La Parellada,Figuerola del Camp,TAR,TAR,4212025,22/03/2022,0,0,0,3,0,0,0,3,3,0,3,1,1
"43001127",Escola Enric Grau i Fontserè,Flix,TEB,TEB,4236157,05/04/2022,5,1,6,14,0,0,0,14,6,0,6,14,5
"43001231",Escola Puig Cavaller,Gandesa,TEB,TEB,4236538,05/04/2022,5,0,5,0,17,0,0,17,0,9,9,5,6
"43001280",Escola Pàmies - ZER La Font de l'Aiguadí,Ginestar,TEB,TEB,4232949,03/04/2022,1,0,1,0,1,0,2,3,0,3,3,0,1
"43001310",Escola Llicorella - ZER L'Aglà,Gratallops,TAR,TAR,4227696,30/03/2022,1,0,1,0,0,0,1,1,0,0,0,0,0
"43001334",Escola Sant Feliu - ZER Les Vinyes,Els Guiamets,TAR,TAR,4212937,23/03/2022,1,0,1,0,0,0,1,1,0,1,1,0,0
"43001346",Escola Montsagre,Horta de Sant Joan,TEB,TEB,4236830,05/04/2022,4,0,4,0,0,3,2,5,0,2,2,4,1
"43001361",Escola Les Cometes,Llorenç del Penedès,TAR,PEN,4225450,29/03/2022,0,0,0,6,10,0,0,16,6,10,16,0,2
"43001383",Escola Anicet Villar - ZER Les Vinyes,Marçà,TAR,TAR,4212946,23/03/2022,1,0,1,0,0,0,1,1,0,1,1,0,1
"43001395",Escola Teresa Subirats i Mestre - ZER Montsià,Mas de Barberans,TEB,TEB,4212911,23/03/2022,0,1,1,3,0,0,0,3,0,0,0,1,1
"43001437",Escola Rosa Gisbert - ZER Montsià,Masdenverge,TEB,TEB,4227378,30/03/2022,1,0,1,5,0,0,0,5,5,0,5,2,1
"43001462",Escola Els Til·lers - ZER El Francolí,La Masó,TAR,TAR,4226712,30/03/2022,1,0,1,0,0,1,0,1,1,0,1,0,0
"43001498",Escola Onze de Setembre - ZER Baix Priorat,El Masroig,TAR,TAR,4222772,28/03/2022,1,0,1,0,0,0,2,2,0,0,0,0,0
"43001553",Escola Les Muralles,Montblanc,TAR,TAR,4236915,05/04/2022,4,0,4,18,1,0,2,21,18,3,21,20,4
"43001607",Escola Josep M. Soler i Gené,Montbrió del Camp,TAR,TAR,4212856,23/03/2022,1,0,1,15,0,0,0,15,16,0,16,16,4
"43001656",Escola Teresa Godes i Domènech,La Juncosa del Montmell (El Montmell),TAR,PEN,4230919,01/04/2022,1,0,1,7,1,0,0,8,0,1,1,3,1
"43001668",Escola Mare de Déu de la Roca,Mont-roig del Camp,TAR,TAR,4237073,05/04/2022,0,2,2,20,0,0,0,20,20,0,20,0,2
"43001681",Escola Lluís Viñas i Viñoles,Móra d'Ebre,TEB,TEB,4236640,05/04/2022,0,6,6,14,1,4,0,19,7,1,8,19,3
"43001735",Escola Ventura Gassol,El Morell,TAR,TAR,4230605,31/03/2022,2,1,3,25,0,4,0,29,29,0,29,27,6
"43001796",Escola Sant Sebastià,Nulles,TAR,TAR,4215205,23/03/2022,1,0,1,4,0,0,0,4,4,0,4,0,1
"43001826",Escola Sant Sebastià,Els Pallaresos,TAR,TAR,4223261,28/03/2022,1,2,3,13,1,0,0,14,13,1,14,4,4
"43001851",Escola Sant Roc - ZER Riu i Serra,Paüls,TEB,TEB,4226893,30/03/2022,1,0,1,3,0,0,0,3,1,0,1,2,1
"43001942",Escola Cèsar Martinell - ZER Terra Alta-Centre,El Pinell de Brai,TEB,TEB,4227567,30/03/2022,0,2,2,4,0,0,0,4,4,0,4,2,2
"43001954",Escola Antoni Tous - ZER Conca de Barberà,Pira,TAR,TAR,4235694,04/04/2022,0,0,0,0,0,2,1,3,0,0,0,2,1
"43001966",Escola Sant Ramon,El Pla de Santa Maria,TAR,TAR,4218850,25/03/2022,1,0,1,0,9,0,0,9,0,9,9,0,2
"43002016",Escola L'Ametller - ZER Terra Alta Nord,La Pobla de Massaluca,TEB,TEB,4238134,06/04/2022,1,0,1,0,1,0,0,1,0,0,0,0,1
"43002053",Escola Garbí - ZER Montsant-Serra de Prades,Poboleda,TAR,TAR,4230687,31/03/2022,1,0,1,0,0,1,1,2,1,1,2,0,1
"43002144",Escola Mare de Déu de la Fontcalda - ZER Ports-Algars,Prat de Comte,TEB,TEB,4213340,23/03/2022,1,0,1,0,0,1,0,1,2,0,2,0,1
"43002171",Escola Joan Plana,Puigpelat,TAR,TAR,4213465,23/03/2022,1,2,3,0,6,0,0,6,0,6,6,1,3
"43002211",Escola Prat de la Riba,Reus,TAR,TAR,4213038,23/03/2022,1,9,10,3,0,1,1,5,2,1,3,5,0
"43002235",Escola Pompeu Fabra,Reus,TAR,TAR,4236785,05/04/2022,1,0,1,9,0,0,0,9,9,0,9,9,1
"43002247",Escola Misericòrdia,Reus,TAR,TAR,4236142,05/04/2022,1,3,4,9,0,0,0,9,9,0,9,7,2
"43002259",Escola Marià Fortuny,Reus,TAR,TAR,4239039,06/04/2022,1,10,11,0,18,0,0,18,0,18,18,17,6
"43002272",Escola General Prim,Reus,TAR,TAR,4213207,23/03/2022,0,0,0,0,0,15,1,16,15,1,16,16,2
"43002570",Institut Gaudí,Reus,TAR,TAR,4222803,28/03/2022,0,0,0,31,2,0,0,33,0,0,0,31,33
"43002582",Institut Salvador Vilaseca,Reus,TAR,TAR,4236737,05/04/2022,1,2,3,22,0,0,0,22,0,0,0,22,0
"43002594",Institut Baix Camp,Reus,TAR,TAR,4231490,01/04/2022,0,0,0,40,3,0,0,43,40,3,43,40,3
"43002661",Escola Sant Agustí - ZER Ebre,Riba-roja d'Ebre,TEB,TEB,4227299,30/03/2022,1,0,1,4,1,0,0,5,2,1,3,4,3
"43002752",Escola Beat Bonaventura Gran,Riudoms,TAR,TAR,4225344,29/03/2022,0,0,0,19,0,0,0,19,19,0,19,19,5
"43002776",Escola Salvador Espriu,Roda de Berà,TAR,TAR,4218093,25/03/2022,0,2,2,11,4,0,0,15,11,4,15,9,4
"43002831",Escola Mestre Marcel·lí Domingo,Roquetes,TEB,TEB,4227176,30/03/2022,16,0,16,24,2,0,0,26,12,0,12,16,8
"43002892",Escola Carles III,Sant Carles de la Ràpita,TEB,TEB,4226701,30/03/2022,0,2,2,24,1,0,0,25,3,1,4,23,5
"43003008",Escola Jaume Balmes,Santa Bàrbara,TEB,TEB,4235999,05/04/2022,0,0,0,14,4,0,0,18,2,4,6,8,4
"43003011",Escola Cor de Roure,Santa Coloma de Queralt,TAR,TAR,4236962,05/04/2022,1,0,1,8,1,0,0,9,8,1,9,7,3
"43003069",Escola Salvador Ninot,Sarral,TAR,TAR,4223341,28/03/2022,1,0,1,9,0,0,0,9,9,0,9,6,3
"43003082",Escola Guillem de Claramunt,La Secuita,TAR,TAR,4213217,23/03/2022,1,1,2,9,0,0,0,9,9,0,9,9,1
"43003100",Escola Abel Ferrater,La Selva del Camp,TAR,TAR,4226807,30/03/2022,0,0,0,20,0,0,0,20,20,0,20,20,2
"43003124",Escola Sagrat Cor - ZER Conca de Barberà,Solivella,TAR,TAR,4222153,28/03/2022,1,2,3,0,1,2,0,3,0,1,1,1,1
"43003136",Escola Bonavista,Bonavista (Tarragona),TAR,TAR,4236463,05/04/2022,0,2,2,14,2,3,0,19,6,0,6,7,4
"43003185",Escola La Canonja,La Canonja,TAR,TAR,4229484,31/03/2022,0,25,25,3,1,0,0,4,3,1,4,2,6
"43003227",Escola Sant Salvador,Sant Salvador (Tarragona),TAR,TAR,4222512,28/03/2022,0,1,1,20,0,0,0,20,0,0,0,20,6
"43003306",Escola Serrallo,Tarragona,TAR,TAR,4223377,28/03/2022,2,8,10,0,0,2,0,2,0,0,0,3,2
"43003321",Escola Sant Pere i Sant Pau,Tarragona,TAR,TAR,4221215,28/03/2022,1,0,1,0,11,0,0,11,0,11,11,0,2
"43003641",Institut Antoni de Martí i Franquès,Tarragona,TAR,TAR,4229395,31/03/2022,4,3,7,6,18,7,0,31,13,18,31,13,13
"43003653",Institut Comte de Rius,Tarragona,TAR,TAR,4236406,05/04/2022,0,0,0,14,4,0,0,18,14,4,18,0,0
"43003690",Escola de Pràctiques,Tarragona,TAR,TAR,4229609,31/03/2022,0,0,0,13,6,0,0,19,13,6,19,19,4
"43003720",Escola El Miracle,Tarragona,TAR,TAR,4225700,29/03/2022,3,0,3,11,0,0,0,11,11,0,11,6,1
"43003732",Institut Pons d'Icart,Tarragona,TAR,TAR,4230805,01/04/2022,0,1,1,21,1,0,0,22,0,1,1,22,4
"43003756",Escola Torreforta,Torreforta (Tarragona),TAR,TAR,4222599,28/03/2022,0,0,0,18,1,0,0,19,0,0,0,18,2
"43003768",Escola Els Àngels,Torreforta (Tarragona),TAR,TAR,4222138,28/03/2022,0,0,0,18,4,0,0,22,18,4,22,22,6
"43003801",Escola La Pineda - ZER Riu Avall,Tivenys,TEB,TEB,4229259,31/03/2022,2,0,2,1,0,3,0,4,1,0,1,1,1
"43003835",Escola Josep Riba - ZER Les Vinyes,La Serra d'Almós (Tivissa),TEB,TEB,4227227,30/03/2022,1,0,1,1,0,0,0,1,1,0,1,1,1
"43003847",Escola Marcel·lí Domingo,Tivissa,TEB,TEB,4222937,28/03/2022,1,1,2,1,0,6,0,7,4,0,4,7,2
"43003884",Escola Antoni Roig,Torredembarra,TAR,TAR,4224830,29/03/2022,0,0,0,19,0,0,0,19,10,0,10,19,5
"43003951",Escola Bítem - ZER Riu Avall,Bítem (Tortosa),TEB,TEB,4236912,05/04/2022,1,0,1,6,0,0,0,6,5,0,5,0,2
"43003975",Escola Sant Àngel,Camarles,TEB,TEB,4223211,28/03/2022,2,2,4,10,1,0,0,11,4,1,5,9,3
"43003987",Escola Port rodó - ZER Mestral,Camp-redó (Tortosa),TEB,TEB,4233588,04/04/2022,1,0,1,7,0,0,0,7,4,0,4,7,2
"43004013",Escola Sant Miquel,Deltebre,TEB,TEB,4230853,01/04/2022,0,0,0,18,0,0,0,18,12,0,12,3,6
"43004037",Escola Maria García i Cabanes,L'Aldea,TEB,TEB,4226921,30/03/2022,0,0,0,9,0,0,0,9,4,0,4,9,3
"43004050",Escola 21 d'Abril,L'Aldea,TEB,TEB,4223310,28/03/2022,0,0,0,9,0,0,0,9,5,0,5,9,2
"43004074",Escola L'Assumpció,Deltebre,TEB,TEB,4230166,31/03/2022,0,2,2,10,5,0,0,15,5,5,10,10,4
"43004116",Escola del Lligallo del Gànguil - ZER Mestral,El Lligallo del Gànguil (Camarles),TEB,TEB,4234305,04/04/2022,1,0,1,4,0,0,0,4,4,0,4,4,1
"43004189",Escola Sant Jaume,Sant Jaume d'Enveja,TEB,TEB,4214448,23/03/2022,0,0,0,13,0,0,0,13,4,0,4,13,1
"43004232",Escola La Mercè,Tortosa,TEB,TEB,4224808,29/03/2022,2,4,6,10,1,0,0,11,2,0,2,11,5
"43004256",Escola Ferreries,Tortosa,TEB,TEB,4236652,05/04/2022,5,1,6,20,0,0,0,20,15,0,15,6,6
"43004268",Escola Remolins,Tortosa,TEB,TEB,4225181,29/03/2022,2,0,2,1,0,5,3,9,2,1,3,6,4
"43004438",Institut Dertosa,Tortosa,TEB,TEB,4231575,01/04/2022,2,17,19,12,2,17,0,31,0,2,2,11,0
"43004441",Institut de l'Ebre,Tortosa,TEB,TEB,4230151,31/03/2022,0,0,0,28,6,0,0,34,4,3,7,0,5
"43004463",Escola Ramón y Cajal,Ulldecona,TEB,TEB,4235414,04/04/2022,15,2,17,14,0,6,0,20,12,0,12,10,5
"43004487",Escola Montsant - ZER Montsant-Serra de Prades,Ulldemolins,TAR,TAR,4225440,29/03/2022,1,0,1,0,2,0,0,2,0,2,2,0,1
"43004505",Escola Mare de Déu del Roser,Vallmoll,TAR,TAR,4223115,28/03/2022,0,0,0,0,9,0,0,9,0,0,0,0,2
"43004517",Escola Rocabruna - ZER El Francolí,Picamoixons (Valls),TAR,TAR,4223164,28/03/2022,1,0,1,3,1,0,0,4,4,1,5,4,0
"43004529",Escola Mare de Déu de la Candela,Valls,TAR,TAR,4224513,29/03/2022,1,0,1,0,9,0,0,9,0,9,9,0,0
"43004530",Escola Baltasar Segú,Valls,TAR,TAR,4225798,29/03/2022,2,0,2,6,3,0,0,9,6,3,9,6,2
"43004608",Institut Narcís Oller,Valls,TAR,TAR,4236724,05/04/2022,0,0,0,27,3,0,0,30,27,3,30,27,4
"43004611",Institut Jaume Huguet,Valls,TAR,TAR,4212819,23/03/2022,2,0,2,58,0,0,0,58,58,0,58,56,2
"43004633",Escola Eugeni d'Ors,Valls,TAR,TAR,4214021,23/03/2022,6,4,10,18,0,0,0,18,10,0,10,16,6
"43004657",Escola Mestral,L'Hospitalet de l'Infant (Vandellòs i l'Hospitalet de l'Infant),TAR,TAR,4231197,01/04/2022,0,7,7,26,0,0,0,26,26,0,26,26,6
"43004700",Escola Valdelors,Vandellòs (Vandellòs i l'Hospitalet de l'Infant),TAR,TAR,4212183,22/03/2022,1,1,2,3,0,0,0,3,3,0,3,2,1
"43004748",Escola Àngel Guimerà,El Vendrell,TAR,PEN,4228030,30/03/2022,0,0,0,18,4,0,0,22,18,4,22,7,4
"43004797",Institut Baix Penedès,El Vendrell,TAR,PEN,4231508,01/04/2022,0,4,4,28,0,0,0,28,0,0,0,11,28
"43004803",Institut Andreu Nin,El Vendrell,TAR,PEN,4236813,05/04/2022,1,11,12,37,0,0,0,37,37,0,37,0,9
"43004815",Escola Pau Casals,El Vendrell,TAR,PEN,4222815,28/03/2022,1,2,3,20,0,0,0,20,0,0,0,20,4
"43004864",Escola Pere Virgili,Vilallonga del Camp,TAR,TAR,4225463,29/03/2022,1,0,1,16,1,0,0,17,16,1,17,10,3
"43004888",Escola Font de l'Arc - ZER Baix Camp Sud,Vilanova d'Escornalbou,TAR,TAR,4233260,04/04/2022,1,1,2,0,3,0,0,3,0,3,3,0,1
"43004921",Escola Bernardí Tolrà,Vila-rodona,TAR,TAR,4235362,04/04/2022,1,1,2,9,0,0,0,9,5,0,5,2,2
"43004931",Escola Santa Maria del Mar,Salou,TAR,TAR,4237432,05/04/2022,0,0,0,14,6,0,0,20,14,6,20,20,4
"43004979",Escola Torroja i Miret,Vila-seca de Solcina (Vila-seca),TAR,TAR,4236973,05/04/2022,1,8,9,14,4,0,0,18,7,4,11,11,4
"43005005",Escola Sant Bernat Calvó,Vila-seca de Solcina (Vila-seca),TAR,TAR,4226140,29/03/2022,1,4,5,16,2,0,0,18,7,2,9,18,4
"43005017",Escola del Montgoi - ZER Poblet,Vilaverd,TAR,TAR,4235129,04/04/2022,1,1,2,0,0,0,2,2,0,2,2,3,1
"43005081",Escola Mare de Déu dels Torrents - ZER Poblet,Vimbodí (Vimbodí i Poblet),TAR,TAR,4236535,05/04/2022,1,0,1,4,0,0,0,4,2,0,2,0,1
"43005108",Escola Les Eres - ZER Ribera d'Ebre Nord,Vinebre,TEB,TEB,4223757,28/03/2022,0,1,1,0,0,2,1,3,2,1,3,3,1
"43005121",Escola Santa Caterina,Vinyols i els Arcs,TAR,TAR,4216342,24/03/2022,1,0,1,9,0,0,0,9,9,0,9,0,2
"43005133",Escola Mare de Déu del Priorat,Banyeres del Penedès,TAR,PEN,4218256,25/03/2022,1,0,1,0,0,10,0,10,10,0,10,0,2
"43005145",Escola Els Ametllers,La Pobla de Montornès,TAR,TAR,4236977,05/04/2022,3,0,3,6,1,0,0,7,6,1,7,6,1
"43005157",Escola Montoliu,La Riera de Gaià,TAR,TAR,4213913,23/03/2022,0,0,0,7,0,2,1,10,9,1,10,6,2
"43005169",Escola Pau Delclòs,Tarragona,TAR,TAR,4224627,29/03/2022,1,0,1,16,2,0,0,18,16,2,18,16,3
"43005170",Escola La Floresta,Torreforta (Tarragona),TAR,TAR,4229169,31/03/2022,1,0,1,7,2,0,0,9,7,2,9,7,2
"43005194",Escola Mediterrani,L'Ampolla,TEB,TEB,4225870,29/03/2022,2,0,2,11,0,0,0,11,4,0,4,10,4
"43005297",Escola Joan Perucho,Albinyana,TAR,PEN,4236957,05/04/2022,1,0,1,0,0,0,9,9,0,9,9,2,2
"43005303",Escola Sant Jordi - ZER Riu i Serra,Aldover,TEB,TEB,4225970,29/03/2022,1,0,1,3,0,0,0,3,2,0,2,3,1
"43005315",Escola d'Alfara de Carles - ZER Mont Caro,Alfara de Carles,TEB,TEB,4230178,31/03/2022,1,0,1,2,0,0,0,2,0,0,0,1,1
"43005327",Escola Ramon Sugrañes,Almoster,TAR,TAR,4212032,22/03/2022,1,0,1,9,0,0,0,9,9,0,9,0,2
"43005339",Escola Montsant - ZER Montsant,La Bisbal de Falset,TAR,TAR,4235382,04/04/2022,1,2,3,0,0,1,0,1,1,0,1,1,0
"43005340",Escola Santa Anna,Castellvell del Camp,TAR,TAR,4225366,29/03/2022,1,1,2,12,0,0,0,12,3,0,3,12,2
"43005364",Escola Les Eres,Creixell,TAR,TAR,4225133,29/03/2022,1,1,2,0,11,0,0,11,0,3,3,2,3
"43005376",Escola Puigmarí - ZER Baix Camp Sud,Duesaigües,TAR,TAR,4224780,29/03/2022,1,0,1,0,0,1,0,1,1,0,1,1,0
"43005388",Escola Mestre Josep Roncero i Pallarès - ZER Montsià,Freginals,TEB,TEB,4236562,05/04/2022,2,1,3,0,0,2,0,2,2,0,2,2,1
"43005391",Escola Sant Llorenç - ZER Montsià,La Galera,TEB,TEB,4236574,05/04/2022,1,1,2,4,0,0,0,4,4,0,4,3,1
"43005406",Escola El Verger - ZER Ribera d'Ebre Nord,Garcia,TEB,TEB,4226986,30/03/2022,1,0,1,3,0,0,0,3,3,0,3,3,1
"43005418",Escola Sant Salvador - ZER Montsià,Godall,TEB,TEB,4229097,31/03/2022,1,1,2,2,0,0,0,2,2,0,2,1,1
"43005421",Escola Berenguer de Montoliu - ZER Els Ceps,Masllorenç,TAR,PEN,4231681,01/04/2022,1,0,1,0,0,2,0,2,2,0,2,1,1
"43005443",Escola Roc Llop i Convalia - ZER Benissanet-Miravet,Miravet,TEB,TEB,4227025,30/03/2022,1,1,2,3,0,1,0,4,3,0,3,2,2
"43005455",Escola Pius XII - ZER L'Aglà,El Molar,TAR,TAR,4222885,28/03/2022,1,0,1,0,0,1,0,1,0,0,0,1,0
"43005467",Escola Les Codinetes,La Nou de Gaià,TAR,TAR,4233290,04/04/2022,0,0,0,2,1,4,0,7,4,1,5,2,1
"43005479",Escola 1 d'Abril - ZER Ebre,La Palma d'Ebre,TEB,TEB,4223137,28/03/2022,1,0,1,1,1,0,0,2,0,1,1,2,1
"43005480",Escola Mare de Déu del Lledó,La Pobla de Mafumet,TAR,TAR,4214575,23/03/2022,2,3,5,0,20,0,0,20,0,6,6,0,0
"43005492",Escola Santa Magdalena - ZER La Parellada,El Pont d'Armentera,TAR,TAR,4215191,23/03/2022,0,0,0,1,3,0,0,4,1,3,4,0,1
"43005509",Escola Rossend Giol - ZER Baix Priorat,Porrera,TAR,TAR,4225012,29/03/2022,1,0,1,0,0,0,1,1,0,1,1,0,0
"43005510",Escola Serra de Prades - ZER Montsant-Serra de Prades,Prades,TAR,TAR,4235843,05/04/2022,1,0,1,1,0,1,1,3,2,1,3,0,1
"43005522",Escola Santa Marina,Pratdip,TAR,TAR,4213486,23/03/2022,1,1,2,2,2,0,0,4,2,2,4,1,2
"43005534",Escola Les Eres de Rasquera - ZER La Font de l'Aiguadí,Rasquera,TEB,TEB,4226349,29/03/2022,1,0,1,5,0,0,0,5,0,0,0,2,1
"43005546",Escola de La Riba - ZER El Francolí,La Riba,TAR,TAR,4233358,04/04/2022,0,0,0,0,3,0,0,3,0,0,0,0,1
"43005558",Escola Sant Mateu,Riudecanyes,TAR,TAR,4218881,25/03/2022,1,1,2,7,0,0,0,7,2,0,2,0,1
"43005561",Escola Mare de Déu del Roser,Riudecols,TAR,TAR,4227004,30/03/2022,1,1,2,6,0,0,0,6,2,0,2,0,2
"43005571",Escola Les Comes,Rodonyà,TAR,TAR,4229055,31/03/2022,1,0,1,8,0,0,0,8,8,0,8,6,2
"43005583",Escola Els Quatre Vents,Sant Jaume dels Domenys,TAR,PEN,4225909,29/03/2022,0,1,1,6,9,0,0,15,6,9,15,0,2
"43005595",Escola La Parellada,Santa Oliva,TAR,PEN,4217751,25/03/2022,0,0,0,10,4,0,0,14,4,2,6,14,2
"43005601",Escola El Tormo - ZER Ribera d'Ebre Nord,La Torre de l'Espanyol,TEB,TEB,4229126,31/03/2022,0,0,0,1,0,2,0,3,2,0,2,2,2
"43005613",Escola Setze de Febrer - ZER Mediterrània,Els Muntells (Sant Jaume d'Enveja),TEB,TEB,4227020,30/03/2022,0,1,1,2,0,0,0,2,1,0,1,2,1
"43005625",Escola Sant Antoni Abat - ZER Mont Caro,Els Reguers (Tortosa),TEB,TEB,4211926,22/03/2022,1,1,2,2,0,0,0,2,0,0,0,3,1
"43005637",Escola Manuel de Castellví i Feliu - ZER Atzavara,Vilabella,TAR,TAR,4236197,05/04/2022,1,0,1,2,1,0,0,3,2,1,3,1,1
"43005650",Escola El Diví Mestre - ZER Terra Alta Nord,Vilalba dels Arcs,TEB,TEB,4233585,04/04/2022,1,0,1,2,1,0,0,3,2,1,3,1,1
"43005662",Escola Josep Nin,Salomó,TAR,TAR,4224561,29/03/2022,1,1,2,0,0,0,4,4,0,4,4,0,1
"43005674",Escola Raval de Cristo - ZER Mont Caro,El Raval de Crist (Roquetes),TEB,TEB,4231088,01/04/2022,2,0,2,4,0,2,0,6,3,0,3,2,2
"43005686",Escola Riu Clar,Torreforta (Tarragona),TAR,TAR,4217794,25/03/2022,2,6,8,3,0,3,3,9,7,2,9,6,2
"43005698",Escola Marjal - ZER Mediterrània,Les Cases d'Alcanar (Alcanar),TEB,TEB,4223419,28/03/2022,2,3,5,5,0,0,0,5,5,0,5,2,3
"43005704",Institut Francesc Vidal i Barraquer,Tarragona,TAR,TAR,4232055,01/04/2022,0,0,0,6,14,0,0,20,6,14,20,0,2
"43005753",Escola Doctor Alberich i Casas,Reus,TAR,TAR,4223614,28/03/2022,1,0,1,12,3,3,0,18,12,0,12,14,4
"43005765",Escola Eduard Toda i Güell,Reus,TAR,TAR,4222471,28/03/2022,0,0,0,16,1,0,0,17,16,1,17,16,2
"43005893",Escola Centcelles,Constantí,TAR,TAR,4235525,04/04/2022,1,3,4,7,0,1,0,8,3,0,3,5,2
"43005901",Escola Joan Rebull,Reus,TAR,TAR,4233298,04/04/2022,0,2,2,15,7,0,0,22,2,1,3,14,8
"43005911",Escola Campclar,Torreforta (Tarragona),TAR,TAR,4230803,01/04/2022,1,3,4,12,0,0,0,12,4,0,4,12,4
"43005935",Escola Sant Bernat Calvó,Reus,TAR,TAR,4218763,25/03/2022,0,0,0,16,0,0,0,16,16,0,16,24,4
"43005947",Escola Cal·lípolis,Platja de la Pineda (Vila-seca),TAR,TAR,4216642,24/03/2022,6,4,10,10,0,1,0,11,11,0,11,10,3
"43005959",Escola Cèsar August,Tarragona,TAR,TAR,4235944,05/04/2022,0,6,6,19,3,0,0,22,6,1,7,22,6
"43005972",Institut Ramon Barbat i Miracle,Vila-seca de Solcina (Vila-seca),TAR,TAR,4225282,29/03/2022,1,7,8,24,0,0,0,24,24,0,24,18,28
"43006046",Escola Divina Pastora - ZER Mestral,Vinallop (Tortosa),TEB,TEB,4233624,04/04/2022,1,0,1,1,0,0,0,1,1,0,1,1,1
"43006061",Escola Rubió i Ors,Reus,TAR,TAR,4213391,23/03/2022,1,2,3,0,0,19,0,19,0,0,0,19,3
"43006101",Institut Montsià,Amposta,TEB,TEB,4235388,04/04/2022,0,0,0,29,1,0,0,30,29,1,30,28,20
"43006125",Institut Campclar,Tarragona,TAR,TAR,4215935,24/03/2022,1,0,1,3,2,30,0,35,0,0,0,25,10
"43006174",Escola Les Moreres,Les Pobles (Aiguamúrcia),TAR,TAR,4215862,24/03/2022,1,1,2,3,0,0,0,3,4,0,4,0,2
"43006186",Escola Soriano Montagut,Amposta,TEB,TEB,4229396,31/03/2022,13,0,13,12,0,3,3,18,14,3,17,15,4
"43006216",Escola Cèlia Artiga,Reus,TAR,TAR,4238703,06/04/2022,1,8,9,6,1,1,0,8,0,0,0,7,3
"43006228",Escola Rosa Sensat,Reus,TAR,TAR,4212921,23/03/2022,1,0,1,11,0,0,0,11,5,0,5,10,3
"43006241",Escola La Plana,La Plana (Vila-seca),TAR,TAR,4231833,01/04/2022,3,7,10,5,4,0,0,9,2,3,5,5,2
"43006332",Escola Mestral,Vila-seca de Solcina (Vila-seca),TAR,TAR,4236292,05/04/2022,0,4,4,0,0,15,0,15,0,0,0,15,4
"43006356",Escola Marinada,Cambrils,TAR,TAR,4213332,23/03/2022,2,0,2,17,0,0,0,17,9,0,9,14,4
"43006371",Escola Sant Roc - ZER Conca de Barberà,Rocafort de Queralt,TAR,TAR,4218991,25/03/2022,1,0,1,0,0,0,1,1,0,1,1,0,0
"43006393",Escola Europa,Salou,TAR,TAR,4225000,29/03/2022,1,4,5,19,0,0,0,19,10,0,10,12,3
"43006496",Institut Manuel Sales i Ferré,Ulldecona,TEB,TEB,4235545,04/04/2022,10,0,10,13,4,0,0,17,5,2,7,0,2
"43006541",Escola Teresa Miquel i Pàmies,Reus,TAR,TAR,4230163,31/03/2022,4,1,5,15,1,0,0,16,0,0,0,0,2
"43006551",Escola Horta Vella,Sant Carles de la Ràpita,TEB,TEB,4225997,29/03/2022,0,0,0,20,0,0,0,20,9,0,9,20,7
"43006563",Escola Marcel·lí Domingo,Tarragona,TAR,TAR,4218809,25/03/2022,0,1,1,18,0,0,0,18,10,0,10,18,4
"43006575",Escola Eladi Homs,Valls,TAR,TAR,4225581,29/03/2022,3,1,4,7,3,0,0,10,7,3,10,4,3
"43006587",Escola Àngels Garriga,El Vendrell,TAR,PEN,4224877,29/03/2022,0,0,0,16,0,0,15,31,16,15,31,30,0
"43006617",Institut Joan Amigó i Callau,L'Espluga de Francolí,TAR,TAR,4225029,29/03/2022,0,14,14,10,0,0,0,10,0,0,0,5,2
"43006630",Institut Pere Martell,Tarragona,TAR,TAR,4230972,01/04/2022,0,10,10,16,20,0,0,36,0,0,0,0,20
"43006642",Institut Terra Alta,Gandesa,TEB,TEB,4229404,31/03/2022,1,2,3,18,1,0,0,19,2,0,2,18,0
"43006654",Institut Cambrils,Cambrils,TAR,TAR,4236570,05/04/2022,1,1,2,21,0,0,0,21,21,0,21,21,7
"43006678",Institut Gabriel Ferrater i Soler,Reus,TAR,TAR,4228994,31/03/2022,1,0,1,32,2,0,0,34,32,2,34,15,34
"43006681",Institut de La Sénia,La Sénia,TEB,TEB,4229928,31/03/2022,1,0,1,15,2,0,0,17,0,2,2,17,0
"43006691",Institut Priorat,Falset,TAR,TAR,4224766,29/03/2022,2,2,4,4,0,24,1,29,28,1,29,0,9
"43006708",Institut Joan Segura i Valls,Santa Coloma de Queralt,TAR,TAR,4213561,23/03/2022,0,1,1,5,0,0,0,5,5,0,5,5,0
"43006851",Escola Molí de Vent,Torredembarra,TAR,TAR,4213133,23/03/2022,0,0,0,20,0,0,0,20,10,0,10,20,2
"43006861",Escola Enxaneta,Valls,TAR,TAR,4229177,31/03/2022,2,0,2,7,2,0,0,9,7,2,9,8,0
"43006873",Escola Riumar,Deltebre,TEB,TEB,4235133,04/04/2022,0,0,0,5,4,0,0,9,0,5,5,9,3
"43006940",EOI de Tarragona,Tarragona,TAR,TAR,4231143,01/04/2022,0,21,21,1,0,0,2,3,1,2,3,0,0
"43006952",Institut Torredembarra,Torredembarra,TAR,TAR,4228690,30/03/2022,3,0,3,35,0,5,0,40,0,0,0,40,0
"43006964",Institut de Deltebre,Deltebre,TEB,TEB,4237046,05/04/2022,3,0,3,22,3,0,0,25,4,0,4,25,10
"43006976",Institut Candelera,L'Ametlla de Mar,TEB,TEB,4231416,01/04/2022,10,4,14,10,2,5,0,17,0,2,2,12,6
"43006988",CEE Garbí,El Vendrell,TAR,PEN,4236919,05/04/2022,6,0,6,12,0,0,0,12,0,0,0,6,2
"43007038",Institut Escola d'Hoteleria i Turisme,Cambrils,TAR,TAR,4236700,05/04/2022,0,0,0,0,13,0,0,13,0,0,0,0,0
"43007051",CFA Josepa Massanés i Dalmau,Tarragona,TAR,TAR,4216063,24/03/2022,0,0,0,0,3,0,0,3,0,3,3,0,0
"43007087",Institut Sòl de Riu,Alcanar,TEB,TEB,4223576,28/03/2022,1,0,1,21,0,0,0,21,0,0,0,21,1
"43007105",Escola Montsant,Reus,TAR,TAR,4214025,23/03/2022,1,3,4,0,9,0,0,9,0,9,9,9,1
"43007117",Escola Pax,Tarragona,TAR,TAR,4231211,01/04/2022,0,3,3,16,0,0,4,20,10,4,14,19,3
"43007129",Institut Julio Antonio,Móra d'Ebre,TEB,TEB,4229774,31/03/2022,1,0,1,27,0,0,0,27,0,0,0,27,10
"43007166",Institut Lluís Domènech i Montaner,Reus,TAR,TAR,4236838,05/04/2022,1,0,1,30,0,0,0,30,0,0,0,30,2
"43007178",Escola Mowgli,Reus,TAR,TAR,4217605,25/03/2022,0,3,3,7,2,0,0,9,7,2,9,3,1
"43007208",Institut Berenguer d'Entença,L'Hospitalet de l'Infant (Vandellòs i l'Hospitalet de l'Infant),TAR,TAR,4213518,23/03/2022,0,13,13,9,8,1,1,19,0,0,0,9,0
"43007221",Institut Els Alfacs,Sant Carles de la Ràpita,TEB,TEB,4230961,01/04/2022,1,0,1,16,9,2,3,30,6,0,6,30,0
"43007233",Institut de Flix,Flix,TEB,TEB,4236812,05/04/2022,1,0,1,17,0,0,0,17,2,0,2,17,0
"43007257",Institut Camí de Mar,Calafell,TAR,PEN,4231152,01/04/2022,0,0,0,21,6,3,0,30,0,6,6,21,2
"43007385",Institut d'Horticultura i Jardineria,Reus,TAR,TAR,4224840,29/03/2022,0,0,0,5,2,0,0,7,5,2,7,0,0
"43007543",Institut Jaume I,Salou,TAR,TAR,4217754,25/03/2022,3,13,16,32,0,0,0,32,32,0,32,32,13
"43007580",Institut de L'Arboç,L'Arboç,TAR,PEN,4215867,24/03/2022,1,0,1,0,4,0,27,31,0,0,0,0,4
"43007646",Institut de Constantí,Constantí,TAR,TAR,4213878,23/03/2022,0,0,0,15,15,0,0,30,0,15,15,0,19
"43007658",Institut Joan Guinjoan i Gispert,Riudoms,TAR,TAR,4236706,05/04/2022,1,0,1,26,0,0,0,26,26,0,26,26,2
"43007661",Institut Ramon de la Torre,Torredembarra,TAR,TAR,4214773,23/03/2022,1,0,1,25,0,0,0,25,0,0,0,25,10
"43008389",Escola Sant Llatzer,Tortosa,TEB,TEB,4229731,31/03/2022,3,0,3,8,0,0,1,9,4,0,4,6,2
"43008390",Institut Torreforta,Tarragona,TAR,TAR,4213510,23/03/2022,0,21,21,14,0,3,4,21,0,0,0,13,0
"43008407",Institut El Morell,El Morell,TAR,TAR,4215964,24/03/2022,1,4,5,31,1,0,0,32,2,1,3,30,2
"43008419",Institut Camarles,Camarles,TEB,TEB,4229898,31/03/2022,0,1,1,15,1,0,0,16,0,1,1,15,0
"43008420",Institut Roquetes,Roquetes,TEB,TEB,4229151,31/03/2022,1,9,10,0,4,17,5,26,0,1,1,25,1
"43008432",Institut Sant Pere i Sant Pau,Sant Pere i Sant Pau (Tarragona),TAR,TAR,4236845,05/04/2022,1,0,1,20,0,0,0,20,20,0,20,10,10
"43008444",Institut Josep Tapiró,Reus,TAR,TAR,4227478,30/03/2022,1,0,1,16,7,1,0,24,0,0,0,14,8
"43008456",Institut Les Planes,Santa Bàrbara,TEB,TEB,4233295,04/04/2022,3,0,3,0,0,14,0,14,2,0,2,14,2
"43008481",Institut Collblanc,La Canonja,TAR,TAR,4230155,31/03/2022,1,1,2,23,0,0,0,23,23,0,23,0,9
"43008501",Institut Pont del Diable,Sant Salvador (Tarragona),TAR,TAR,4225684,29/03/2022,0,0,0,9,3,0,0,12,9,3,12,2,12
"43008511",Institut Joan Puig i Ferreter,La Selva del Camp,TAR,TAR,4233491,04/04/2022,2,0,2,0,20,0,0,20,0,20,20,0,8
"43008523",Institut Vila-seca,Vila-seca de Solcina (Vila-seca),TAR,TAR,4226795,30/03/2022,4,16,20,3,1,17,2,23,0,0,0,20,0
"43008535",Escola Solcunit,Cunit,TAR,PEN,4227231,30/03/2022,0,0,0,24,2,3,0,29,27,2,29,21,4
"43008547",Escola Cambrils,Cambrils,TAR,TAR,4222645,28/03/2022,0,6,6,0,1,17,0,18,18,0,18,5,4
"43008638",Institut Antoni Ballester,Mont-roig del Camp,TAR,TAR,4227465,30/03/2022,1,20,21,0,0,4,2,6,4,2,6,4,14
"43008729",CFA Tarragona,Tarragona,TAR,TAR,4231198,01/04/2022,0,1,1,2,1,0,2,5,0,0,0,2,1
"43008754",CFA Sebastià Juan Arbó,Amposta,TEB,TEB,4225601,29/03/2022,0,0,0,5,0,0,0,5,0,0,0,5,0
"43008857",CFA Reus,Reus,TAR,TAR,4212101,22/03/2022,0,0,0,4,0,3,0,7,7,0,7,7,0
"43008912",Escola Cinta Curto,Tortosa,TEB,TEB,4224961,29/03/2022,0,0,0,9,0,0,0,9,5,0,5,8,5
"43009187",Institut Martí l'Humà,Montblanc,TAR,TAR,4236623,05/04/2022,0,1,1,25,0,0,0,25,0,0,0,23,2
"43009217",Escola del Poble Nou del Delta - ZER Mediterrània,El Poblenou del Delta (Amposta),TEB,TEB,4224160,28/03/2022,1,0,1,0,1,0,0,1,0,1,1,0,1
"43009230",Escola Tarragona,Tarragona,TAR,TAR,4223560,28/03/2022,0,4,4,15,0,0,0,15,15,0,15,8,3
"43009242",Escola L'Antina,Torredembarra,TAR,TAR,4219434,26/03/2022,0,12,12,0,5,14,0,19,14,5,19,10,5
"43009369",Escola Saavedra,Tarragona,TAR,TAR,4223455,28/03/2022,7,0,7,5,0,0,0,5,0,0,0,0,2
"43009451",Escola Salou,Salou,TAR,TAR,4213705,23/03/2022,5,0,5,17,0,0,0,17,6,0,6,17,5
"43009497",Institut Fonts del Glorieta,Alcover,TAR,TAR,4227787,30/03/2022,1,10,11,11,1,1,0,13,11,1,12,12,2
"43009710",EOI de Reus,Reus,TAR,TAR,4234992,04/04/2022,0,0,0,9,0,0,0,9,0,0,0,9,0
"43009722",Institut Cal·lípolis,Tarragona,TAR,TAR,4221240,28/03/2022,0,0,0,22,2,0,0,24,22,2,24,24,24
"43009771",CFA Tortosa,Tortosa,TEB,TEB,4230034,31/03/2022,0,2,2,6,0,0,0,6,2,0,2,4,0
"43009850",Institut Ernest Lluch i Martí,Cunit,TAR,PEN,4229888,31/03/2022,1,0,1,19,2,2,0,23,1,2,3,19,2
"43009862",EOI de Tortosa,Tortosa,TEB,TEB,4224873,29/03/2022,0,0,0,8,0,0,0,8,0,0,0,8,1
"43009886",Escola Josep Veciana,Perafort,TAR,TAR,4213702,23/03/2022,1,0,1,10,0,0,0,10,10,0,10,10,3
"43009898",Escola Castell de Calafell,Calafell,TAR,PEN,4229017,31/03/2022,0,21,21,0,0,6,13,19,6,13,19,6,2
"43009977",Institut d'Altafulla,Altafulla,TAR,TAR,4229922,31/03/2022,0,0,0,18,2,0,0,20,0,0,0,20,0
"43010037",EOI del Vendrell,El Vendrell,TAR,PEN,4224745,29/03/2022,0,3,3,3,0,1,0,4,0,0,0,3,0
"43010062",CFA El Vendrell,El Vendrell,TAR,PEN,4227669,30/03/2022,0,1,1,1,3,0,0,4,1,3,4,2,1
"43010074",CFA Valls,Valls,TAR,TAR,4235385,04/04/2022,0,0,0,0,4,0,0,4,0,4,4,0,0
"43010086",CFA Vilaseca,Vila-seca de Solcina (Vila-seca),TAR,TAR,4213318,23/03/2022,0,0,0,2,0,1,0,3,3,0,3,2,0
"43010098",Escola La Ginesta,Segur de Calafell (Calafell),TAR,PEN,4227439,30/03/2022,2,0,2,18,2,0,0,20,18,2,20,20,4
"43010141",Escola Guillem Fortuny,Cambrils,TAR,TAR,4231271,01/04/2022,0,4,4,17,1,0,0,18,2,1,3,17,5
"43010153",Escola Vora Mar,Salou,TAR,TAR,4227102,30/03/2022,2,0,2,6,13,0,0,19,6,13,19,19,4
"43010165",Escola Marta Mata,El Vendrell,TAR,PEN,4236866,05/04/2022,0,2,2,17,0,0,0,17,17,0,17,17,4
"43010189",Institut Mediterrània,El Vendrell,TAR,PEN,4217887,25/03/2022,1,0,1,19,0,0,0,19,19,0,19,19,0
"43010220",Escola de Maspujols,Maspujols,TAR,TAR,4214470,23/03/2022,2,1,3,0,7,0,0,7,0,7,7,0,2
"43010311",CFA Ribera d'Ebre,Móra d'Ebre,TEB,TEB,4234318,04/04/2022,0,0,0,6,0,0,0,6,0,0,0,0,0
"43010323",CFA Montblanc,Montblanc,TAR,TAR,4224820,29/03/2022,0,1,1,3,0,0,1,4,0,0,0,3,0
"43010335",Institut La Mar de la Frau,Cambrils,TAR,TAR,4225148,29/03/2022,12,0,12,18,0,0,0,18,0,18,18,12,18
"43010347",Institut Marta Mata,Salou,TAR,TAR,4235067,04/04/2022,3,0,3,19,0,0,0,19,0,0,0,19,4
"43010372",Institut La Talaia,Segur de Calafell (Calafell),TAR,PEN,4214200,23/03/2022,5,4,9,22,0,0,0,22,22,0,22,17,0
"43010396",Escola de Ponent,Tarragona,TAR,TAR,4235268,04/04/2022,0,0,0,11,1,0,0,12,11,0,11,0,1
"43010402",Escola El Roquissar,Altafulla,TAR,TAR,4236896,05/04/2022,1,5,6,9,0,0,0,9,0,0,0,2,2
"43010414",Institut Coster de la Torre,La Bisbal del Penedès,TAR,PEN,4236644,05/04/2022,1,0,1,23,0,0,0,23,0,0,0,0,23
"43010487",Escola Marcel·lí Esquius,Miami Platja (Mont-roig del Camp),TAR,TAR,4237106,05/04/2022,3,7,10,0,2,4,0,6,0,2,2,4,1
"43010499",CFA Pau Casals,El Catllar,TAR,TAR,4224579,29/03/2022,0,0,0,0,3,0,0,3,0,3,3,0,0
"43010505",Escola La Vitxeta,Reus,TAR,TAR,4213536,23/03/2022,0,8,8,0,0,7,1,8,7,1,8,7,2
"43010529",Escola Cavaller Arnau,Riudoms,TAR,TAR,4216769,24/03/2022,1,4,5,1,1,9,0,11,0,0,0,7,3
"43010530",Escola Miramar,Vila-seca de Solcina (Vila-seca),TAR,TAR,4214471,23/03/2022,0,0,0,12,6,0,0,18,6,6,12,12,4
"43010578",Institut Fontanelles,Les Borges del Camp,TAR,TAR,4229548,31/03/2022,0,0,0,26,6,5,2,39,0,8,8,29,4
"43010581",Escola Mas Clariana,Cambrils,TAR,TAR,4236903,05/04/2022,0,0,0,18,0,0,0,18,18,0,18,0,2
"43010591",Escola Arquitecte Jujol,Els Pallaresos,TAR,TAR,4217740,25/03/2022,0,1,1,10,0,0,0,10,10,0,10,10,0
"43010608",Institut Serra de Miramar,Valls,TAR,TAR,4212113,22/03/2022,0,0,0,28,0,0,0,28,28,0,28,0,20
"43010621",Escola Cingle Roig - ZER Baix Camp Nord,Vilaplana,TAR,TAR,4228075,30/03/2022,1,0,1,0,0,1,3,4,1,3,4,0,1
"43010669",EOI d'Amposta,Amposta,TEB,TEB,4229378,31/03/2022,0,0,0,0,0,3,0,3,0,0,0,3,1
"43010670",EOI de Valls,Valls,TAR,TAR,4213313,23/03/2022,0,2,2,6,0,0,0,6,0,0,0,6,0
"43010748",Institut Els Pallaresos,Els Pallaresos,TAR,TAR,4236440,05/04/2022,4,0,4,6,6,2,6,20,3,0,3,4,20
"43010773",Escola Consol Ferré,Amposta,TEB,TEB,4229255,31/03/2022,0,0,0,0,18,0,0,18,0,8,8,0,6
"43010815",Escola Els Cossetans,Cunit,TAR,PEN,4215976,24/03/2022,0,0,0,18,0,0,0,18,18,0,18,1,6
"43010839",Escola Serra Major - ZER L'Aglà,La Vilella Baixa,TAR,TAR,4212899,23/03/2022,1,0,1,0,0,1,0,1,1,0,1,0,0
"43010852",Institut Roseta Mauri,Reus,TAR,TAR,4224861,29/03/2022,4,0,4,0,0,23,0,23,23,0,23,0,16
"43010864",Escola Isabel Besora,Reus,TAR,TAR,4224529,29/03/2022,3,2,5,14,0,0,0,14,4,0,4,7,4
"43010888",Institut de Tecnificació,Amposta,TEB,TEB,4227621,30/03/2022,0,5,5,18,0,0,0,18,0,0,0,21,0
"43010980",EOI Ribera d'Ebre,Móra d'Ebre,TEB,TEB,4236577,05/04/2022,0,0,0,6,0,0,0,6,0,0,0,6,1
"43011121",Escola Vilamar,Calafell,TAR,PEN,4239465,07/04/2022,1,1,2,0,9,0,0,9,0,9,9,10,2
"43011145",Escola Els Ganxets,Reus,TAR,TAR,4223215,28/03/2022,1,0,1,9,0,0,0,9,9,0,9,9,2
"43011170",Institut Cristòfol Despuig,Tortosa,TEB,TEB,4224736,29/03/2022,1,0,1,20,0,0,0,20,20,0,20,20,8
"43011194",Escola El Cucurull,Roda de Berà,TAR,TAR,4213071,23/03/2022,1,2,3,12,0,0,0,12,3,0,3,12,2
"43011200",EOI de Salou,Salou,TAR,TAR,4229409,31/03/2022,0,0,0,0,4,0,0,4,0,4,4,4,0
"43011212",Escola La Bòbila,Cambrils,TAR,TAR,4212011,22/03/2022,0,0,0,18,0,0,0,18,10,0,10,18,1
"43011418",Institut Roda de Berà,Roda de Berà,TAR,TAR,4225023,29/03/2022,1,0,1,15,5,0,0,20,15,5,20,0,6
"43011479",Institut Tarragona,Tarragona,TAR,TAR,4224570,29/03/2022,0,0,0,22,0,0,0,22,0,0,0,22,22
"43011492",Escola La Canaleta,Vila-seca de Solcina (Vila-seca),TAR,TAR,4227930,30/03/2022,2,8,10,12,0,0,6,18,12,6,18,8,5
"43012083",Institut Escola Pi del Burgar,Reus,TAR,TAR,4234785,04/04/2022,0,3,3,26,0,0,0,26,5,2,7,26,12
"43012095",Escola Joan Miró,Miami Platja (Mont-roig del Camp),TAR,TAR,4230246,31/03/2022,0,0,0,1,0,17,2,20,18,0,18,18,0
"43012113",Institut Escola Mare de Déu del Portal,Batea,TEB,TEB,4235857,05/04/2022,11,3,14,9,0,3,0,12,4,0,4,7,0
"43012289",Institut Escola 3 d'Abril,Móra la Nova,TEB,TEB,4222843,28/03/2022,10,0,10,1,0,22,0,23,11,1,12,20,6
"43012307",Institut Escola Daniel Mangrané,Jesús (Tortosa),TEB,TEB,4226936,30/03/2022,10,0,10,8,2,0,0,10,4,2,6,7,9
"43012319",Institut Escola El Perelló,El Perelló,TEB,TEB,4238430,06/04/2022,4,2,6,0,26,0,0,26,0,8,8,26,6
"43012769",CEE Font del Lleó,Reus,TAR,TAR,4236956,05/04/2022,6,0,6,0,0,8,0,8,0,0,0,0,1
"43012812",Institut Escola L'Agulla,El Catllar,TAR,TAR,4224876,29/03/2022,2,0,2,0,0,0,23,23,0,23,23,21,6
"43012903",Escola El Bosc - ZER El Francolí,Mont-ral,TAR,TAR,4212239,22/03/2022,1,0,1,1,0,0,0,1,1,0,1,1,0
"43012939",Òrgan Gestor del Complex Educatiu de Tarragona,Tarragona,TAR,TAR,4235700,04/04/2022,0,0,0,0,14,0,0,14,0,14,14,14,0
"43012976",Institut Escola Mediterrani,Bonavista (Tarragona),TAR,TAR,4223290,28/03/2022,2,1,3,13,0,0,0,13,5,0,5,2,7
"43012988",Institut de Miami,Miami Platja (Mont-roig del Camp),TAR,TAR,4229651,31/03/2022,1,0,1,0,15,0,0,15,0,15,15,0,13
"43013075",Institut Escola Àngel de Tobies,El Vendrell,TAR,PEN,4211985,22/03/2022,7,0,7,12,0,6,0,18,6,0,6,18,7
"43013087",Institut Escola Corbatera,Cornudella de Montsant,TAR,TAR,4230097,31/03/2022,1,0,1,0,0,6,1,7,1,0,1,6,0
"43013099",Institut Escola Agustí Barberà,Amposta,TEB,TEB,4234940,04/04/2022,8,4,12,6,2,9,2,19,15,4,19,9,9
"43013117",Institut d'Est. Profes. Aqüícoles i Ambientals de Catalunya,Sant Carles de la Ràpita,TEB,TEB,4226255,29/03/2022,3,0,3,0,0,3,0,3,0,0,0,3,0
"43013129",Institut Escola Coma-ruga,El Vendrell,TAR,PEN,4224756,29/03/2022,4,2,6,0,17,0,0,17,0,17,17,0,2
"43013130",Institut Escola Joan Ardèvol,Cambrils,TAR,TAR,4228700,31/03/2022,4,2,6,16,4,0,0,20,6,0,6,10,12
"43013142",Institut Escola El Temple,Tortosa,TEB,TEB,4231183,01/04/2022,7,0,7,10,12,0,0,22,16,6,22,23,10
